Source Port,Destination Port,NAT Source Port,NAT Destination Port,Action,Bytes,Bytes Sent,Bytes Received,Packets,Elapsed Time (sec),pkts_sent,pkts_received
57222,53,54587,53,allow,177,94,83,2,30,1,1
43676,80,45378,80,allow,696,378,318,12,35,7,5
55597,53,45448,53,allow,168,86,82,2,30,1,1
50281,53,33175,53,allow,195,102,93,2,30,1,1
57222,53,51448,53,allow,177,94,83,2,30,1,1
56710,53,57885,53,allow,177,94,83,2,30,1,1
50172,53,37056,53,allow,211,78,133,2,30,1,1
38802,53,38802,53,allow,216,90,126,2,30,1,1
50281,53,8038,53,allow,195,102,93,2,30,1,1
38551,53,14191,53,allow,168,78,90,2,30,1,1
64787,53,29856,53,allow,728,102,626,2,30,1,1
38641,443,31615,443,allow,318,192,126,6,14,4,2
54996,53,2476,53,allow,168,86,82,2,31,1,1
48066,443,56844,443,allow,62,62,0,1,4,1,0
50000,53,16568,53,allow,502,115,387,4,52,2,2
55234,53,5157,53,allow,177,94,83,2,29,1,1
65401,53,57745,53,allow,235,102,133,2,29,1,1
51737,53,3505,53,allow,231,78,153,2,30,1,1
54557,80,41721,80,allow,2091,799,1292,10,15,6,4
64223,53,57211,53,allow,199,94,105,2,30,1,1
49245,53,34102,53,allow,376,126,250,2,29,1,1
64399,53,50659,53,allow,230,110,120,2,29,1,1
55234,53,22160,53,allow,177,94,83,2,30,1,1
64593,53,56394,53,allow,94,94,0,1,30,1,0
56911,53,36658,53,allow,177,94,83,2,31,1,1
65004,53,23515,53,allow,323,94,229,2,30,1,1
56911,53,39355,53,allow,177,94,83,2,30,1,1
58306,443,59387,443,allow,864,436,428,13,29,7,6
42412,443,55628,443,allow,204,70,134,4,26,2,2
56710,53,52813,53,allow,177,94,83,2,30,1,1
50016,53,14072,53,allow,766,103,663,4,41,2,2
58307,443,36806,443,allow,934,506,428,14,29,8,6
55182,53,36739,53,allow,293,94,199,2,30,1,1
56911,53,31733,53,allow,177,94,83,2,30,1,1
45317,53,22055,53,allow,86,86,0,1,30,1,0
56704,53,2427,53,allow,318,94,224,2,30,1,1
49410,53,62890,53,allow,177,94,83,2,30,1,1
56504,53,45710,53,allow,102,102,0,1,30,1,0
38082,443,14308,443,allow,284,164,120,4,15,2,2
55476,53,58894,53,allow,232,110,122,2,30,1,1
49395,53,40831,53,allow,390,111,279,4,53,2,2
56172,53,35826,53,allow,253,87,166,4,30,2,2
56624,53,36589,53,allow,177,94,83,2,31,1,1
64094,1024,62040,1024,allow,70,70,0,1,5,1,0
52126,443,21159,443,allow,1672,1149,523,13,37,8,5
52144,80,16896,80,allow,366,240,126,7,33,5,2
50816,443,50681,443,allow,134,60,74,3,6,2,1
50057,80,26007,80,allow,1570,754,816,10,16,6,4
52146,80,44068,80,allow,366,240,126,7,33,5,2
54139,53,64934,53,allow,168,78,90,2,31,1,1
49410,53,29049,53,allow,177,94,83,2,31,1,1
52148,80,27900,80,allow,366,240,126,7,33,5,2
49900,443,28761,443,allow,1820,1101,719,18,73,10,8
43931,53,36161,53,allow,168,78,90,2,31,1,1
51048,445,0,0,drop,70,70,0,1,0,1,0
51045,445,0,0,drop,70,70,0,1,0,1,0
55725,445,0,0,drop,70,70,0,1,0,1,0
55723,445,0,0,drop,70,70,0,1,0,1,0
55724,445,0,0,drop,70,70,0,1,0,1,0
51125,445,0,0,drop,66,66,0,1,0,1,0
51123,445,0,0,drop,66,66,0,1,0,1,0
51122,445,0,0,drop,66,66,0,1,0,1,0
51121,445,0,0,drop,66,66,0,1,0,1,0
51126,445,0,0,drop,66,66,0,1,0,1,0
51124,445,0,0,drop,66,66,0,1,0,1,0
51120,445,0,0,drop,66,66,0,1,0,1,0
51119,445,0,0,drop,66,66,0,1,0,1,0
51041,445,0,0,drop,70,70,0,1,0,1,0
51039,445,0,0,drop,70,70,0,1,0,1,0
55718,445,0,0,drop,70,70,0,1,0,1,0
55717,445,0,0,drop,70,70,0,1,0,1,0
55713,445,0,0,drop,70,70,0,1,0,1,0
55708,445,0,0,drop,70,70,0,1,0,1,0
51034,445,0,0,drop,70,70,0,1,0,1,0
51107,445,0,0,drop,66,66,0,1,0,1,0
51105,445,0,0,drop,66,66,0,1,0,1,0
51104,445,0,0,drop,66,66,0,1,0,1,0
55703,445,0,0,drop,70,70,0,1,0,1,0
55701,445,0,0,drop,70,70,0,1,0,1,0
55696,445,0,0,drop,70,70,0,1,0,1,0
55698,445,0,0,drop,70,70,0,1,0,1,0
51021,445,0,0,drop,70,70,0,1,0,1,0
51018,445,0,0,drop,70,70,0,1,0,1,0
55686,445,0,0,drop,70,70,0,1,0,1,0
55683,445,0,0,drop,70,70,0,1,0,1,0
55679,445,0,0,drop,70,70,0,1,0,1,0
51095,445,0,0,drop,66,66,0,1,0,1,0
51014,445,0,0,drop,70,70,0,1,0,1,0
51012,445,0,0,drop,70,70,0,1,0,1,0
51010,445,0,0,drop,70,70,0,1,0,1,0
55678,445,0,0,drop,70,70,0,1,0,1,0
55677,445,0,0,drop,70,70,0,1,0,1,0
51080,445,0,0,drop,66,66,0,1,0,1,0
51076,445,0,0,drop,66,66,0,1,0,1,0
51003,445,0,0,drop,70,70,0,1,0,1,0
51001,445,0,0,drop,70,70,0,1,0,1,0
55667,445,0,0,drop,70,70,0,1,0,1,0
55665,445,0,0,drop,70,70,0,1,0,1,0
55660,445,0,0,drop,70,70,0,1,0,1,0
55658,445,0,0,drop,70,70,0,1,0,1,0
51000,445,0,0,drop,70,70,0,1,0,1,0
51071,445,0,0,drop,66,66,0,1,0,1,0
50999,445,0,0,drop,70,70,0,1,0,1,0
50998,445,0,0,drop,70,70,0,1,0,1,0
50995,445,0,0,drop,70,70,0,1,0,1,0
50992,445,0,0,drop,70,70,0,1,0,1,0
51067,445,0,0,drop,66,66,0,1,0,1,0
51066,445,0,0,drop,66,66,0,1,0,1,0
51065,445,0,0,drop,66,66,0,1,0,1,0
51062,445,0,0,drop,66,66,0,1,0,1,0
51057,445,0,0,drop,66,66,0,1,0,1,0
51063,445,0,0,drop,66,66,0,1,0,1,0
51059,445,0,0,drop,66,66,0,1,0,1,0
55651,445,0,0,drop,70,70,0,1,0,1,0
55648,445,0,0,drop,70,70,0,1,0,1,0
55646,445,0,0,drop,70,70,0,1,0,1,0
55644,445,0,0,drop,70,70,0,1,0,1,0
50980,445,0,0,drop,70,70,0,1,0,1,0
50979,445,0,0,drop,70,70,0,1,0,1,0
50975,445,0,0,drop,70,70,0,1,0,1,0
50970,445,0,0,drop,70,70,0,1,0,1,0
50969,445,0,0,drop,70,70,0,1,0,1,0
56624,53,45708,53,allow,170,87,83,2,30,1,1
46898,53,46898,53,allow,194,87,107,2,30,1,1
39430,443,21846,443,allow,506,292,214,8,50,5,3
48550,443,45303,443,allow,778,358,420,12,43,6,6
47845,53,47845,53,allow,243,94,149,2,32,1,1
56674,443,44964,443,allow,237,177,60,3,5,2,1
54996,53,39612,53,allow,168,86,82,2,35,1,1
56911,53,21649,53,allow,170,87,83,2,30,1,1
49935,53,10954,53,allow,75,75,0,1,30,1,0
52852,53,0,0,allow,82,82,0,1,30,1,0
59226,53,59226,53,allow,194,87,107,2,30,1,1
55674,53,14625,53,allow,744,89,655,2,31,1,1
40814,53,40814,53,allow,213,87,126,2,31,1,1
56730,53,30044,53,allow,170,87,83,2,31,1,1
46713,53,46713,53,allow,217,87,130,2,31,1,1
56434,53,6758,53,allow,701,88,613,2,31,1,1
53151,53,29237,53,allow,168,78,90,2,31,1,1
64288,53,54415,53,allow,398,103,295,4,41,2,2
64087,80,46757,80,allow,314,192,122,6,15,4,2
56052,53,22562,53,allow,177,94,83,2,30,1,1
52150,80,40663,80,allow,546,300,246,10,32,6,4
55641,445,0,0,drop,70,70,0,1,0,1,0
55642,445,0,0,drop,70,70,0,1,0,1,0
55640,445,0,0,drop,70,70,0,1,0,1,0
51050,445,0,0,drop,66,66,0,1,0,1,0
55635,445,0,0,drop,70,70,0,1,0,1,0
50957,445,0,0,drop,70,70,0,1,0,1,0
51047,445,0,0,drop,66,66,0,1,0,1,0
51046,445,0,0,drop,66,66,0,1,0,1,0
51045,445,0,0,drop,66,66,0,1,0,1,0
51042,445,0,0,drop,66,66,0,1,0,1,0
51414,22,0,0,deny,60,60,0,1,0,1,0
50951,445,0,0,drop,70,70,0,1,0,1,0
55633,445,0,0,drop,70,70,0,1,0,1,0
55622,445,0,0,drop,70,70,0,1,0,1,0
52145,80,50375,80,allow,366,240,126,7,32,5,2
52162,443,20113,443,allow,1461,924,537,13,31,7,6
56504,53,24881,53,allow,198,102,96,2,32,1,1
52143,80,6472,80,allow,366,240,126,7,32,5,2
52147,80,1117,80,allow,366,240,126,7,32,5,2
52157,80,19874,80,allow,366,240,126,7,32,5,2
55526,80,37218,80,allow,78,78,0,2,8,2,0
52151,80,38473,80,allow,546,300,246,10,32,6,4
56624,53,34436,53,allow,177,94,83,2,30,1,1
49795,53,44891,53,allow,263,94,169,2,30,1,1
50057,53,37422,53,allow,177,94,83,2,30,1,1
55306,53,39881,53,allow,177,94,83,2,30,1,1
52159,80,23650,80,allow,502,310,192,9,31,6,3
52153,80,26645,80,allow,366,240,126,7,32,5,2
60291,53,5136,53,allow,78,78,0,1,30,1,0
56555,53,42493,53,allow,348,94,254,2,30,1,1
49436,53,61599,53,allow,718,94,624,2,30,1,1
64226,53,54672,53,allow,245,94,151,2,30,1,1
56741,53,5499,53,allow,370,94,276,2,30,1,1
51041,80,59300,80,allow,1514,480,1034,11,15,6,5
56663,53,41717,53,allow,181,94,87,2,33,1,1
56440,53,62063,53,allow,212,102,110,2,30,1,1
56052,53,19569,53,allow,177,94,83,2,30,1,1
53971,80,16324,80,allow,662,448,214,10,15,7,3
64196,53,65372,53,allow,262,94,168,2,30,1,1
38330,123,58815,123,allow,184,94,90,2,30,1,1
49935,53,45170,53,allow,168,86,82,2,30,1,1
55639,53,27613,53,allow,244,94,150,2,30,1,1
53470,53,29709,53,allow,168,78,90,2,30,1,1
51986,80,28001,80,allow,1420,888,532,11,49,7,4
50563,53,11644,53,allow,718,94,624,2,30,1,1
52152,80,10469,80,allow,366,240,126,7,32,5,2
56521,53,35277,53,allow,305,86,219,2,30,1,1
65078,53,19268,53,allow,177,94,83,2,30,1,1
52142,80,50942,80,allow,246,120,126,5,32,3,2
52155,80,52769,80,allow,366,240,126,7,32,5,2
52161,443,17095,443,allow,1461,924,537,13,31,7,6
52158,80,31502,80,allow,502,310,192,9,31,6,3
52154,80,54882,80,allow,366,240,126,7,32,5,2
49899,443,6307,443,allow,1820,1101,719,18,72,10,8
49668,443,64842,443,allow,1288,754,534,13,50,5,8
57242,53,53275,53,allow,184,86,98,2,29,1,1
60833,443,43148,443,allow,1157,817,340,10,26,5,5
56172,53,12622,53,allow,253,87,166,4,29,2,2
56663,53,55920,53,allow,181,94,87,2,30,1,1
56773,80,16432,80,allow,1462,703,759,8,16,5,3
55806,53,2252,53,allow,200,102,98,2,30,1,1
56624,53,60055,53,allow,328,87,241,4,52,2,2
56667,53,36173,53,allow,232,94,138,2,30,1,1
56684,53,5087,53,allow,194,94,100,2,30,1,1
65001,53,27011,53,allow,200,78,122,2,30,1,1
56751,53,35800,53,allow,177,94,83,2,30,1,1
55848,53,3289,53,allow,387,134,253,2,30,1,1
65484,53,10578,53,allow,195,86,109,2,30,1,1
49695,53,29724,53,allow,240,102,138,2,30,1,1
64877,53,41929,53,allow,209,110,99,2,30,1,1
43516,53,56876,53,allow,168,78,90,2,30,1,1
51946,80,42668,80,allow,1716,952,764,13,69,8,5
52160,80,10438,80,allow,502,310,192,9,31,6,3
57986,80,48652,80,allow,1056,682,374,10,15,6,4
49410,53,59985,53,allow,324,87,237,4,55,2,2
54877,53,59244,53,allow,199,94,105,2,30,1,1
49432,53,21540,53,allow,199,94,105,2,30,1,1
49743,53,1715,53,allow,210,94,116,2,30,1,1
49913,53,15271,53,allow,177,94,83,2,30,1,1
55072,53,55776,53,allow,177,94,83,2,30,1,1
49980,53,9358,53,allow,168,94,74,2,31,1,1
55306,53,44864,53,allow,177,94,83,2,31,1,1
65078,53,50659,53,allow,177,94,83,2,30,1,1
49980,53,26131,53,allow,152,78,74,2,30,1,1
55065,53,9474,53,allow,168,78,90,2,30,1,1
45151,53,40658,53,allow,168,78,90,2,30,1,1
55072,53,50967,53,allow,177,94,83,2,31,1,1
50064,80,16215,80,allow,186,64,122,4,25,2,2
57262,53,45135,53,allow,94,94,0,1,30,1,0
49964,53,64934,53,allow,749,94,655,2,30,1,1
56751,53,10691,53,allow,177,94,83,2,30,1,1
55563,53,42353,53,allow,177,94,83,2,30,1,1
55619,445,0,0,drop,70,70,0,1,0,1,0
50942,445,0,0,drop,70,70,0,1,0,1,0
50939,445,0,0,drop,70,70,0,1,0,1,0
50941,445,0,0,drop,70,70,0,1,0,1,0
50937,445,0,0,drop,70,70,0,1,0,1,0
50935,445,0,0,drop,70,70,0,1,0,1,0
51032,445,0,0,drop,66,66,0,1,0,1,0
51024,445,0,0,drop,66,66,0,1,0,1,0
55608,445,0,0,drop,70,70,0,1,0,1,0
50928,445,0,0,drop,70,70,0,1,0,1,0
51021,445,0,0,drop,66,66,0,1,0,1,0
50920,445,0,0,drop,70,70,0,1,0,1,0
50917,445,0,0,drop,70,70,0,1,0,1,0
51014,445,0,0,drop,66,66,0,1,0,1,0
51007,445,0,0,drop,66,66,0,1,0,1,0
50913,445,0,0,drop,70,70,0,1,0,1,0
50912,445,0,0,drop,70,70,0,1,0,1,0
55597,445,0,0,drop,70,70,0,1,0,1,0
55595,445,0,0,drop,70,70,0,1,0,1,0
55596,445,0,0,drop,70,70,0,1,0,1,0
50996,445,0,0,drop,66,66,0,1,0,1,0
50997,445,0,0,drop,66,66,0,1,0,1,0
50998,445,0,0,drop,66,66,0,1,0,1,0
50991,445,0,0,drop,66,66,0,1,0,1,0
50995,445,0,0,drop,66,66,0,1,0,1,0
50994,445,0,0,drop,66,66,0,1,0,1,0
50993,445,0,0,drop,66,66,0,1,0,1,0
50990,445,0,0,drop,66,66,0,1,0,1,0
50908,445,0,0,drop,70,70,0,1,0,1,0
50907,445,0,0,drop,70,70,0,1,0,1,0
50902,445,0,0,drop,70,70,0,1,0,1,0
55593,445,0,0,drop,70,70,0,1,0,1,0
55592,445,0,0,drop,70,70,0,1,0,1,0
55582,445,0,0,drop,70,70,0,1,0,1,0
55580,445,0,0,drop,70,70,0,1,0,1,0
50978,445,0,0,drop,66,66,0,1,0,1,0
50976,445,0,0,drop,66,66,0,1,0,1,0
50975,445,0,0,drop,66,66,0,1,0,1,0
55575,445,0,0,drop,70,70,0,1,0,1,0
55569,445,0,0,drop,70,70,0,1,0,1,0
55568,445,0,0,drop,70,70,0,1,0,1,0
55567,445,0,0,drop,70,70,0,1,0,1,0
50889,445,0,0,drop,70,70,0,1,0,1,0
50886,445,0,0,drop,70,70,0,1,0,1,0
55558,445,0,0,drop,70,70,0,1,0,1,0
55555,445,0,0,drop,70,70,0,1,0,1,0
55551,445,0,0,drop,70,70,0,1,0,1,0
50963,445,0,0,drop,66,66,0,1,0,1,0
50882,445,0,0,drop,70,70,0,1,0,1,0
50880,445,0,0,drop,70,70,0,1,0,1,0
50878,445,0,0,drop,70,70,0,1,0,1,0
55550,445,0,0,drop,70,70,0,1,0,1,0
55547,445,0,0,drop,70,70,0,1,0,1,0
50871,445,0,0,drop,70,70,0,1,0,1,0
50950,445,0,0,drop,66,66,0,1,0,1,0
50947,445,0,0,drop,66,66,0,1,0,1,0
50869,445,0,0,drop,70,70,0,1,0,1,0
55410,53,27764,53,allow,711,87,624,2,30,1,1
55059,53,53925,53,allow,711,87,624,2,30,1,1
55613,53,34338,53,allow,170,87,83,2,30,1,1
52277,443,52277,443,allow,1880,941,939,17,21,7,10
56434,53,56434,53,allow,243,94,149,2,32,1,1
55893,53,56779,53,allow,711,87,624,2,30,1,1
55836,53,8077,53,allow,170,87,83,2,31,1,1
64928,53,11072,53,allow,762,98,664,2,30,1,1
56752,53,39858,53,allow,701,88,613,2,30,1,1
50895,443,61149,443,allow,130,70,60,3,5,2,1
55100,53,57209,53,allow,711,87,624,2,30,1,1
59895,53,59895,53,allow,643,88,555,2,30,1,1
50868,445,0,0,drop,70,70,0,1,0,1,0
55538,445,0,0,drop,70,70,0,1,0,1,0
55532,445,0,0,drop,70,70,0,1,0,1,0
55530,445,0,0,drop,70,70,0,1,0,1,0
55529,445,0,0,drop,70,70,0,1,0,1,0
50867,445,0,0,drop,70,70,0,1,0,1,0
50866,445,0,0,drop,70,70,0,1,0,1,0
50862,445,0,0,drop,70,70,0,1,0,1,0
50861,445,0,0,drop,70,70,0,1,0,1,0
50945,445,0,0,drop,66,66,0,1,0,1,0
50934,445,0,0,drop,66,66,0,1,0,1,0
50936,445,0,0,drop,66,66,0,1,0,1,0
50938,445,0,0,drop,66,66,0,1,0,1,0
50932,445,0,0,drop,66,66,0,1,0,1,0
55590,53,20424,53,allow,177,94,83,2,30,1,1
50929,445,0,0,drop,66,66,0,1,0,1,0
50927,445,0,0,drop,66,66,0,1,0,1,0
50928,445,0,0,drop,66,66,0,1,0,1,0
50848,445,0,0,drop,70,70,0,1,0,1,0
50847,445,0,0,drop,70,70,0,1,0,1,0
50843,445,0,0,drop,70,70,0,1,0,1,0
55523,445,0,0,drop,70,70,0,1,0,1,0
50838,445,0,0,drop,70,70,0,1,0,1,0
50837,445,0,0,drop,70,70,0,1,0,1,0
55520,445,0,0,drop,70,70,0,1,0,1,0
55518,445,0,0,drop,70,70,0,1,0,1,0
55516,445,0,0,drop,70,70,0,1,0,1,0
50826,445,0,0,drop,70,70,0,1,0,1,0
55514,445,0,0,drop,70,70,0,1,0,1,0
55515,445,0,0,drop,70,70,0,1,0,1,0
55509,445,0,0,drop,70,70,0,1,0,1,0
52231,1026,54310,1026,allow,136,136,0,3,14,3,0
57441,53,7425,53,allow,177,94,83,2,30,1,1
51502,80,42285,80,allow,1515,481,1034,11,15,6,5
64581,53,7849,53,allow,514,88,426,4,42,2,2
50008,53,2633,53,allow,232,94,138,2,29,1,1
47159,443,53350,443,allow,777,432,345,10,15,5,5
46452,53,46452,53,allow,247,98,149,2,32,1,1
49913,53,61333,53,allow,177,94,83,2,29,1,1
55563,53,47396,53,allow,177,94,83,2,29,1,1
55135,53,55135,53,allow,220,90,130,2,29,1,1
50705,80,25198,80,allow,499,192,307,6,26,4,2
50697,80,65344,80,allow,318,192,126,6,27,4,2
60526,443,60526,443,allow,1462,863,599,15,37,9,6
47009,53,0,0,allow,86,86,0,1,30,1,0
65077,53,33139,53,allow,734,86,648,2,30,1,1
41431,443,64563,443,allow,190,70,120,4,15,2,2
37419,443,55901,443,allow,558,210,348,9,28,4,5
60372,53,60372,53,allow,222,90,132,2,30,1,1
55836,53,20362,53,allow,177,94,83,2,30,1,1
55613,53,57785,53,allow,177,94,83,2,30,1,1
65139,53,12315,53,allow,210,102,108,2,30,1,1
50700,80,14024,80,allow,648,256,392,8,27,5,3
50704,80,8069,80,allow,499,192,307,6,26,4,2
43744,53,43744,53,allow,235,90,145,2,32,1,1
57441,53,33174,53,allow,177,94,83,2,30,1,1
56022,53,29566,53,allow,728,102,626,2,30,1,1
53705,443,25596,443,allow,1579,988,591,13,44,7,6
56275,53,54180,53,allow,177,94,83,2,30,1,1
50433,443,11749,443,allow,134,60,74,3,10,2,1
55806,53,43969,53,allow,200,102,98,2,32,1,1
50057,53,42578,53,allow,177,94,83,2,29,1,1
56730,53,39267,53,allow,177,94,83,2,29,1,1
53024,123,1742,123,allow,184,94,90,2,30,1,1
56730,53,28037,53,allow,177,94,83,2,30,1,1
55306,53,18601,53,allow,177,94,83,2,29,1,1
55354,53,28658,53,allow,168,94,74,2,30,1,1
54351,53,59901,53,allow,168,78,90,2,29,1,1
55613,53,25861,53,allow,177,94,83,2,30,1,1
55613,53,1186,53,allow,177,94,83,2,30,1,1
55354,53,24160,53,allow,168,94,74,2,30,1,1
43625,53,13195,53,allow,86,86,0,1,30,1,0
56730,53,28651,53,allow,177,94,83,2,30,1,1
56962,53,33318,53,allow,210,102,108,2,30,1,1
50171,53,22623,53,allow,211,78,133,2,30,1,1
65062,53,47695,53,allow,229,110,119,2,30,1,1
50698,80,39680,80,allow,318,192,126,6,27,4,2
55723,80,48588,80,allow,70,70,0,1,5,1,0
55836,53,51304,53,allow,177,94,83,2,30,1,1
46295,443,39789,443,allow,178,118,60,2,15,1,1
49335,80,26214,80,allow,1193,703,490,8,18,5,3
55650,53,22960,53,allow,179,94,85,2,31,1,1
53126,53,53126,53,allow,247,98,149,2,32,1,1
58990,53,6423,53,allow,168,78,90,2,30,1,1
40785,443,32724,443,allow,646,292,354,10,41,5,5
50253,53,23205,53,allow,167,86,81,2,31,1,1
56841,53,62125,53,allow,177,94,83,2,30,1,1
55494,53,4891,53,allow,255,102,153,2,30,1,1
50920,445,0,0,drop,66,66,0,1,0,1,0
55507,445,0,0,drop,70,70,0,1,0,1,0
50919,445,0,0,drop,66,66,0,1,0,1,0
50915,445,0,0,drop,66,66,0,1,0,1,0
50917,445,0,0,drop,66,66,0,1,0,1,0
50913,445,0,0,drop,66,66,0,1,0,1,0
50822,445,0,0,drop,70,70,0,1,0,1,0
55504,445,0,0,drop,70,70,0,1,0,1,0
50813,445,0,0,drop,70,70,0,1,0,1,0
50811,445,0,0,drop,70,70,0,1,0,1,0
50810,445,0,0,drop,70,70,0,1,0,1,0
55498,445,0,0,drop,70,70,0,1,0,1,0
55491,445,0,0,drop,70,70,0,1,0,1,0
50807,445,0,0,drop,70,70,0,1,0,1,0
50806,445,0,0,drop,70,70,0,1,0,1,0
50903,445,0,0,drop,66,66,0,1,0,1,0
50800,445,0,0,drop,70,70,0,1,0,1,0
50895,445,0,0,drop,66,66,0,1,0,1,0
55481,445,0,0,drop,70,70,0,1,0,1,0
50893,445,0,0,drop,66,66,0,1,0,1,0
50792,445,0,0,drop,70,70,0,1,0,1,0
50789,445,0,0,drop,70,70,0,1,0,1,0
50885,445,0,0,drop,66,66,0,1,0,1,0
50882,445,0,0,drop,66,66,0,1,0,1,0
50785,445,0,0,drop,70,70,0,1,0,1,0
50784,445,0,0,drop,70,70,0,1,0,1,0
50780,445,0,0,drop,70,70,0,1,0,1,0
55468,445,0,0,drop,70,70,0,1,0,1,0
55469,445,0,0,drop,70,70,0,1,0,1,0
55467,445,0,0,drop,70,70,0,1,0,1,0
50867,445,0,0,drop,66,66,0,1,0,1,0
50863,445,0,0,drop,66,66,0,1,0,1,0
50869,445,0,0,drop,66,66,0,1,0,1,0
50865,445,0,0,drop,66,66,0,1,0,1,0
50870,445,0,0,drop,66,66,0,1,0,1,0
50868,445,0,0,drop,66,66,0,1,0,1,0
50866,445,0,0,drop,66,66,0,1,0,1,0
50864,445,0,0,drop,66,66,0,1,0,1,0
50779,445,0,0,drop,70,70,0,1,0,1,0
56075,23,0,0,deny,60,60,0,1,0,1,0
50774,445,0,0,drop,70,70,0,1,0,1,0
55463,445,0,0,drop,70,70,0,1,0,1,0
55567,53,51894,53,allow,184,80,104,2,0,1,1
55458,445,0,0,drop,70,70,0,1,0,1,0
55460,445,0,0,drop,70,70,0,1,0,1,0
55452,445,0,0,drop,70,70,0,1,0,1,0
50850,445,0,0,drop,66,66,0,1,0,1,0
50848,445,0,0,drop,66,66,0,1,0,1,0
50847,445,0,0,drop,66,66,0,1,0,1,0
55448,445,0,0,drop,70,70,0,1,0,1,0
55443,445,0,0,drop,70,70,0,1,0,1,0
55441,445,0,0,drop,70,70,0,1,0,1,0
55440,445,0,0,drop,70,70,0,1,0,1,0
50761,445,0,0,drop,70,70,0,1,0,1,0
50758,445,0,0,drop,70,70,0,1,0,1,0
55430,445,0,0,drop,70,70,0,1,0,1,0
55427,445,0,0,drop,70,70,0,1,0,1,0
55423,445,0,0,drop,70,70,0,1,0,1,0
50754,445,0,0,drop,70,70,0,1,0,1,0
50752,445,0,0,drop,70,70,0,1,0,1,0
50837,445,0,0,drop,66,66,0,1,0,1,0
50750,445,0,0,drop,70,70,0,1,0,1,0
55422,445,0,0,drop,70,70,0,1,0,1,0
64431,53,52524,53,allow,170,87,83,2,31,1,1
64715,53,13561,53,allow,770,102,668,2,30,1,1
36712,53,0,0,allow,138,69,69,2,30,1,1
38400,53,0,0,allow,82,82,0,1,30,1,0
56659,53,59706,53,allow,711,87,624,2,30,1,1
57424,53,35431,53,allow,711,87,624,2,30,1,1
56838,53,49360,53,allow,170,87,83,2,30,1,1
57436,53,43639,53,allow,733,85,648,2,30,1,1
56343,53,26546,53,allow,170,87,83,2,30,1,1
52280,443,52280,443,allow,1615,941,674,15,20,7,8
56275,53,11893,53,allow,170,87,83,2,30,1,1
41774,53,0,0,allow,82,82,0,1,30,1,0
50190,53,51481,53,allow,754,94,660,2,30,1,1
55650,53,47564,53,allow,174,89,85,2,30,1,1
55797,53,58319,53,allow,170,87,83,2,31,1,1
51443,53,51443,53,allow,217,87,130,2,31,1,1
55325,53,64305,53,allow,711,87,624,2,31,1,1
56663,53,34654,53,allow,178,91,87,2,31,1,1
56882,53,4292,53,allow,87,87,0,2,61,2,0
65284,53,18214,53,allow,758,96,662,2,31,1,1
55420,445,0,0,drop,70,70,0,1,0,1,0
50743,445,0,0,drop,70,70,0,1,0,1,0
65507,53,7082,53,allow,229,102,127,2,30,1,1
53195,443,44058,443,allow,2016,1160,856,17,46,9,8
56841,53,54383,53,allow,177,94,83,2,29,1,1
50253,53,52044,53,allow,167,86,81,2,29,1,1
56838,53,18546,53,allow,177,94,83,2,29,1,1
64431,53,6973,53,allow,177,94,83,2,30,1,1
55650,53,39411,53,allow,179,94,85,2,29,1,1
50170,53,38281,53,allow,260,86,174,2,29,1,1
56755,443,63082,443,allow,1327,918,409,10,26,6,4
42441,123,34753,123,allow,184,94,90,2,30,1,1
56838,53,39774,53,allow,177,94,83,2,30,1,1
55590,53,49633,53,allow,177,94,83,2,29,1,1
50078,53,55714,53,allow,177,94,83,2,29,1,1
48783,53,0,0,allow,86,86,0,1,30,1,0
64431,53,36891,53,allow,177,94,83,2,30,1,1
57038,53,18909,53,allow,194,102,92,2,33,1,1
56092,53,34391,53,allow,177,94,83,2,30,1,1
55594,53,43491,53,allow,167,86,81,2,30,1,1
56343,53,46504,53,allow,177,94,83,2,30,1,1
51684,80,23150,80,allow,1515,481,1034,11,15,6,5
56092,53,54654,53,allow,177,94,83,2,30,1,1
55915,53,47313,53,allow,86,86,0,1,30,1,0
65330,53,32414,53,allow,733,94,639,2,30,1,1
56343,53,54537,53,allow,177,94,83,2,30,1,1
55867,53,45353,53,allow,178,94,84,2,30,1,1
55963,53,19959,53,allow,316,94,222,2,30,1,1
57038,53,31637,53,allow,194,102,92,2,30,1,1
65520,53,2299,53,allow,379,94,285,2,30,1,1
64439,53,36419,53,allow,359,134,225,2,30,1,1
51120,587,51120,587,allow,320,128,192,6,6,3,3
64996,53,37849,53,allow,547,91,456,4,35,2,2
49250,80,27382,80,allow,1623,629,994,8,75,5,3
51324,465,51324,465,allow,320,128,192,6,5,3,3
56407,53,58288,53,allow,216,102,114,2,29,1,1
56275,53,62167,53,allow,177,94,83,2,29,1,1
50078,53,19314,53,allow,185,102,83,2,29,1,1
49778,53,15143,53,allow,255,102,153,2,29,1,1
64067,53,52701,53,allow,329,94,235,2,29,1,1
49674,53,9150,53,allow,211,102,109,2,29,1,1
56343,53,52506,53,allow,177,94,83,2,29,1,1
49458,53,15275,53,allow,280,94,186,2,30,1,1
49364,53,17404,53,allow,307,307,0,4,60,4,0
55836,53,33356,53,allow,177,94,83,2,30,1,1
56492,53,4383,53,allow,212,102,110,2,30,1,1
56905,80,13949,80,allow,78,78,0,2,8,2,0
37335,443,14228,443,allow,130,70,60,3,5,2,1
54104,443,3216,443,allow,190,70,120,4,15,2,2
56838,53,31421,53,allow,327,87,240,4,50,2,2
64709,53,11434,53,allow,821,102,719,2,30,1,1
62232,80,47630,80,allow,1511,517,994,8,15,5,3
55594,53,22728,53,allow,167,86,81,2,30,1,1
56515,53,36823,53,allow,177,94,83,2,30,1,1
55420,53,38783,53,allow,177,94,83,2,30,1,1
55053,53,47870,53,allow,216,102,114,2,30,1,1
55867,53,60176,53,allow,178,94,84,2,31,1,1
56431,53,28557,53,allow,177,94,83,2,31,1,1
56586,53,32780,53,allow,177,94,83,2,31,1,1
64796,53,3205,53,allow,184,94,90,2,31,1,1
64431,53,35945,53,allow,177,94,83,2,31,1,1
64124,443,56676,443,allow,1411,852,559,13,25,7,6
55869,53,8327,53,allow,196,102,94,2,31,1,1
53251,53,53251,53,allow,247,98,149,2,34,1,1
49857,53,15096,53,allow,173,94,79,2,30,1,1
57840,53,57840,53,allow,183,82,101,2,30,1,1
55869,53,64090,53,allow,196,102,94,2,30,1,1
49396,53,60623,53,allow,216,102,114,2,30,1,1
55732,53,29178,53,allow,177,94,83,2,30,1,1
55797,53,36305,53,allow,177,94,83,2,31,1,1
65289,53,7871,53,allow,179,94,85,2,31,1,1
56906,53,55216,53,allow,167,86,81,2,31,1,1
50741,445,0,0,drop,70,70,0,1,0,1,0
50821,445,0,0,drop,66,66,0,1,0,1,0
50818,445,0,0,drop,66,66,0,1,0,1,0
50740,445,0,0,drop,70,70,0,1,0,1,0
50739,445,0,0,drop,70,70,0,1,0,1,0
50738,445,0,0,drop,70,70,0,1,0,1,0
50735,445,0,0,drop,70,70,0,1,0,1,0
50732,445,0,0,drop,70,70,0,1,0,1,0
55409,445,0,0,drop,70,70,0,1,0,1,0
55408,445,0,0,drop,70,70,0,1,0,1,0
55404,445,0,0,drop,70,70,0,1,0,1,0
55402,445,0,0,drop,70,70,0,1,0,1,0
50816,445,0,0,drop,66,66,0,1,0,1,0
50720,445,0,0,drop,70,70,0,1,0,1,0
50719,445,0,0,drop,70,70,0,1,0,1,0
50717,445,0,0,drop,70,70,0,1,0,1,0
50809,445,0,0,drop,66,66,0,1,0,1,0
50799,445,0,0,drop,66,66,0,1,0,1,0
50807,445,0,0,drop,66,66,0,1,0,1,0
50800,445,0,0,drop,66,66,0,1,0,1,0
50803,445,0,0,drop,66,66,0,1,0,1,0
50808,445,0,0,drop,66,66,0,1,0,1,0
50801,445,0,0,drop,66,66,0,1,0,1,0
50709,445,0,0,drop,70,70,0,1,0,1,0
50710,445,0,0,drop,70,70,0,1,0,1,0
55395,445,0,0,drop,70,70,0,1,0,1,0
55392,445,0,0,drop,70,70,0,1,0,1,0
55389,445,0,0,drop,70,70,0,1,0,1,0
55388,445,0,0,drop,70,70,0,1,0,1,0
50698,445,0,0,drop,70,70,0,1,0,1,0
55386,445,0,0,drop,70,70,0,1,0,1,0
55385,445,0,0,drop,70,70,0,1,0,1,0
55384,445,0,0,drop,70,70,0,1,0,1,0
50793,445,0,0,drop,66,66,0,1,0,1,0
55379,445,0,0,drop,70,70,0,1,0,1,0
50790,445,0,0,drop,66,66,0,1,0,1,0
50789,445,0,0,drop,66,66,0,1,0,1,0
50787,445,0,0,drop,66,66,0,1,0,1,0
50694,445,0,0,drop,70,70,0,1,0,1,0
50786,445,0,0,drop,66,66,0,1,0,1,0
50683,445,0,0,drop,70,70,0,1,0,1,0
50682,445,0,0,drop,70,70,0,1,0,1,0
50684,445,0,0,drop,70,70,0,1,0,1,0
50681,445,0,0,drop,70,70,0,1,0,1,0
55374,445,0,0,drop,70,70,0,1,0,1,0
50677,445,0,0,drop,70,70,0,1,0,1,0
55370,445,0,0,drop,70,70,0,1,0,1,0
55363,445,0,0,drop,70,70,0,1,0,1,0
50775,445,0,0,drop,66,66,0,1,0,1,0
60193,53,20927,53,allow,214,85,129,2,0,1,1
54025,53,41690,53,allow,578,286,292,9,0,5,4
50672,445,0,0,drop,70,70,0,1,0,1,0
50767,445,0,0,drop,66,66,0,1,0,1,0
55351,445,0,0,drop,70,70,0,1,0,1,0
61288,23,0,0,deny,60,60,0,1,0,1,0
50664,445,0,0,drop,70,70,0,1,0,1,0
50661,445,0,0,drop,70,70,0,1,0,1,0
50764,445,0,0,drop,66,66,0,1,0,1,0
40394,67,0,0,deny,60,60,0,1,0,1,0
50756,445,0,0,drop,66,66,0,1,0,1,0
50657,445,0,0,drop,70,70,0,1,0,1,0
50656,445,0,0,drop,70,70,0,1,0,1,0
50749,445,0,0,drop,66,66,0,1,0,1,0
50652,445,0,0,drop,70,70,0,1,0,1,0
50650,445,0,0,drop,70,70,0,1,0,1,0
55341,445,0,0,drop,70,70,0,1,0,1,0
55340,445,0,0,drop,70,70,0,1,0,1,0
55339,445,0,0,drop,70,70,0,1,0,1,0
50738,445,0,0,drop,66,66,0,1,0,1,0
50735,445,0,0,drop,66,66,0,1,0,1,0
50741,445,0,0,drop,66,66,0,1,0,1,0
50742,445,0,0,drop,66,66,0,1,0,1,0
50737,445,0,0,drop,66,66,0,1,0,1,0
50740,445,0,0,drop,66,66,0,1,0,1,0
50736,445,0,0,drop,66,66,0,1,0,1,0
50734,445,0,0,drop,66,66,0,1,0,1,0
50646,445,0,0,drop,70,70,0,1,0,1,0
55338,445,0,0,drop,70,70,0,1,0,1,0
55335,445,0,0,drop,70,70,0,1,0,1,0
55333,445,0,0,drop,70,70,0,1,0,1,0
55321,445,0,0,drop,70,70,0,1,0,1,0
50721,445,0,0,drop,66,66,0,1,0,1,0
50720,445,0,0,drop,66,66,0,1,0,1,0
50719,445,0,0,deny,66,66,0,1,0,1,0
50633,445,0,0,drop,70,70,0,1,0,1,0
55319,445,0,0,drop,70,70,0,1,0,1,0
55317,445,0,0,drop,70,70,0,1,0,1,0
55314,445,0,0,drop,70,70,0,1,0,1,0
55308,445,0,0,drop,70,70,0,1,0,1,0
50630,445,0,0,drop,70,70,0,1,0,1,0
55109,53,12323,53,allow,711,87,624,2,30,1,1
55869,53,59798,53,allow,192,98,94,2,30,1,1
55457,443,34189,443,allow,130,70,60,3,5,2,1
56083,53,60591,53,allow,711,87,624,2,30,1,1
56431,53,62997,53,allow,170,87,83,2,30,1,1
61054,53,61054,53,allow,237,91,146,2,33,1,1
54076,53,54076,53,allow,243,94,149,2,32,1,1
52270,443,52270,443,allow,1615,941,674,15,20,7,8
55867,53,58666,53,allow,172,88,84,2,30,1,1
56586,53,6320,53,allow,170,87,83,2,30,1,1
50823,443,50823,443,allow,1210,637,573,14,25,7,7
64796,53,48263,53,allow,184,94,90,2,31,1,1
52269,443,52269,443,allow,1615,941,674,15,20,7,8
65359,53,51803,53,allow,731,91,640,2,30,1,1
56504,53,4684,53,allow,196,100,96,2,30,1,1
56919,53,26686,53,allow,170,87,83,2,30,1,1
49506,53,26702,53,allow,200,102,98,2,31,1,1
65289,53,55084,53,allow,174,89,85,2,31,1,1
64722,53,22432,53,allow,184,94,90,2,31,1,1
50031,53,53719,53,allow,178,91,87,2,31,1,1
59086,53,59086,53,allow,235,90,145,2,32,1,1
50944,443,50944,443,allow,1210,637,573,14,25,7,7
51073,443,51073,443,allow,1210,637,573,14,25,7,7
40175,53,40175,53,allow,235,90,145,2,32,1,1
56733,53,47115,53,allow,187,98,89,3,52,2,1
37350,53,37350,53,allow,213,87,126,2,30,1,1
58254,80,49705,80,allow,1151,711,440,10,15,5,5
62160,53,62160,53,allow,205,81,124,2,30,1,1
55735,53,59032,53,allow,256,93,163,2,30,1,1
64171,53,19883,53,allow,174,89,85,2,30,1,1
53338,53,53532,53,allow,168,78,90,2,30,1,1
56262,53,64499,53,allow,170,87,83,2,31,1,1
56906,53,50869,53,allow,166,85,81,2,31,1,1
56322,53,0,0,allow,166,73,93,2,31,1,1
57033,53,60387,53,allow,754,94,660,2,31,1,1
56720,53,57762,53,allow,916,86,830,2,31,1,1
49321,53,16825,53,allow,184,94,90,2,31,1,1
50625,445,0,0,drop,70,70,0,1,0,1,0
50624,445,0,0,drop,70,70,0,1,0,1,0
55300,445,0,0,drop,70,70,0,1,0,1,0
55295,445,0,0,drop,70,70,0,1,0,1,0
50622,445,0,0,drop,70,70,0,1,0,1,0
42356,443,3759,443,allow,276,70,206,5,26,2,3
43900,443,13168,443,allow,442,250,192,8,25,5,3
53951,80,8930,80,allow,78,78,0,2,7,2,0
51136,443,51136,443,allow,1210,637,573,14,25,7,7
65131,53,28562,53,allow,443,98,345,4,57,2,2
49670,443,5760,443,allow,886,541,345,11,15,6,5
65053,53,65053,53,allow,235,90,145,2,31,1,1
49188,53,58733,53,allow,621,111,510,4,35,2,2
52272,443,52272,443,allow,1615,941,674,15,20,7,8
39994,80,41282,80,allow,2387,930,1457,14,16,7,7
56515,53,8193,53,allow,177,94,83,2,29,1,1
57448,53,27842,53,allow,177,94,83,2,29,1,1
56906,53,48411,53,allow,167,86,81,2,29,1,1
50063,53,17752,53,allow,173,94,79,2,29,1,1
55650,53,4298,53,allow,179,94,85,2,29,1,1
61119,53,61119,53,allow,217,90,127,2,29,1,1
50063,53,53923,53,allow,173,94,79,2,30,1,1
55732,53,41995,53,allow,177,94,83,2,29,1,1
56176,53,13645,53,allow,177,94,83,2,30,1,1
63954,53,6162,53,allow,289,102,187,2,30,1,1
57152,53,57152,53,allow,241,98,143,2,30,1,1
49481,53,5935,53,allow,232,102,130,2,30,1,1
56504,53,22416,53,allow,198,102,96,2,33,1,1
65094,53,59382,53,allow,630,204,426,6,64,3,3
64051,53,63556,53,allow,275,102,173,2,30,1,1
49837,53,3661,53,allow,183,102,81,2,30,1,1
65028,53,37363,53,allow,79,79,0,2,33,2,0
61544,53,18551,53,allow,325,86,239,2,30,1,1
64876,53,58020,53,allow,737,94,643,2,30,1,1
53500,443,64344,443,allow,558,210,348,9,29,4,5
64722,53,7575,53,allow,184,94,90,2,30,1,1
56262,53,63670,53,allow,177,94,83,2,30,1,1
56563,53,53188,53,allow,292,126,166,2,30,1,1
50031,53,15521,53,allow,181,94,87,2,30,1,1
56431,53,59476,53,allow,177,94,83,2,30,1,1
64796,53,58063,53,allow,184,94,90,2,30,1,1
49340,53,57846,53,allow,387,134,253,2,30,1,1
57176,53,43366,53,allow,178,94,84,2,30,1,1
54388,53,31456,53,allow,168,78,90,2,30,1,1
58975,80,4684,80,allow,214,140,74,4,15,3,1
59912,53,38804,53,allow,168,78,90,2,30,1,1
64926,53,0,0,allow,371,77,294,2,30,1,1
64171,53,47261,53,allow,179,94,85,2,30,1,1
49224,53,4375,53,allow,199,102,97,2,32,1,1
43026,443,33561,443,allow,138,78,60,2,4,1,1
55867,53,49859,53,allow,178,94,84,2,29,1,1
36873,80,37820,80,allow,1115,534,581,12,16,7,5
56919,53,21784,53,allow,177,94,83,2,29,1,1
50388,53,43330,53,allow,94,94,0,1,29,1,0
55797,53,20315,53,allow,177,94,83,2,29,1,1
56269,53,56636,53,allow,326,126,200,2,30,1,1
55420,53,27651,53,allow,177,94,83,2,29,1,1
65290,53,22798,53,allow,181,94,87,2,29,1,1
49506,53,12143,53,allow,200,102,98,2,30,1,1
65229,53,65530,53,allow,443,182,261,6,30,3,3
49837,53,9778,53,allow,167,86,81,2,30,1,1
65239,53,57855,53,allow,489,185,304,6,73,3,3
56586,53,54269,53,allow,177,94,83,2,30,1,1
64376,53,21911,53,allow,210,94,116,2,30,1,1
57448,53,10658,53,allow,177,94,83,2,29,1,1
56037,53,8318,53,allow,246,102,144,2,30,1,1
55797,53,21762,53,allow,177,94,83,2,30,1,1
56977,53,6420,53,allow,322,102,220,2,30,1,1
65290,53,6842,53,allow,181,94,87,2,29,1,1
49857,53,44627,53,allow,165,86,79,2,29,1,1
56919,53,40423,53,allow,177,94,83,2,29,1,1
56906,53,34993,53,allow,167,86,81,2,31,1,1
56307,53,55446,53,allow,185,102,83,2,31,1,1
56257,53,40578,53,allow,177,94,83,2,31,1,1
55605,53,12415,53,allow,300,88,212,4,51,2,2
49745,53,63902,53,allow,1472,98,1374,4,54,2,2
49603,53,34411,53,allow,326,126,200,2,30,1,1
55025,53,42219,53,allow,183,94,89,2,30,1,1
50031,53,40045,53,allow,181,94,87,2,30,1,1
56322,53,0,0,allow,629,73,556,2,30,1,1
56176,53,54476,53,allow,177,94,83,2,30,1,1
64171,53,17588,53,allow,179,94,85,2,30,1,1
49462,53,10345,53,allow,86,86,0,1,30,1,0
65402,53,33102,53,allow,297,110,187,2,30,1,1
49506,53,23058,53,allow,200,102,98,2,30,1,1
64722,53,27260,53,allow,184,94,90,2,30,1,1
56262,53,55550,53,allow,177,94,83,2,31,1,1
56663,53,10723,53,allow,181,94,87,2,33,1,1
58974,80,55839,80,allow,214,140,74,4,15,3,1
45545,53,45545,53,allow,178,82,96,2,30,1,1
49293,53,22414,53,allow,811,94,717,2,30,1,1
64511,53,2785,53,allow,305,102,203,2,30,1,1
55025,53,22515,53,allow,183,94,89,2,30,1,1
65289,53,55210,53,allow,179,94,85,2,30,1,1
56919,53,56265,53,allow,177,94,83,2,30,1,1
56431,53,39797,53,allow,177,94,83,2,30,1,1
56572,53,63633,53,allow,177,94,83,2,31,1,1
56262,53,24636,53,allow,177,94,83,2,30,1,1
64917,53,41071,53,allow,194,94,100,2,30,1,1
49321,53,55835,53,allow,184,94,90,2,31,1,1
49506,53,52835,53,allow,200,102,98,2,31,1,1
64722,53,18980,53,allow,384,94,290,4,42,2,2
55869,53,49767,53,allow,196,102,94,2,30,1,1
64694,53,22388,53,allow,289,82,207,4,46,2,2
42096,80,4456,80,allow,1711,698,1013,14,17,6,8
50708,445,0,0,drop,66,66,0,1,0,1,0
55294,445,0,0,drop,70,70,0,1,0,1,0
50615,445,0,0,drop,70,70,0,1,0,1,0
55293,445,0,0,drop,70,70,0,1,0,1,0
50613,445,0,0,drop,70,70,0,1,0,1,0
50692,445,0,0,drop,66,66,0,1,0,1,0
50691,445,0,0,drop,66,66,0,1,0,1,0
50612,445,0,0,drop,70,70,0,1,0,1,0
50611,445,0,0,drop,70,70,0,1,0,1,0
50610,445,0,0,drop,70,70,0,1,0,1,0
50606,445,0,0,drop,70,70,0,1,0,1,0
50604,445,0,0,drop,70,70,0,1,0,1,0
55283,445,0,0,drop,70,70,0,1,0,1,0
55280,445,0,0,drop,70,70,0,1,0,1,0
55277,445,0,0,drop,70,70,0,1,0,1,0
55275,445,0,0,drop,70,70,0,1,0,1,0
50592,445,0,0,drop,70,70,0,1,0,1,0
50591,445,0,0,drop,70,70,0,1,0,1,0
50689,445,0,0,drop,66,66,0,1,0,1,0
50586,445,0,0,drop,70,70,0,1,0,1,0
50582,445,0,0,drop,70,70,0,1,0,1,0
50581,445,0,0,drop,70,70,0,1,0,1,0
50680,445,0,0,drop,66,66,0,1,0,1,0
50682,445,0,0,drop,66,66,0,1,0,1,0
50671,445,0,0,drop,66,66,0,1,0,1,0
50676,445,0,0,drop,66,66,0,1,0,1,0
50677,445,0,0,drop,66,66,0,1,0,1,0
50674,445,0,0,drop,66,66,0,1,0,1,0
50675,445,0,0,drop,66,66,0,1,0,1,0
55266,445,0,0,drop,70,70,0,1,0,1,0
55264,445,0,0,drop,70,70,0,1,0,1,0
55262,445,0,0,drop,70,70,0,1,0,1,0
55261,445,0,0,drop,70,70,0,1,0,1,0
36005,22,0,0,deny,60,60,0,1,0,1,0
50570,445,0,0,drop,70,70,0,1,0,1,0
55259,445,0,0,drop,70,70,0,1,0,1,0
55256,445,0,0,drop,70,70,0,1,0,1,0
55253,445,0,0,drop,70,70,0,1,0,1,0
50665,445,0,0,drop,66,66,0,1,0,1,0
55251,445,0,0,drop,70,70,0,1,0,1,0
50662,445,0,0,drop,66,66,0,1,0,1,0
50566,445,0,0,drop,70,70,0,1,0,1,0
50660,445,0,0,drop,66,66,0,1,0,1,0
50659,445,0,0,drop,66,66,0,1,0,1,0
50658,445,0,0,drop,66,66,0,1,0,1,0
50557,445,0,0,drop,70,70,0,1,0,1,0
50556,445,0,0,drop,70,70,0,1,0,1,0
50555,445,0,0,drop,70,70,0,1,0,1,0
50552,445,0,0,drop,70,70,0,1,0,1,0
50550,445,0,0,drop,70,70,0,1,0,1,0
55246,445,0,0,drop,70,70,0,1,0,1,0
55240,445,0,0,drop,70,70,0,1,0,1,0
55233,445,0,0,drop,70,70,0,1,0,1,0
50647,445,0,0,drop,66,66,0,1,0,1,0
50544,445,0,0,drop,70,70,0,1,0,1,0
50639,445,0,0,drop,66,66,0,1,0,1,0
55223,445,0,0,drop,70,70,0,1,0,1,0
50536,445,0,0,drop,70,70,0,1,0,1,0
55306,53,23236,53,allow,170,87,83,2,0,1,1
50535,445,0,0,drop,70,70,0,1,0,1,0
50637,445,0,0,drop,66,66,0,1,0,1,0
50530,445,0,0,drop,70,70,0,1,0,1,0
50528,445,0,0,drop,70,70,0,1,0,1,0
50629,445,0,0,drop,66,66,0,1,0,1,0
50622,445,0,0,drop,66,66,0,1,0,1,0
50524,445,0,0,drop,70,70,0,1,0,1,0
50523,445,0,0,drop,70,70,0,1,0,1,0
55216,445,0,0,drop,70,70,0,1,0,1,0
55212,445,0,0,drop,70,70,0,1,0,1,0
55211,445,0,0,drop,70,70,0,1,0,1,0
50607,445,0,0,drop,66,66,0,1,0,1,0
50614,445,0,0,drop,66,66,0,1,0,1,0
50609,445,0,0,drop,66,66,0,1,0,1,0
50610,445,0,0,drop,66,66,0,1,0,1,0
50613,445,0,0,drop,66,66,0,1,0,1,0
50608,445,0,0,drop,66,66,0,1,0,1,0
50606,445,0,0,drop,66,66,0,1,0,1,0
50612,445,0,0,drop,66,66,0,1,0,1,0
50518,445,0,0,drop,70,70,0,1,0,1,0
55209,445,0,0,drop,70,70,0,1,0,1,0
55204,445,0,0,drop,70,70,0,1,0,1,0
55203,445,0,0,drop,70,70,0,1,0,1,0
55199,445,0,0,drop,70,70,0,1,0,1,0
50594,445,0,0,drop,66,66,0,1,0,1,0
50593,445,0,0,drop,66,66,0,1,0,1,0
50591,445,0,0,drop,66,66,0,1,0,1,0
50505,445,0,0,drop,70,70,0,1,0,1,0
55903,53,1701,53,allow,170,87,83,2,30,1,1
55115,53,54899,53,allow,758,96,662,2,31,1,1
50687,443,7518,443,allow,1199,618,581,13,29,6,7
64681,53,5691,53,allow,86,86,0,1,60,1,0
56122,53,50294,53,allow,731,91,640,2,30,1,1
39023,443,14196,443,allow,1017,705,312,9,20,4,5
50686,443,4744,443,allow,1199,618,581,13,29,6,7
50730,53,50730,53,allow,228,97,131,2,30,1,1
57047,53,47290,53,allow,1426,98,1328,4,53,2,2
36103,443,46915,443,allow,130,70,60,2,15,1,1
44884,443,1595,443,allow,309,309,0,1,5,1,0
54973,53,61675,53,allow,711,87,624,2,30,1,1
56265,53,18284,53,allow,733,85,648,2,30,1,1
55897,53,23504,53,allow,770,102,668,2,30,1,1
55975,53,49618,53,allow,711,87,624,2,30,1,1
56257,53,60774,53,allow,170,87,83,2,31,1,1
50134,53,40420,53,allow,733,86,647,2,31,1,1
56216,53,5035,53,allow,170,87,83,2,31,1,1
46774,53,46774,53,allow,235,90,145,2,33,1,1
59442,53,59442,53,allow,235,90,145,2,33,1,1
38698,443,26967,443,allow,628,250,378,11,39,5,6
55370,53,23288,53,allow,711,87,624,2,30,1,1
57176,53,30899,53,allow,172,88,84,2,30,1,1
55219,53,47738,53,allow,91,91,0,1,30,1,0
55806,53,53227,53,allow,200,102,98,2,30,1,1
55564,53,55564,53,allow,215,88,127,2,30,1,1
55349,53,28852,53,allow,744,89,655,2,30,1,1
55224,53,26209,53,allow,711,87,624,2,31,1,1
56255,53,37256,53,allow,701,88,613,2,31,1,1
49762,53,56822,53,allow,184,94,90,2,31,1,1
59513,53,0,0,allow,82,82,0,1,31,1,0
55647,53,53361,53,allow,250,86,164,4,31,2,2
56480,53,53765,53,allow,755,94,661,2,31,1,1
64124,53,26589,53,allow,182,93,89,2,31,1,1
57052,53,31599,53,allow,711,87,624,2,31,1,1
45154,53,45154,53,allow,236,108,128,2,31,1,1
55288,53,47176,53,allow,192,98,94,2,31,1,1
57374,53,45450,53,allow,733,86,647,2,31,1,1
56397,53,29734,53,allow,174,89,85,2,31,1,1
55082,53,13671,53,allow,755,93,662,2,31,1,1
54256,123,0,0,deny,234,234,0,1,0,1,0
55191,445,0,0,drop,70,70,0,1,0,1,0
50502,445,0,0,drop,70,70,0,1,0,1,0
55190,445,0,0,drop,70,70,0,1,0,1,0
55183,445,0,0,drop,70,70,0,1,0,1,0
55180,445,0,0,drop,70,70,0,1,0,1,0
50498,445,0,0,drop,70,70,0,1,0,1,0
50496,445,0,0,drop,70,70,0,1,0,1,0
50494,445,0,0,drop,70,70,0,1,0,1,0
55172,445,0,0,drop,70,70,0,1,0,1,0
55168,445,0,0,drop,70,70,0,1,0,1,0
55167,445,0,0,drop,70,70,0,1,0,1,0
50581,445,0,0,drop,66,66,0,1,0,1,0
50487,445,0,0,drop,70,70,0,1,0,1,0
55166,445,0,0,drop,70,70,0,1,0,1,0
50485,445,0,0,drop,70,70,0,1,0,1,0
55164,445,0,0,drop,70,70,0,1,0,1,0
50484,445,0,0,drop,70,70,0,1,0,1,0
50483,445,0,0,drop,70,70,0,1,0,1,0
50482,445,0,0,drop,70,70,0,1,0,1,0
50476,445,0,0,drop,70,70,0,1,0,1,0
65216,53,28628,53,allow,218,94,124,2,30,1,1
56216,53,58788,53,allow,177,94,83,2,30,1,1
37110,53,37110,53,allow,247,98,149,2,33,1,1
38783,443,19297,443,allow,584,370,214,9,25,6,3
55806,53,52811,53,allow,200,102,98,2,33,1,1
56586,53,50469,53,allow,177,94,83,2,29,1,1
64618,53,13340,53,allow,410,102,308,2,29,1,1
49787,53,40556,53,allow,258,110,148,2,29,1,1
65289,53,50124,53,allow,564,193,371,6,51,3,3
56439,53,20721,53,allow,177,94,83,2,29,1,1
57176,53,54360,53,allow,178,94,84,2,29,1,1
64365,53,27467,53,allow,341,110,231,2,29,1,1
65511,53,46791,53,allow,214,102,112,2,30,1,1
50175,53,51711,53,allow,819,102,717,2,30,1,1
49344,53,20668,53,allow,458,188,270,6,29,3,3
57176,53,50437,53,allow,178,94,84,2,29,1,1
55339,53,49453,53,allow,194,94,100,2,30,1,1
55903,53,28482,53,allow,177,94,83,2,30,1,1
64009,53,32252,53,allow,209,110,99,2,30,1,1
56068,53,60568,53,allow,168,94,74,2,30,1,1
53194,443,6156,443,allow,1478,918,560,12,44,6,6
46486,53,46486,53,allow,414,268,146,3,34,2,1
59131,53,59747,53,allow,70,70,0,1,30,1,0
55015,53,27863,53,allow,733,94,639,2,30,1,1
56892,53,40383,53,allow,210,102,108,2,30,1,1
55561,53,57871,53,allow,313,102,211,2,30,1,1
57284,53,57366,53,allow,165,86,79,2,30,1,1
55288,53,5668,53,allow,196,102,94,2,30,1,1
56939,53,41233,53,allow,322,134,188,2,30,1,1
55138,53,34483,53,allow,173,94,79,2,30,1,1
56257,53,40161,53,allow,177,94,83,2,30,1,1
55219,53,51728,53,allow,181,94,87,2,32,1,1
52718,53,15399,53,allow,164,78,86,2,30,1,1
49321,53,46028,53,allow,184,94,90,2,30,1,1
56068,53,7794,53,allow,152,78,74,2,30,1,1
55070,53,15674,53,allow,195,94,101,2,30,1,1
62506,443,7984,443,allow,1326,876,450,11,32,6,5
55903,53,48648,53,allow,177,94,83,2,30,1,1
53304,80,56632,80,allow,130,64,66,3,4,2,1
60707,80,12418,80,allow,144,78,66,2,5,1,1
49573,443,25314,443,allow,1820,1101,719,18,16,10,8
56572,53,22035,53,allow,177,94,83,2,29,1,1
56307,53,24670,53,allow,185,102,83,2,29,1,1
50175,53,55281,53,allow,196,102,94,2,30,1,1
64425,53,6282,53,allow,182,86,96,2,29,1,1
56439,53,22707,53,allow,177,94,83,2,29,1,1
55795,53,50908,53,allow,177,94,83,2,30,1,1
64560,53,45431,53,allow,807,94,713,2,30,1,1
56397,53,62027,53,allow,179,94,85,2,30,1,1
64698,53,15508,53,allow,763,102,661,2,30,1,1
56143,53,11476,53,allow,214,94,120,2,30,1,1
36687,53,34461,53,allow,168,78,90,2,31,1,1
56620,53,8741,53,allow,214,102,112,2,30,1,1
55871,53,54072,53,allow,189,102,87,2,30,1,1
55382,53,39381,53,allow,226,110,116,2,30,1,1
56594,53,16703,53,allow,167,86,81,2,30,1,1
50031,53,6210,53,allow,181,94,87,2,30,1,1
56216,53,54561,53,allow,177,94,83,2,30,1,1
56594,53,29488,53,allow,167,86,81,2,30,1,1
37052,53,37052,53,allow,178,82,96,2,30,1,1
55795,53,49814,53,allow,177,94,83,2,30,1,1
55138,53,34113,53,allow,165,86,79,2,30,1,1
50478,445,0,0,drop,70,70,0,1,0,1,0
50564,445,0,0,drop,66,66,0,1,0,1,0
50562,445,0,0,drop,66,66,0,1,0,1,0
49762,53,16917,53,allow,184,94,90,2,30,1,1
55107,53,13262,53,allow,184,94,90,2,30,1,1
55647,53,13562,53,allow,168,86,82,2,31,1,1
37322,53,64245,53,allow,168,78,90,2,31,1,1
49369,53,12483,53,allow,168,86,82,2,31,1,1
49369,53,65002,53,allow,168,86,82,2,30,1,1
49383,53,39251,53,allow,758,102,656,2,30,1,1
57431,53,3019,53,allow,181,94,87,2,31,1,1
57169,53,55765,53,allow,458,188,270,6,31,3,3
56397,53,56445,53,allow,179,94,85,2,31,1,1
55288,53,4599,53,allow,196,102,94,2,30,1,1
49760,53,59419,53,allow,183,94,89,2,30,1,1
57006,53,15142,53,allow,819,102,717,2,30,1,1
49633,53,11968,53,allow,168,86,82,2,30,1,1
49590,53,5842,53,allow,458,188,270,6,30,3,3
55318,53,12855,53,allow,167,86,81,2,30,1,1
56442,53,53594,53,allow,167,86,81,2,30,1,1
57304,53,49312,53,allow,228,110,118,2,31,1,1
55318,53,32183,53,allow,167,86,81,2,31,1,1
55155,445,0,0,drop,70,70,0,1,0,1,0
55154,445,0,0,drop,70,70,0,1,0,1,0
55151,445,0,0,drop,70,70,0,1,0,1,0
55146,445,0,0,drop,70,70,0,1,0,1,0
50464,445,0,0,drop,70,70,0,1,0,1,0
50463,445,0,0,drop,70,70,0,1,0,1,0
50460,445,0,0,drop,70,70,0,1,0,1,0
50453,445,0,0,drop,70,70,0,1,0,1,0
50454,445,0,0,drop,70,70,0,1,0,1,0
50561,445,0,0,drop,66,66,0,1,0,1,0
50553,445,0,0,drop,66,66,0,1,0,1,0
50552,445,0,0,drop,66,66,0,1,0,1,0
50549,445,0,0,drop,66,66,0,1,0,1,0
50548,445,0,0,drop,66,66,0,1,0,1,0
50545,445,0,0,drop,66,66,0,1,0,1,0
50546,445,0,0,drop,66,66,0,1,0,1,0
50543,445,0,0,drop,66,66,0,1,0,1,0
57239,123,0,0,deny,90,90,0,1,0,1,0
55140,445,0,0,drop,70,70,0,1,0,1,0
55136,445,0,0,drop,70,70,0,1,0,1,0
55133,445,0,0,drop,70,70,0,1,0,1,0
55132,445,0,0,drop,70,70,0,1,0,1,0
50442,445,0,0,drop,70,70,0,1,0,1,0
42030,25,0,0,deny,74,74,0,1,0,1,0
42608,1,0,0,deny,62,62,0,1,0,1,0
55130,445,0,0,drop,70,70,0,1,0,1,0
55131,445,0,0,drop,70,70,0,1,0,1,0
55128,445,0,0,drop,70,70,0,1,0,1,0
50438,445,0,0,drop,70,70,0,1,0,1,0
50537,445,0,0,drop,66,66,0,1,0,1,0
55123,445,0,0,drop,70,70,0,1,0,1,0
50535,445,0,0,drop,66,66,0,1,0,1,0
50532,445,0,0,drop,66,66,0,1,0,1,0
50533,445,0,0,drop,66,66,0,1,0,1,0
50427,445,0,0,drop,70,70,0,1,0,1,0
50429,445,0,0,drop,70,70,0,1,0,1,0
50426,445,0,0,drop,70,70,0,1,0,1,0
50530,445,0,0,drop,66,66,0,1,0,1,0
50423,445,0,0,drop,70,70,0,1,0,1,0
50421,445,0,0,drop,70,70,0,1,0,1,0
56182,53,55538,53,allow,762,98,664,2,0,1,1
55118,445,0,0,drop,70,70,0,1,0,1,0
55114,445,0,0,drop,70,70,0,1,0,1,0
55105,445,0,0,drop,70,70,0,1,0,1,0
50415,445,0,0,drop,70,70,0,1,0,1,0
50518,445,0,0,drop,66,66,0,1,0,1,0
50408,445,0,0,drop,70,70,0,1,0,1,0
50511,445,0,0,drop,66,66,0,1,0,1,0
50406,445,0,0,drop,70,70,0,1,0,1,0
55095,445,0,0,drop,70,70,0,1,0,1,0
50508,445,0,0,drop,66,66,0,1,0,1,0
50402,445,0,0,drop,70,70,0,1,0,1,0
50400,445,0,0,drop,70,70,0,1,0,1,0
50502,445,0,0,drop,66,66,0,1,0,1,0
50499,445,0,0,drop,66,66,0,1,0,1,0
50396,445,0,0,drop,70,70,0,1,0,1,0
50394,445,0,0,drop,70,70,0,1,0,1,0
44891,23,0,0,deny,60,60,0,1,0,1,0
55088,445,0,0,drop,70,70,0,1,0,1,0
55084,445,0,0,drop,70,70,0,1,0,1,0
55083,445,0,0,drop,70,70,0,1,0,1,0
50485,445,0,0,drop,66,66,0,1,0,1,0
50486,445,0,0,drop,66,66,0,1,0,1,0
50481,445,0,0,drop,66,66,0,1,0,1,0
49828,53,40540,53,allow,578,286,292,9,15,5,4
55318,53,35151,53,allow,166,85,81,2,30,1,1
49552,53,59587,53,allow,188,96,92,2,30,1,1
55445,53,56296,53,allow,711,87,624,2,30,1,1
49369,53,21699,53,allow,168,86,82,2,30,1,1
56748,53,43623,53,allow,184,94,90,2,31,1,1
56204,53,48985,53,allow,168,86,82,2,30,1,1
56822,53,60516,53,allow,184,94,90,2,30,1,1
64801,53,33594,53,allow,728,96,632,2,30,1,1
55638,53,11091,53,allow,168,86,82,2,30,1,1
49482,80,49482,80,allow,2444,1148,1296,14,48,7,7
42780,53,61676,53,allow,198,93,105,2,30,1,1
55774,53,26343,53,allow,701,88,613,2,30,1,1
57431,53,32621,53,allow,178,91,87,2,31,1,1
55088,53,52692,53,allow,170,87,83,2,31,1,1
56732,53,32710,53,allow,701,88,613,2,30,1,1
57038,53,16760,53,allow,188,96,92,2,30,1,1
45287,53,10390,53,allow,198,93,105,2,30,1,1
49633,53,21391,53,allow,168,86,82,2,30,1,1
41317,53,41317,53,allow,217,87,130,2,30,1,1
48906,53,48906,53,allow,217,87,130,2,30,1,1
65336,53,30958,53,allow,771,101,670,2,31,1,1
55702,53,21809,53,allow,761,100,661,2,31,1,1
55469,53,16063,53,allow,817,98,719,2,31,1,1
55107,53,40259,53,allow,184,94,90,2,30,1,1
56677,53,20003,53,allow,200,102,98,2,31,1,1
56765,53,1940,53,allow,188,96,92,2,31,1,1
49332,53,39051,53,allow,740,93,647,2,31,1,1
49870,53,21637,53,allow,188,96,92,2,31,1,1
55317,53,36634,53,allow,711,87,624,2,31,1,1
56439,53,38034,53,allow,196,100,96,2,31,1,1
56942,53,26338,53,allow,170,87,83,2,31,1,1
57269,53,41250,53,allow,182,93,89,2,31,1,1
56030,53,56239,53,allow,815,95,720,2,31,1,1
55478,53,12055,53,allow,170,87,83,2,31,1,1
56079,53,34259,53,allow,740,93,647,2,31,1,1
49480,53,59035,53,allow,184,94,90,2,31,1,1
65442,53,27260,53,allow,760,97,663,2,31,1,1
49540,53,42804,53,allow,754,94,660,2,31,1,1
50285,53,26837,53,allow,760,97,663,2,31,1,1
64941,53,34820,53,allow,295,101,194,4,31,2,2
64763,53,55818,53,allow,212,108,104,2,31,1,1
50479,445,0,0,drop,66,66,0,1,0,1,0
50480,445,0,0,drop,66,66,0,1,0,1,0
50482,445,0,0,drop,66,66,0,1,0,1,0
50484,445,0,0,drop,66,66,0,1,0,1,0
50478,445,0,0,drop,66,66,0,1,0,1,0
44044,23,0,0,deny,60,60,0,1,0,1,0
52363,123,30662,123,allow,184,94,90,2,30,1,1
55288,53,34566,53,allow,196,102,94,2,30,1,1
54996,53,14810,53,allow,168,86,82,2,31,1,1
64709,53,54232,53,allow,338,110,228,2,29,1,1
64683,53,62247,53,allow,198,102,96,2,29,1,1
64124,53,35184,53,allow,183,94,89,2,30,1,1
56442,53,30750,53,allow,167,86,81,2,30,1,1
55183,53,52172,53,allow,177,94,83,2,30,1,1
55107,53,25498,53,allow,184,94,90,2,30,1,1
56658,53,34980,53,allow,458,188,270,6,30,3,3
54136,80,25504,80,allow,1585,863,722,12,15,6,6
55903,53,64113,53,allow,177,94,83,2,29,1,1
50210,53,56208,53,allow,756,94,662,2,29,1,1
49321,53,38287,53,allow,184,94,90,2,29,1,1
64683,53,49305,53,allow,821,102,719,2,29,1,1
55647,53,31412,53,allow,168,86,82,2,29,1,1
50524,53,52843,53,allow,816,102,714,2,29,1,1
56677,53,7912,53,allow,200,102,98,2,30,1,1
49762,53,33292,53,allow,184,94,90,2,30,1,1
57297,53,52793,53,allow,242,102,140,2,30,1,1
49989,53,64218,53,allow,755,94,661,2,29,1,1
57284,53,33476,53,allow,173,94,79,2,29,1,1
54973,53,49914,53,allow,811,94,717,2,29,1,1
56204,53,61458,53,allow,168,86,82,2,30,1,1
57006,53,13462,53,allow,196,102,94,2,29,1,1
50524,53,62327,53,allow,193,102,91,2,30,1,1
64560,53,36010,53,allow,184,94,90,2,29,1,1
56688,53,13604,53,allow,196,102,94,2,29,1,1
49948,53,30662,53,allow,214,94,120,2,30,1,1
56041,53,5205,53,allow,183,94,89,2,30,1,1
55233,53,15536,53,allow,215,102,113,2,30,1,1
56822,53,28434,53,allow,184,94,90,2,30,1,1
43564,53,37702,53,allow,199,94,105,2,30,1,1
56041,53,23370,53,allow,183,94,89,2,30,1,1
54382,53,54382,53,allow,414,268,146,3,33,2,1
57228,53,50397,53,allow,344,94,250,2,30,1,1
56677,53,47518,53,allow,200,102,98,2,30,1,1
49552,53,25565,53,allow,194,102,92,2,30,1,1
56942,53,38411,53,allow,177,94,83,2,30,1,1
57431,53,54427,53,allow,181,94,87,2,30,1,1
55088,53,34841,53,allow,177,94,83,2,30,1,1
48095,53,40439,53,allow,199,94,105,2,30,1,1
56942,53,55677,53,allow,177,94,83,2,30,1,1
55823,53,52028,53,allow,210,102,108,2,30,1,1
56191,53,1757,53,allow,177,94,83,2,30,1,1
60863,53,60863,53,allow,298,114,184,2,30,1,1
64122,53,46704,53,allow,255,102,153,2,30,1,1
56531,53,17376,53,allow,309,94,215,2,30,1,1
56205,53,15763,53,allow,240,110,130,2,30,1,1
55753,53,0,0,allow,82,82,0,2,40,2,0
49563,80,54340,80,allow,1515,481,1034,11,15,6,5
49762,53,65280,53,allow,184,94,90,2,30,1,1
49552,53,34956,53,allow,194,102,92,2,30,1,1
56617,53,38232,53,allow,228,110,118,2,30,1,1
50421,443,23778,443,allow,562,222,340,9,26,4,5
49369,53,34405,53,allow,324,86,238,4,47,2,2
55647,53,8145,53,allow,168,86,82,2,30,1,1
64124,53,4238,53,allow,183,94,89,2,30,1,1
63948,53,52448,53,allow,366,102,264,4,60,2,2
55638,53,63082,53,allow,168,86,82,2,30,1,1
56204,53,36998,53,allow,168,86,82,2,30,1,1
57122,53,58221,53,allow,198,94,104,2,30,1,1
56111,53,27769,53,allow,227,110,117,2,30,1,1
49480,53,58009,53,allow,184,94,90,2,31,1,1
49671,53,50695,53,allow,335,117,218,4,36,2,2
57288,443,50391,443,allow,840,420,420,14,39,7,7
55089,80,46073,80,allow,1558,452,1106,11,15,6,5
44155,53,24482,53,allow,168,78,90,2,29,1,1
56872,53,25005,53,allow,443,182,261,6,29,3,3
56688,53,52079,53,allow,196,102,94,2,31,1,1
50672,80,28058,80,allow,1515,481,1034,11,16,6,5
56748,53,55168,53,allow,184,94,90,2,30,1,1
60213,80,45825,80,allow,70,70,0,1,4,1,0
55088,53,21749,53,allow,177,94,83,2,30,1,1
64124,53,27285,53,allow,294,93,201,4,42,2,2
49272,53,53692,53,allow,198,102,96,2,30,1,1
55871,53,26416,53,allow,181,94,87,2,29,1,1
62170,53,16163,53,allow,234,94,140,2,29,1,1
50279,53,54207,53,allow,749,94,655,2,29,1,1
56216,53,35008,53,allow,177,94,83,2,29,1,1
49760,53,45249,53,allow,183,94,89,2,29,1,1
55183,53,35427,53,allow,177,94,83,2,29,1,1
56257,53,40398,53,allow,177,94,83,2,29,1,1
55836,53,17348,53,allow,177,94,83,2,30,1,1
57422,53,31757,53,allow,821,102,719,2,30,1,1
49272,53,44204,53,allow,198,102,96,2,30,1,1
64072,80,14418,80,allow,314,192,122,6,15,4,2
56252,53,39340,53,allow,228,110,118,2,30,1,1
48443,53,3585,53,allow,168,78,90,2,30,1,1
56191,53,27279,53,allow,177,94,83,2,30,1,1
56748,53,15879,53,allow,184,94,90,2,30,1,1
56765,53,6433,53,allow,194,102,92,2,30,1,1
65240,53,35636,53,allow,755,102,653,2,30,1,1
55556,53,41769,53,allow,224,94,130,2,30,1,1
49495,53,39798,53,allow,758,102,656,2,31,1,1
49724,53,30037,53,allow,470,131,339,4,32,2,2
55097,53,3886,53,allow,324,102,222,4,42,2,2
61920,53,61920,53,allow,298,114,184,2,30,1,1
52686,53,56390,53,allow,199,94,105,2,30,1,1
57409,53,41368,53,allow,232,94,138,2,30,1,1
56982,53,26329,53,allow,193,94,99,2,30,1,1
57038,53,63930,53,allow,194,102,92,2,33,1,1
49216,53,56828,53,allow,274,94,180,2,30,1,1
55836,53,6468,53,allow,177,94,83,2,30,1,1
56678,53,49059,53,allow,240,110,130,2,30,1,1
55478,53,56587,53,allow,177,94,83,2,30,1,1
56822,53,60070,53,allow,184,94,90,2,30,1,1
57384,53,57923,53,allow,228,110,118,2,30,1,1
49821,53,3854,53,allow,265,94,171,2,30,1,1
56147,53,61785,53,allow,258,110,148,2,30,1,1
57422,53,42352,53,allow,198,102,96,2,30,1,1
49356,53,31993,53,allow,763,102,661,2,31,1,1
57269,53,5905,53,allow,183,94,89,2,30,1,1
64128,53,31311,53,allow,193,102,91,2,31,1,1
56020,53,55046,53,allow,168,86,82,2,30,1,1
56506,53,36137,53,allow,227,102,125,2,30,1,1
55478,53,54641,53,allow,177,94,83,2,30,1,1
49969,53,53673,53,allow,789,102,687,2,30,1,1
56863,53,12002,53,allow,177,94,83,2,31,1,1
56397,53,11047,53,allow,179,94,85,2,30,1,1
56942,53,10682,53,allow,177,94,83,2,31,1,1
56020,53,24675,53,allow,168,86,82,2,31,1,1
56439,53,35642,53,allow,198,102,96,2,31,1,1
49224,53,51489,53,allow,199,102,97,2,34,1,1
57269,53,43829,53,allow,183,94,89,2,30,1,1
49245,80,49245,80,allow,378,180,198,7,54,4,3
64094,1024,11634,1024,allow,66,66,0,2,8,2,0
57426,443,14949,443,allow,832,268,564,14,37,5,9
55082,445,0,0,drop,70,70,0,1,0,1,0
55081,445,0,0,drop,70,70,0,1,0,1,0
55075,445,0,0,drop,70,70,0,1,0,1,0
55067,445,0,0,drop,70,70,0,1,0,1,0
50466,445,0,0,drop,66,66,0,1,0,1,0
50465,445,0,0,drop,66,66,0,1,0,1,0
50463,445,0,0,drop,66,66,0,1,0,1,0
50377,445,0,0,drop,70,70,0,1,0,1,0
50372,445,0,0,drop,70,70,0,1,0,1,0
55063,445,0,0,drop,70,70,0,1,0,1,0
55059,445,0,0,drop,70,70,0,1,0,1,0
55055,445,0,0,drop,70,70,0,1,0,1,0
55056,445,0,0,drop,70,70,0,1,0,1,0
49220,22,0,0,deny,60,60,0,1,0,1,0
50367,445,0,0,drop,70,70,0,1,0,1,0
50366,445,0,0,drop,70,70,0,1,0,1,0
50364,445,0,0,drop,70,70,0,1,0,1,0
55045,445,0,0,drop,70,70,0,1,0,1,0
55044,445,0,0,drop,70,70,0,1,0,1,0
55039,445,0,0,drop,70,70,0,1,0,1,0
50453,445,0,0,drop,66,66,0,1,0,1,0
50357,445,0,0,drop,70,70,0,1,0,1,0
50355,445,0,0,drop,70,70,0,1,0,1,0
55038,445,0,0,drop,70,70,0,1,0,1,0
50354,445,0,0,drop,70,70,0,1,0,1,0
55037,445,0,0,drop,70,70,0,1,0,1,0
50353,445,0,0,drop,70,70,0,1,0,1,0
50352,445,0,0,drop,70,70,0,1,0,1,0
50346,445,0,0,drop,70,70,0,1,0,1,0
50347,445,0,0,drop,70,70,0,1,0,1,0
50436,445,0,0,drop,66,66,0,1,0,1,0
50437,445,0,0,drop,66,66,0,1,0,1,0
50334,445,0,0,drop,70,70,0,1,0,1,0
50333,445,0,0,drop,70,70,0,1,0,1,0
50331,445,0,0,drop,70,70,0,1,0,1,0
50324,445,0,0,drop,70,70,0,1,0,1,0
50323,445,0,0,drop,70,70,0,1,0,1,0
55027,445,0,0,drop,70,70,0,1,0,1,0
55026,445,0,0,drop,70,70,0,1,0,1,0
55024,445,0,0,drop,70,70,0,1,0,1,0
55020,445,0,0,drop,70,70,0,1,0,1,0
50432,445,0,0,drop,66,66,0,1,0,1,0
50426,445,0,0,drop,66,66,0,1,0,1,0
50427,445,0,0,drop,66,66,0,1,0,1,0
50425,445,0,0,drop,66,66,0,1,0,1,0
50422,445,0,0,drop,66,66,0,1,0,1,0
50421,445,0,0,drop,66,66,0,1,0,1,0
50418,445,0,0,drop,66,66,0,1,0,1,0
50415,445,0,0,drop,66,66,0,1,0,1,0
55010,445,0,0,drop,70,70,0,1,0,1,0
50312,445,0,0,drop,70,70,0,1,0,1,0
55008,445,0,0,drop,70,70,0,1,0,1,0
55006,445,0,0,drop,70,70,0,1,0,1,0
55004,445,0,0,drop,70,70,0,1,0,1,0
50308,445,0,0,drop,70,70,0,1,0,1,0
55003,445,0,0,drop,70,70,0,1,0,1,0
54997,445,0,0,drop,70,70,0,1,0,1,0
54996,445,0,0,drop,70,70,0,1,0,1,0
61802,23,0,0,deny,60,60,0,1,0,1,0
50409,445,0,0,drop,66,66,0,1,0,1,0
54995,445,0,0,drop,70,70,0,1,0,1,0
50298,445,0,0,drop,70,70,0,1,0,1,0
50297,445,0,0,drop,70,70,0,1,0,1,0
50299,445,0,0,drop,70,70,0,1,0,1,0
50407,445,0,0,drop,66,66,0,1,0,1,0
50293,445,0,0,drop,70,70,0,1,0,1,0
50405,445,0,0,drop,66,66,0,1,0,1,0
50403,445,0,0,drop,66,66,0,1,0,1,0
64737,53,51522,53,allow,757,98,659,2,0,1,1
50291,445,0,0,drop,70,70,0,1,0,1,0
50402,445,0,0,drop,66,66,0,1,0,1,0
54990,445,0,0,drop,70,70,0,1,0,1,0
54981,445,0,0,drop,70,70,0,1,0,1,0
54977,445,0,0,drop,70,70,0,1,0,1,0
50285,445,0,0,drop,70,70,0,1,0,1,0
50391,445,0,0,drop,66,66,0,1,0,1,0
50277,445,0,0,drop,70,70,0,1,0,1,0
50274,445,0,0,drop,70,70,0,1,0,1,0
50383,445,0,0,drop,66,66,0,1,0,1,0
54967,445,0,0,drop,70,70,0,1,0,1,0
50270,445,0,0,drop,70,70,0,1,0,1,0
50269,445,0,0,drop,70,70,0,1,0,1,0
50381,445,0,0,drop,66,66,0,1,0,1,0
50265,445,0,0,drop,70,70,0,1,0,1,0
50372,445,0,0,drop,66,66,0,1,0,1,0
64797,53,54337,53,allow,182,93,89,2,30,1,1
49685,80,12171,80,allow,1548,847,701,10,16,5,5
49243,80,49243,80,allow,378,180,198,7,53,4,3
49242,80,49242,80,allow,378,180,198,7,53,4,3
49272,53,7753,53,allow,196,100,96,2,30,1,1
55095,53,54084,53,allow,783,96,687,2,30,1,1
50630,53,37346,53,allow,754,94,660,2,30,1,1
56368,53,19580,53,allow,711,87,624,2,30,1,1
55893,53,33227,53,allow,267,94,173,4,56,2,2
55072,53,45639,53,allow,170,87,83,2,31,1,1
57134,53,30351,53,allow,190,97,93,2,30,1,1
55526,53,26801,53,allow,749,94,655,2,30,1,1
64128,53,32109,53,allow,186,95,91,2,30,1,1
57436,53,31842,53,allow,182,93,89,2,30,1,1
50600,53,50600,53,allow,257,101,156,2,34,1,1
57120,53,16635,53,allow,761,100,661,2,30,1,1
57139,53,57139,53,allow,235,90,145,2,32,1,1
55642,53,4187,53,allow,711,87,624,2,30,1,1
55633,53,54670,53,allow,816,97,719,2,30,1,1
56688,53,38230,53,allow,192,98,94,2,30,1,1
58035,53,58035,53,allow,237,91,146,2,32,1,1
52203,1024,52908,1024,allow,136,136,0,3,14,3,0
64779,53,1103,53,allow,810,108,702,2,30,1,1
56487,53,25181,53,allow,788,108,680,2,31,1,1
49364,53,25963,53,allow,307,307,0,4,61,4,0
55025,53,8549,53,allow,93,93,0,1,31,1,0
56424,53,11596,53,allow,170,87,83,2,31,1,1
56163,53,27486,53,allow,188,96,92,2,31,1,1
56020,53,48606,53,allow,168,86,82,2,31,1,1
55617,53,30754,53,allow,212,108,104,2,31,1,1
49929,53,57396,53,allow,212,108,104,2,31,1,1
64712,53,32542,53,allow,181,98,83,2,31,1,1
57144,53,3454,53,allow,172,88,84,2,31,1,1
54998,53,2972,53,allow,196,100,96,2,31,1,1
56603,53,10898,53,allow,174,89,85,2,31,1,1
50367,445,0,0,drop,66,66,0,1,0,1,0
50264,445,0,0,drop,70,70,0,1,0,1,0
65228,53,0,0,deny,88,88,0,1,0,1,0
50259,445,0,0,drop,70,70,0,1,0,1,0
54955,445,0,0,drop,70,70,0,1,0,1,0
54957,445,0,0,drop,70,70,0,1,0,1,0
54956,445,0,0,drop,70,70,0,1,0,1,0
50350,445,0,0,drop,66,66,0,1,0,1,0
50357,445,0,0,drop,66,66,0,1,0,1,0
50352,445,0,0,drop,66,66,0,1,0,1,0
50356,445,0,0,drop,66,66,0,1,0,1,0
50354,445,0,0,drop,66,66,0,1,0,1,0
50358,445,0,0,drop,66,66,0,1,0,1,0
50353,445,0,0,drop,66,66,0,1,0,1,0
50351,445,0,0,drop,66,66,0,1,0,1,0
54951,445,0,0,drop,70,70,0,1,0,1,0
54947,445,0,0,drop,70,70,0,1,0,1,0
54942,445,0,0,drop,70,70,0,1,0,1,0
54940,445,0,0,drop,70,70,0,1,0,1,0
50246,445,0,0,drop,70,70,0,1,0,1,0
50337,445,0,0,drop,66,66,0,1,0,1,0
50338,445,0,0,drop,66,66,0,1,0,1,0
50335,445,0,0,drop,66,66,0,1,0,1,0
50243,445,0,0,drop,70,70,0,1,0,1,0
54936,445,0,0,drop,70,70,0,1,0,1,0
54934,445,0,0,drop,70,70,0,1,0,1,0
54930,445,0,0,drop,70,70,0,1,0,1,0
54926,445,0,0,drop,70,70,0,1,0,1,0
50238,445,0,0,drop,70,70,0,1,0,1,0
49323,53,12095,53,allow,790,110,680,2,30,1,1
56652,53,23903,53,allow,821,102,719,2,30,1,1
64941,53,8617,53,allow,199,102,97,2,30,1,1
64797,53,56821,53,allow,183,94,89,2,30,1,1
49742,53,44369,53,allow,199,94,105,2,30,1,1
64763,53,53321,53,allow,214,110,104,2,30,1,1
49247,80,49247,80,allow,378,180,198,7,53,4,3
64075,1026,24378,1026,allow,70,70,0,1,4,1,0
55893,53,24260,53,allow,267,94,173,4,55,2,2
55318,53,26417,53,allow,167,86,81,2,29,1,1
65234,53,35438,53,allow,193,102,91,2,30,1,1
49272,53,2689,53,allow,198,102,96,2,29,1,1
57431,53,12541,53,allow,181,94,87,2,29,1,1
56971,53,24481,53,allow,195,102,93,2,30,1,1
49714,53,19961,53,allow,490,101,389,4,45,2,2
58785,53,54759,53,allow,211,86,125,2,30,1,1
50332,53,15195,53,allow,193,102,91,2,29,1,1
49402,53,62978,53,allow,214,110,104,2,30,1,1
57631,443,64255,443,allow,154,94,60,2,5,1,1
43829,443,59022,443,allow,368,160,208,6,33,3,3
50544,53,6922,53,allow,193,102,91,2,30,1,1
57269,53,63044,53,allow,183,94,89,2,30,1,1
49480,53,47457,53,allow,184,94,90,2,30,1,1
64750,53,43856,53,allow,193,102,91,2,30,1,1
49003,53,49003,53,allow,262,106,156,2,32,1,1
56750,80,10595,80,allow,194,128,66,4,25,3,1
65294,53,7465,53,allow,184,102,82,2,30,1,1
50544,53,48893,53,allow,816,102,714,2,30,1,1
42947,53,42947,53,allow,260,106,154,2,33,1,1
64640,53,17711,53,allow,249,94,155,2,30,1,1
65389,53,2887,53,allow,215,102,113,2,30,1,1
56652,53,12784,53,allow,198,102,96,2,30,1,1
65294,53,37568,53,allow,168,86,82,2,30,1,1
64268,53,55887,53,allow,679,179,500,6,69,3,3
65461,53,60419,53,allow,226,94,132,2,30,1,1
56688,53,20462,53,allow,196,102,94,2,30,1,1
64685,53,55702,53,allow,193,102,91,2,30,1,1
50241,53,51739,53,allow,184,102,82,2,30,1,1
57134,53,41374,53,allow,195,102,93,2,30,1,1
55478,53,55747,53,allow,177,94,83,2,30,1,1
55072,53,59629,53,allow,177,94,83,2,30,1,1
49480,53,12824,53,allow,184,94,90,2,30,1,1
57436,53,46375,53,allow,183,94,89,2,30,1,1
55958,53,32998,53,allow,177,94,83,2,30,1,1
64128,53,26433,53,allow,193,102,91,2,30,1,1
57436,53,1607,53,allow,183,94,89,2,30,1,1
49402,53,18505,53,allow,214,110,104,2,30,1,1
57063,53,34748,53,allow,177,94,83,2,30,1,1
49701,53,45217,53,allow,523,92,431,4,48,2,2
55958,53,17152,53,allow,177,94,83,2,30,1,1
52432,443,37828,443,allow,330,190,140,6,15,4,2
36433,80,4245,80,allow,1585,863,722,12,15,6,6
55062,53,27959,53,allow,194,94,100,2,31,1,1
56747,80,7383,80,allow,194,128,66,4,25,3,1
56748,80,43315,80,allow,194,128,66,4,25,3,1
50420,443,27192,443,allow,648,210,438,10,27,4,6
49246,80,49246,80,allow,378,180,198,7,53,4,3
55893,53,45153,53,allow,267,94,173,4,56,2,2
56204,53,64652,53,allow,168,86,82,2,29,1,1
56822,53,57328,53,allow,184,94,90,2,29,1,1
52160,443,26040,443,allow,956,420,536,15,26,7,8
55107,53,60741,53,allow,184,94,90,2,29,1,1
65070,53,12563,53,allow,198,102,96,2,30,1,1
58755,53,43262,53,allow,277,102,175,2,30,1,1
64815,53,31191,53,allow,214,110,104,2,30,1,1
56765,53,25229,53,allow,194,102,92,2,29,1,1
55088,53,51001,53,allow,177,94,83,2,29,1,1
52931,443,64191,443,allow,416,210,206,7,26,4,3
50332,53,12740,53,allow,193,102,91,2,29,1,1
56748,53,37401,53,allow,184,94,90,2,30,1,1
49775,80,50741,80,allow,254,128,126,5,16,3,2
56439,53,49648,53,allow,198,102,96,2,29,1,1
65258,53,18646,53,allow,763,102,661,2,30,1,1
56677,53,61027,53,allow,200,102,98,2,30,1,1
56863,53,37391,53,allow,177,94,83,2,30,1,1
64797,53,6795,53,allow,183,94,89,2,30,1,1
49870,53,17515,53,allow,194,102,92,2,30,1,1
57436,53,48007,53,allow,183,94,89,2,30,1,1
49418,53,2882,53,allow,165,86,79,2,30,1,1
65229,53,28081,53,allow,195,102,93,2,30,1,1
50369,53,47601,53,allow,166,86,80,2,30,1,1
37574,123,51434,123,allow,184,94,90,2,30,1,1
49308,53,30302,53,allow,195,102,93,2,31,1,1
64941,53,17276,53,allow,199,102,97,2,30,1,1
55072,53,7801,53,allow,177,94,83,2,30,1,1
49254,53,47857,53,allow,173,94,79,2,30,1,1
55072,53,28531,53,allow,177,94,83,2,30,1,1
57398,53,40796,53,allow,196,94,102,2,31,1,1
52434,80,48898,80,allow,1647,481,1166,13,15,6,7
56971,53,47465,53,allow,195,102,93,2,30,1,1
64763,53,14685,53,allow,214,110,104,2,30,1,1
56765,53,28041,53,allow,194,102,92,2,30,1,1
64797,53,38007,53,allow,183,94,89,2,30,1,1
65465,53,62433,53,allow,372,126,246,2,30,1,1
57063,53,54503,53,allow,177,94,83,2,30,1,1
57134,53,42837,53,allow,195,102,93,2,30,1,1
49402,53,34826,53,allow,214,110,104,2,30,1,1
57396,53,7718,53,allow,184,94,90,2,30,1,1
51714,123,49877,123,allow,184,94,90,2,30,1,1
55879,53,59038,53,allow,184,94,90,2,30,1,1
56163,53,47774,53,allow,194,102,92,2,30,1,1
56749,80,24129,80,allow,194,128,66,4,25,3,1
64815,53,51366,53,allow,214,110,104,2,30,1,1
49870,53,59356,53,allow,194,102,92,2,30,1,1
64599,53,27573,53,allow,398,102,296,2,30,1,1
56439,53,18376,53,allow,198,102,96,2,30,1,1
65181,53,41975,53,allow,421,96,325,4,42,2,2
65070,53,45301,53,allow,821,102,719,2,30,1,1
64748,53,54658,53,allow,212,102,110,2,30,1,1
64941,53,15219,53,allow,199,102,97,2,30,1,1
50241,53,32622,53,allow,184,102,82,2,30,1,1
56341,53,11727,53,allow,243,94,149,2,30,1,1
65229,53,50271,53,allow,195,102,93,2,30,1,1
57396,53,20662,53,allow,807,94,713,2,30,1,1
64685,53,47182,53,allow,193,102,91,2,30,1,1
49308,53,4514,53,allow,195,102,93,2,30,1,1
49703,53,62145,53,allow,228,110,118,2,30,1,1
64980,53,1256,53,allow,199,102,97,2,31,1,1
54998,53,21655,53,allow,198,102,96,2,31,1,1
57072,53,34434,53,allow,193,102,91,2,30,1,1
56332,53,17265,53,allow,193,102,91,2,30,1,1
55025,53,14358,53,allow,183,94,89,2,31,1,1
56332,53,36197,53,allow,193,102,91,2,31,1,1
65234,53,58797,53,allow,193,102,91,2,31,1,1
64710,53,45310,53,allow,195,102,93,2,31,1,1
56226,53,55576,53,allow,512,187,325,6,58,3,3
51992,443,50696,443,allow,1083,596,487,11,16,7,4
51993,443,1370,443,allow,1209,656,553,13,16,8,5
50237,445,0,0,drop,70,70,0,1,0,1,0
50235,445,0,0,drop,70,70,0,1,0,1,0
54916,445,0,0,drop,70,70,0,1,0,1,0
54913,445,0,0,drop,70,70,0,1,0,1,0
54911,445,0,0,drop,70,70,0,1,0,1,0
50325,445,0,0,drop,66,66,0,1,0,1,0
50228,445,0,0,drop,70,70,0,1,0,1,0
50226,445,0,0,drop,70,70,0,1,0,1,0
50225,445,0,0,drop,70,70,0,1,0,1,0
50224,445,0,0,drop,70,70,0,1,0,1,0
54910,445,0,0,drop,70,70,0,1,0,1,0
50223,445,0,0,drop,70,70,0,1,0,1,0
50219,445,0,0,drop,70,70,0,1,0,1,0
50217,445,0,0,drop,70,70,0,1,0,1,0
54909,445,0,0,drop,70,70,0,1,0,1,0
50310,445,0,0,drop,66,66,0,1,0,1,0
50308,445,0,0,drop,66,66,0,1,0,1,0
50198,445,0,0,drop,70,70,0,1,0,1,0
50205,445,0,0,drop,70,70,0,1,0,1,0
50204,445,0,0,drop,70,70,0,1,0,1,0
50195,445,0,0,drop,70,70,0,1,0,1,0
50194,445,0,0,drop,70,70,0,1,0,1,0
54898,445,0,0,drop,70,70,0,1,0,1,0
54899,445,0,0,drop,70,70,0,1,0,1,0
54895,445,0,0,drop,70,70,0,1,0,1,0
54892,445,0,0,drop,70,70,0,1,0,1,0
50303,445,0,0,drop,66,66,0,1,0,1,0
50291,445,0,0,drop,66,66,0,1,0,1,0
50296,445,0,0,drop,66,66,0,1,0,1,0
50293,445,0,0,drop,66,66,0,1,0,1,0
50288,445,0,0,drop,66,66,0,1,0,1,0
50295,445,0,0,drop,66,66,0,1,0,1,0
50297,445,0,0,drop,66,66,0,1,0,1,0
50287,445,0,0,drop,66,66,0,1,0,1,0
50183,445,0,0,drop,70,70,0,1,0,1,0
54882,445,0,0,drop,70,70,0,1,0,1,0
54880,445,0,0,drop,70,70,0,1,0,1,0
54879,445,0,0,drop,70,70,0,1,0,1,0
54876,445,0,0,drop,70,70,0,1,0,1,0
50179,445,0,0,drop,70,70,0,1,0,1,0
54874,445,0,0,drop,70,70,0,1,0,1,0
54869,445,0,0,drop,70,70,0,1,0,1,0
54868,445,0,0,drop,70,70,0,1,0,1,0
50169,445,0,0,drop,70,70,0,1,0,1,0
50167,445,0,0,drop,70,70,0,1,0,1,0
50170,445,0,0,drop,70,70,0,1,0,1,0
50280,445,0,0,drop,66,66,0,1,0,1,0
50164,445,0,0,drop,70,70,0,1,0,1,0
54867,445,0,0,drop,70,70,0,1,0,1,0
50162,445,0,0,drop,70,70,0,1,0,1,0
50279,445,0,0,drop,66,66,0,1,0,1,0
50277,445,0,0,drop,66,66,0,1,0,1,0
50276,445,0,0,drop,66,66,0,1,0,1,0
50274,445,0,0,drop,66,66,0,1,0,1,0
50156,445,0,0,drop,70,70,0,1,0,1,0
54857,445,0,0,drop,70,70,0,1,0,1,0
54849,445,0,0,drop,70,70,0,1,0,1,0
50263,445,0,0,drop,66,66,0,1,0,1,0
50149,445,0,0,drop,70,70,0,1,0,1,0
50146,445,0,0,drop,70,70,0,1,0,1,0
50337,53,56473,53,allow,762,97,665,2,30,1,1
64710,53,31226,53,allow,190,97,93,2,30,1,1
65234,53,64779,53,allow,186,95,91,2,31,1,1
49459,53,24594,53,allow,198,101,97,2,30,1,1
49308,53,20210,53,allow,190,97,93,2,30,1,1
64883,53,13274,53,allow,184,94,90,2,31,1,1
56247,53,34021,53,allow,751,95,656,2,30,1,1
55879,53,40028,53,allow,184,94,90,2,30,1,1
57115,53,47701,53,allow,172,88,84,2,30,1,1
36499,53,58408,53,allow,302,208,94,3,30,2,1
49941,53,34590,53,allow,186,95,91,2,31,1,1
64242,53,44715,53,allow,176,90,86,2,31,1,1
43718,53,43718,53,allow,209,77,132,2,34,1,1
64684,53,19854,53,allow,184,94,90,2,31,1,1
64685,53,52958,53,allow,186,95,91,2,30,1,1
58653,53,0,0,allow,82,82,0,1,30,1,0
57288,53,62463,53,allow,770,101,669,2,30,1,1
56332,53,50254,53,allow,186,95,91,2,30,1,1
65408,53,61605,53,allow,764,99,665,2,30,1,1
56606,53,17065,53,allow,762,97,665,2,31,1,1
49370,443,17640,443,allow,350,210,140,6,16,4,2
65206,53,9006,53,allow,762,98,664,2,30,1,1
55161,53,9497,53,allow,732,89,643,2,30,1,1
55579,53,14828,53,allow,172,88,84,2,30,1,1
53625,53,53625,53,allow,643,88,555,2,31,1,1
55273,53,3281,53,allow,764,99,665,2,31,1,1
64770,53,63194,53,allow,93,93,0,1,31,1,0
64639,53,5053,53,allow,198,101,97,2,31,1,1
57181,53,16955,53,allow,753,96,657,2,31,1,1
50455,53,22933,53,allow,756,95,661,2,30,1,1
57378,53,2616,53,allow,756,95,661,2,31,1,1
55799,53,31223,53,allow,752,93,659,2,31,1,1
64283,53,28343,53,allow,186,95,91,2,31,1,1
56864,53,65006,53,allow,200,102,98,2,31,1,1
55265,53,47317,53,allow,198,101,97,2,31,1,1
56622,53,51149,53,allow,757,98,659,2,31,1,1
50255,445,0,0,drop,66,66,0,1,0,1,0
50143,445,0,0,drop,70,70,0,1,0,1,0
54839,445,0,0,drop,70,70,0,1,0,1,0
50141,445,0,0,drop,70,70,0,1,0,1,0
55879,53,11765,53,allow,184,94,90,2,30,1,1
56603,53,24241,53,allow,179,94,85,2,30,1,1
64041,53,28808,53,allow,380,92,288,4,37,2,2
57354,53,64428,53,allow,198,94,104,2,29,1,1
49929,53,44359,53,allow,214,110,104,2,29,1,1
57134,53,24003,53,allow,195,102,93,2,29,1,1
51994,443,26093,443,allow,330,190,140,6,15,4,2
64997,53,32660,53,allow,771,102,669,2,29,1,1
64856,53,25050,53,allow,451,124,327,4,45,2,2
49459,53,5838,53,allow,199,102,97,2,29,1,1
49254,53,63665,53,allow,173,94,79,2,29,1,1
60914,53,60914,53,allow,180,82,98,2,29,1,1
57072,53,31261,53,allow,816,102,714,2,29,1,1
49586,53,25001,53,allow,212,94,118,2,29,1,1
54998,53,23774,53,allow,198,102,96,2,29,1,1
64883,53,48996,53,allow,184,94,90,2,30,1,1
55255,53,4437,53,allow,282,94,188,2,29,1,1
50369,53,17923,53,allow,166,86,80,2,29,1,1
56424,53,45965,53,allow,177,94,83,2,29,1,1
64885,53,14280,53,allow,261,102,159,2,29,1,1
48982,53,28037,53,allow,306,212,94,3,29,2,1
55462,53,64670,53,allow,214,110,104,2,29,1,1
64980,53,27979,53,allow,199,102,97,2,29,1,1
64641,53,5011,53,allow,260,102,158,2,30,1,1
64968,53,62769,53,allow,767,102,665,2,30,1,1
55372,53,44494,53,allow,199,102,97,2,30,1,1
49907,53,22787,53,allow,199,102,97,2,30,1,1
49342,53,2621,53,allow,200,102,98,2,30,1,1
47665,443,4370,443,allow,214,140,74,4,15,3,1
64490,53,23595,53,allow,280,118,162,2,30,1,1
64175,53,22231,53,allow,453,100,353,4,57,2,2
50700,80,7989,80,allow,142,142,0,1,5,1,0
64495,53,28201,53,allow,243,94,149,2,30,1,1
64988,53,6131,53,allow,360,110,250,2,30,1,1
55723,80,12672,80,allow,70,70,0,2,8,2,0
65344,53,6284,53,allow,211,102,109,2,30,1,1
65366,53,65366,53,allow,244,98,146,2,33,1,1
49853,53,4793,53,allow,291,102,189,2,30,1,1
56424,53,21857,53,allow,177,94,83,2,30,1,1
56163,53,9366,53,allow,194,102,92,2,30,1,1
55617,53,46139,53,allow,214,110,104,2,30,1,1
64883,53,2709,53,allow,184,94,90,2,30,1,1
49437,53,49111,53,allow,498,204,294,6,30,3,3
64712,53,1546,53,allow,177,94,83,2,30,1,1
57144,53,45834,53,allow,178,94,84,2,30,1,1
57411,443,31872,443,allow,214,140,74,4,15,3,1
55516,53,62536,53,allow,211,102,109,2,30,1,1
49326,53,31358,53,allow,193,102,91,2,31,1,1
55579,53,62219,53,allow,178,94,84,2,30,1,1
49941,53,13341,53,allow,193,102,91,2,30,1,1
37694,80,28033,80,allow,1190,591,599,8,15,5,3
55893,53,44273,53,allow,267,94,173,4,55,2,2
44320,443,32394,443,allow,154,94,60,2,4,1,1
64750,53,24687,53,allow,193,102,91,2,29,1,1
52701,443,13239,443,allow,130,70,60,3,5,2,1
49352,53,51513,53,allow,216,102,114,2,29,1,1
55071,53,30463,53,allow,356,118,238,2,29,1,1
56424,53,8677,53,allow,177,94,83,2,29,1,1
57409,443,54706,443,allow,1054,567,487,10,15,6,4
55462,53,19938,53,allow,214,110,104,2,29,1,1
51688,123,9497,123,allow,184,94,90,2,29,1,1
64242,53,3579,53,allow,180,94,86,2,30,1,1
55144,53,13694,53,allow,316,94,222,2,29,1,1
57115,53,18402,53,allow,178,94,84,2,30,1,1
44517,53,22276,53,allow,306,212,94,3,29,2,1
55879,53,9895,53,allow,184,94,90,2,29,1,1
49418,53,32330,53,allow,165,86,79,2,29,1,1
57115,53,57243,53,allow,178,94,84,2,29,1,1
49929,53,53934,53,allow,214,110,104,2,30,1,1
64710,53,1727,53,allow,195,102,93,2,29,1,1
64684,53,47246,53,allow,184,94,90,2,30,1,1
55617,53,20605,53,allow,214,110,104,2,30,1,1
64684,53,48311,53,allow,184,94,90,2,30,1,1
64171,53,30410,53,allow,94,94,0,1,30,1,0
49459,53,33594,53,allow,199,102,97,2,30,1,1
57144,53,55905,53,allow,178,94,84,2,30,1,1
65236,53,5620,53,allow,758,102,656,2,30,1,1
55372,53,36344,53,allow,199,102,97,2,30,1,1
49342,53,62127,53,allow,200,102,98,2,30,1,1
64522,53,42718,53,allow,230,102,128,2,31,1,1
55786,53,43858,53,allow,177,94,83,2,31,1,1
49941,53,58431,53,allow,193,102,91,2,30,1,1
49469,53,2393,53,allow,185,102,83,2,30,1,1
56603,53,17293,53,allow,179,94,85,2,30,1,1
65075,53,5602,53,allow,164,86,78,2,31,1,1
49459,53,35212,53,allow,199,102,97,2,31,1,1
53723,443,51817,443,allow,70,70,0,1,5,1,0
51910,443,32865,443,allow,308,188,120,4,15,2,2
45109,443,9498,443,allow,190,70,120,4,15,2,2
64568,53,24682,53,allow,388,134,254,2,30,1,1
50316,53,18070,53,allow,816,102,714,2,30,1,1
65518,53,59686,53,allow,211,102,109,2,30,1,1
49277,53,14856,53,allow,230,102,128,2,30,1,1
47663,443,61725,443,allow,214,140,74,4,15,3,1
49374,53,26527,53,allow,199,94,105,2,30,1,1
55617,53,11638,53,allow,214,110,104,2,30,1,1
64242,53,41761,53,allow,180,94,86,2,30,1,1
65028,53,13338,53,allow,763,102,661,2,30,1,1
55579,53,12007,53,allow,178,94,84,2,30,1,1
50316,53,39379,53,allow,193,102,91,2,30,1,1
56008,53,22150,53,allow,230,86,144,2,30,1,1
56603,53,28698,53,allow,179,94,85,2,30,1,1
49342,53,56835,53,allow,200,102,98,2,30,1,1
51913,443,51764,443,allow,190,70,120,4,15,2,2
37952,80,16690,80,allow,1372,868,504,13,35,8,5
57115,53,1229,53,allow,178,94,84,2,30,1,1
65154,53,12899,53,allow,196,94,102,2,30,1,1
55820,53,19644,53,allow,194,102,92,2,30,1,1
49941,53,57941,53,allow,193,102,91,2,31,1,1
64283,53,30888,53,allow,193,102,91,2,31,1,1
56882,53,12251,53,allow,87,87,0,2,60,2,0
65322,53,59723,53,allow,235,94,141,2,30,1,1
42121,53,52822,53,allow,199,94,105,2,31,1,1
65090,53,63161,53,allow,230,102,128,2,31,1,1
50294,53,23372,53,allow,178,94,84,2,30,1,1
65515,53,18245,53,allow,195,102,93,2,31,1,1
49469,53,45496,53,allow,177,94,83,2,30,1,1
64639,53,49663,53,allow,199,102,97,2,31,1,1
58381,53,27908,53,allow,199,94,105,2,31,1,1
57793,53,34542,53,allow,168,78,90,2,31,1,1
64684,53,15819,53,allow,184,94,90,2,31,1,1
64724,53,50975,53,allow,195,102,93,2,31,1,1
56332,53,61425,53,allow,193,102,91,2,31,1,1
54998,53,27657,53,allow,198,102,96,2,31,1,1
65234,53,47492,53,allow,193,102,91,2,31,1,1
56079,53,14640,53,allow,199,102,97,2,31,1,1
50191,53,52829,53,allow,182,102,80,2,30,1,1
49512,53,60222,53,allow,195,102,93,2,31,1,1
37912,443,31339,443,allow,130,70,60,3,5,2,1
49913,53,48535,53,allow,493,94,399,4,40,2,2
49982,53,15818,53,allow,322,94,228,4,49,2,2
55820,53,60004,53,allow,194,102,92,2,31,1,1
50730,443,7850,443,allow,1323,738,585,10,16,6,4
50252,445,0,0,drop,66,66,0,1,0,1,0
50137,445,0,0,drop,70,70,0,1,0,1,0
50246,445,0,0,drop,66,66,0,1,0,1,0
50136,445,0,0,drop,70,70,0,1,0,1,0
50239,445,0,0,drop,66,66,0,1,0,1,0
50131,445,0,0,drop,70,70,0,1,0,1,0
54830,445,0,0,drop,70,70,0,1,0,1,0
54828,445,0,0,drop,70,70,0,1,0,1,0
54827,445,0,0,drop,70,70,0,1,0,1,0
50229,445,0,0,drop,66,66,0,1,0,1,0
50230,445,0,0,drop,66,66,0,1,0,1,0
50226,445,0,0,drop,66,66,0,1,0,1,0
50225,445,0,0,drop,66,66,0,1,0,1,0
50228,445,0,0,drop,66,66,0,1,0,1,0
50222,445,0,0,drop,66,66,0,1,0,1,0
50224,445,0,0,drop,66,66,0,1,0,1,0
50223,445,0,0,drop,66,66,0,1,0,1,0
50828,23,0,0,deny,60,60,0,1,0,1,0
50118,445,0,0,drop,70,70,0,1,0,1,0
54821,445,0,0,drop,70,70,0,1,0,1,0
54816,445,0,0,drop,70,70,0,1,0,1,0
54814,445,0,0,drop,70,70,0,1,0,1,0
54811,445,0,0,drop,70,70,0,1,0,1,0
50115,445,0,0,drop,70,70,0,1,0,1,0
50210,445,0,0,drop,66,66,0,1,0,1,0
50208,445,0,0,drop,66,66,0,1,0,1,0
50207,445,0,0,drop,66,66,0,1,0,1,0
54808,445,0,0,drop,70,70,0,1,0,1,0
50111,445,0,0,drop,70,70,0,1,0,1,0
54803,445,0,0,drop,70,70,0,1,0,1,0
54797,445,0,0,drop,70,70,0,1,0,1,0
54795,445,0,0,drop,70,70,0,1,0,1,0
50109,445,0,0,drop,70,70,0,1,0,1,0
50107,445,0,0,drop,70,70,0,1,0,1,0
56102,53,3387,53,allow,757,98,659,2,0,1,1
54788,445,0,0,drop,70,70,0,1,0,1,0
54787,445,0,0,drop,70,70,0,1,0,1,0
54783,445,0,0,drop,70,70,0,1,0,1,0
50100,445,0,0,drop,70,70,0,1,0,1,0
50198,445,0,0,drop,66,66,0,1,0,1,0
50098,445,0,0,drop,70,70,0,1,0,1,0
50097,445,0,0,drop,70,70,0,1,0,1,0
50096,445,0,0,drop,70,70,0,1,0,1,0
50095,445,0,0,drop,70,70,0,1,0,1,0
50089,445,0,0,drop,70,70,0,1,0,1,0
50092,445,0,0,drop,70,70,0,1,0,1,0
54782,445,0,0,drop,70,70,0,1,0,1,0
54781,445,0,0,drop,70,70,0,1,0,1,0
50076,445,0,0,drop,70,70,0,1,0,1,0
50075,445,0,0,drop,70,70,0,1,0,1,0
50070,445,0,0,drop,70,70,0,1,0,1,0
50065,445,0,0,drop,70,70,0,1,0,1,0
50066,445,0,0,drop,70,70,0,1,0,1,0
50182,445,0,0,drop,66,66,0,1,0,1,0
50180,445,0,0,drop,66,66,0,1,0,1,0
54768,445,0,0,deny,70,70,0,1,0,1,0
54767,445,0,0,drop,70,70,0,1,0,1,0
54766,445,0,0,drop,70,70,0,1,0,1,0
54760,445,0,0,drop,70,70,0,1,0,1,0
50174,445,0,0,drop,66,66,0,1,0,1,0
50054,445,0,0,drop,70,70,0,1,0,1,0
50164,445,0,0,drop,66,66,0,1,0,1,0
50169,445,0,0,drop,66,66,0,1,0,1,0
50171,445,0,0,drop,66,66,0,1,0,1,0
50168,445,0,0,drop,66,66,0,1,0,1,0
50162,445,0,0,drop,66,66,0,1,0,1,0
50161,445,0,0,drop,66,66,0,1,0,1,0
50159,445,0,0,drop,66,66,0,1,0,1,0
54757,445,0,0,drop,70,70,0,1,0,1,0
54752,445,0,0,drop,70,70,0,1,0,1,0
54749,445,0,0,drop,70,70,0,1,0,1,0
54748,445,0,0,drop,70,70,0,1,0,1,0
50050,445,0,0,drop,70,70,0,1,0,1,0
50041,445,0,0,drop,70,70,0,1,0,1,0
50040,445,0,0,drop,70,70,0,1,0,1,0
50039,445,0,0,drop,70,70,0,1,0,1,0
50035,445,0,0,drop,70,70,0,1,0,1,0
54740,445,0,0,drop,70,70,0,1,0,1,0
54745,445,0,0,drop,70,70,0,1,0,1,0
54743,445,0,0,drop,70,70,0,1,0,1,0
50033,445,0,0,drop,70,70,0,1,0,1,0
50153,445,0,0,drop,66,66,0,1,0,1,0
54739,445,0,0,drop,70,70,0,1,0,1,0
50151,445,0,0,drop,66,66,0,1,0,1,0
50149,445,0,0,drop,66,66,0,1,0,1,0
50148,445,0,0,drop,66,66,0,1,0,1,0
50146,445,0,0,drop,66,66,0,1,0,1,0
56258,53,45112,53,allow,166,85,81,2,31,1,1
57002,53,38861,53,allow,731,85,646,2,30,1,1
49514,53,50895,53,allow,780,93,687,2,30,1,1
55325,53,12048,53,allow,762,101,661,2,30,1,1
57265,53,26246,53,allow,762,98,664,2,30,1,1
56079,53,63600,53,allow,198,101,97,2,31,1,1
64724,53,10875,53,allow,190,97,93,2,31,1,1
64789,53,3910,53,allow,198,101,97,2,30,1,1
65006,53,31072,53,allow,793,101,692,2,30,1,1
39462,80,39462,80,allow,1058,497,561,10,16,6,4
54234,53,54234,53,allow,237,91,146,2,33,1,1
49512,53,53127,53,allow,190,97,93,2,31,1,1
38520,53,38520,53,allow,231,88,143,2,34,1,1
64149,53,35596,53,allow,301,108,193,4,50,2,2
63607,53,63607,53,allow,643,88,555,2,30,1,1
49342,53,37970,53,allow,200,102,98,2,30,1,1
56812,53,46886,53,allow,767,102,665,2,30,1,1
64937,53,10087,53,allow,182,93,89,2,31,1,1
64937,53,22410,53,allow,182,93,89,2,31,1,1
64332,53,28123,53,allow,166,85,81,2,31,1,1
55711,53,33941,53,allow,733,93,640,2,31,1,1
64217,53,58721,53,allow,186,95,91,2,31,1,1
57411,53,22912,53,allow,192,98,94,2,31,1,1
48229,53,48229,53,allow,213,87,126,2,31,1,1
55820,53,24388,53,allow,188,96,92,2,31,1,1
64815,123,8798,123,allow,184,94,90,2,31,1,1
50636,53,31294,53,allow,772,100,672,2,31,1,1
49907,53,44048,53,allow,198,101,97,2,31,1,1
55646,53,23408,53,allow,182,93,89,2,31,1,1
56724,53,16788,53,allow,190,97,93,2,31,1,1
55615,53,23565,53,allow,772,100,672,2,31,1,1
50027,445,0,0,drop,70,70,0,1,0,1,0
54735,445,0,0,drop,70,70,0,1,0,1,0
54727,445,0,0,drop,70,70,0,1,0,1,0
54721,445,0,0,drop,70,70,0,1,0,1,0
50020,445,0,0,drop,70,70,0,1,0,1,0
50018,445,0,0,drop,70,70,0,1,0,1,0
56258,53,19240,53,allow,167,86,81,2,30,1,1
56745,80,35194,80,allow,214,140,74,4,25,3,1
50135,445,0,0,drop,66,66,0,1,0,1,0
50014,445,0,0,drop,70,70,0,1,0,1,0
50012,445,0,0,drop,70,70,0,1,0,1,0
50127,445,0,0,drop,66,66,0,1,0,1,0
54711,445,0,0,drop,70,70,0,1,0,1,0
50008,445,0,0,drop,70,70,0,1,0,1,0
50125,445,0,0,drop,66,66,0,1,0,1,0
50007,445,0,0,drop,70,70,0,1,0,1,0
64322,53,60744,53,allow,273,90,183,4,33,2,2
64307,53,35303,53,allow,241,94,147,2,30,1,1
49880,53,5726,53,allow,194,102,92,2,30,1,1
55265,53,4151,53,allow,199,102,97,2,30,1,1
56115,53,60323,53,allow,167,86,81,2,30,1,1
56115,53,18486,53,allow,167,86,81,2,30,1,1
65452,53,19191,53,allow,196,102,94,2,30,1,1
64789,53,27915,53,allow,199,102,97,2,30,1,1
65515,53,18334,53,allow,195,102,93,2,29,1,1
64882,53,29551,53,allow,230,102,128,2,29,1,1
65076,53,51472,53,allow,215,94,121,2,29,1,1
57054,53,52774,53,allow,241,94,147,2,29,1,1
56131,53,35553,53,allow,199,94,105,2,29,1,1
49939,53,35198,53,allow,231,102,129,2,29,1,1
49166,53,17612,53,allow,322,102,220,2,30,1,1
64789,53,49397,53,allow,199,102,97,2,30,1,1
56400,53,1687,53,allow,196,102,94,2,30,1,1
56538,53,20855,53,allow,401,95,306,4,57,2,2
64149,53,6477,53,allow,301,108,193,4,49,2,2
64930,53,11667,53,allow,317,96,221,4,32,2,2
49279,53,50429,53,allow,199,102,97,2,29,1,1
49929,53,22603,53,allow,214,110,104,2,29,1,1
64283,53,44589,53,allow,193,102,91,2,29,1,1
49177,443,40595,443,allow,840,700,140,13,59,11,2
64710,53,5594,53,allow,195,102,93,2,29,1,1
49836,53,26222,53,allow,889,404,485,10,29,5,5
64935,53,15324,53,allow,193,102,91,2,31,1,1
65199,53,15810,53,allow,215,94,121,2,30,1,1
64606,53,12951,53,allow,290,102,188,2,30,1,1
38320,53,38320,53,allow,260,106,154,2,32,1,1
55598,53,62889,53,allow,186,102,84,2,30,1,1
65220,53,21177,53,allow,184,94,90,2,30,1,1
57137,53,46999,53,allow,279,96,183,4,32,2,2
64404,53,7876,53,allow,251,110,141,2,30,1,1
49965,53,10762,53,allow,226,110,116,2,30,1,1
49280,53,63122,53,allow,167,86,81,2,30,1,1
55273,53,48247,53,allow,197,94,103,2,30,1,1
55265,53,44071,53,allow,199,102,97,2,30,1,1
49448,53,38995,53,allow,195,94,101,2,30,1,1
64789,53,51641,53,allow,199,102,97,2,30,1,1
49280,53,8666,53,allow,167,86,81,2,30,1,1
50011,53,47474,53,allow,1398,98,1300,4,31,2,2
49291,53,30701,53,allow,759,102,657,2,30,1,1
64217,53,23995,53,allow,193,102,91,2,30,1,1
64283,53,27743,53,allow,193,102,91,2,30,1,1
50681,80,59849,80,allow,318,192,126,6,26,4,2
64639,53,21872,53,allow,199,102,97,2,30,1,1
64719,53,55102,53,allow,263,118,145,2,30,1,1
64149,53,17311,53,allow,301,108,193,4,49,2,2
55797,53,43104,53,allow,194,102,92,2,30,1,1
64724,53,43750,53,allow,195,102,93,2,30,1,1
55797,53,58246,53,allow,817,102,715,2,30,1,1
56258,53,24780,53,allow,167,86,81,2,30,1,1
57309,53,4070,53,allow,197,102,95,2,30,1,1
64603,53,49089,53,allow,269,110,159,2,30,1,1
42686,53,42686,53,allow,262,106,156,2,32,1,1
64854,53,54158,53,allow,260,102,158,2,30,1,1
63965,53,1139,53,allow,214,102,112,2,30,1,1
55100,53,15692,53,allow,182,102,80,2,30,1,1
55094,53,35029,53,allow,244,94,150,2,30,1,1
65452,53,12771,53,allow,819,102,717,2,30,1,1
56864,53,28207,53,allow,200,102,98,2,30,1,1
65260,53,63253,53,allow,184,94,90,2,30,1,1
49512,53,36100,53,allow,195,102,93,2,30,1,1
49326,53,56607,53,allow,193,102,91,2,31,1,1
49554,53,46723,53,allow,541,201,340,6,64,3,3
63985,53,11526,53,allow,351,103,248,4,46,2,2
55254,53,23493,53,allow,195,102,93,2,30,1,1
65075,53,61185,53,allow,172,94,78,2,30,1,1
55254,53,12306,53,allow,195,102,93,2,30,1,1
55026,53,51536,53,allow,164,86,78,2,30,1,1
65176,53,19712,53,allow,299,99,200,4,45,2,2
64883,53,45539,53,allow,292,94,198,4,57,2,2
55579,53,24866,53,allow,178,94,84,2,29,1,1
49308,53,35422,53,allow,320,97,223,4,50,2,2
50191,53,41237,53,allow,182,102,80,2,29,1,1
56775,53,62594,53,allow,200,94,106,2,29,1,1
64550,53,62266,53,allow,221,94,127,2,29,1,1
50294,53,34116,53,allow,178,94,84,2,29,1,1
55754,53,55090,53,allow,199,102,97,2,30,1,1
56079,53,40631,53,allow,199,102,97,2,29,1,1
56864,53,5721,53,allow,200,102,98,2,30,1,1
57144,53,1605,53,allow,178,94,84,2,29,1,1
55348,53,24176,53,allow,498,204,294,6,30,3,3
56864,53,8861,53,allow,200,102,98,2,30,1,1
56020,53,56318,53,allow,168,86,82,2,29,1,1
55598,53,46757,53,allow,186,102,84,2,30,1,1
56332,53,33283,53,allow,199,102,97,2,29,1,1
50316,53,38175,53,allow,753,94,659,2,29,1,1
64895,53,61625,53,allow,199,102,97,2,30,1,1
49407,53,19099,53,allow,209,102,107,2,30,1,1
49248,53,8891,53,allow,211,102,109,2,30,1,1
65063,53,59913,53,allow,340,94,246,2,30,1,1
49697,53,43942,53,allow,195,94,101,2,30,1,1
55087,53,1147,53,allow,183,94,89,2,31,1,1
65377,53,44573,53,allow,193,102,91,2,31,1,1
49880,53,16831,53,allow,817,102,715,2,30,1,1
59119,53,4964,53,allow,168,78,90,2,30,1,1
57411,53,7355,53,allow,196,102,94,2,30,1,1
37833,53,37833,53,allow,222,90,132,2,30,1,1
49585,53,39603,53,allow,732,86,646,2,30,1,1
64639,53,46471,53,allow,199,102,97,2,30,1,1
55786,53,44397,53,allow,177,94,83,2,30,1,1
45899,53,19119,53,allow,168,78,90,2,30,1,1
65201,53,5254,53,allow,288,94,194,2,30,1,1
49974,53,0,0,allow,86,86,0,1,30,1,0
49907,53,32516,53,allow,199,102,97,2,30,1,1
55265,53,65356,53,allow,199,102,97,2,30,1,1
55044,53,38715,53,allow,196,102,94,2,30,1,1
49314,53,60410,53,allow,214,94,120,2,30,1,1
54816,53,4342,53,allow,168,78,90,2,30,1,1
36245,53,44289,53,allow,168,78,90,2,30,1,1
55100,53,34612,53,allow,182,102,80,2,30,1,1
44505,53,44505,53,allow,216,90,126,2,30,1,1
56400,53,12520,53,allow,819,102,717,2,30,1,1
65377,53,29691,53,allow,193,102,91,2,30,1,1
45676,123,45676,123,allow,184,94,90,2,30,1,1
56660,53,55953,53,allow,183,94,89,2,31,1,1
49198,53,18910,53,allow,164,78,86,2,31,1,1
55044,53,10792,53,allow,196,102,94,2,31,1,1
64724,53,63918,53,allow,319,97,222,4,31,2,2
56079,53,1064,53,allow,199,102,97,2,31,1,1
57137,53,9212,53,allow,279,96,183,4,32,2,2
53281,80,26227,80,allow,124,64,60,3,5,2,1
49217,53,30696,53,allow,282,93,189,4,45,2,2
49260,53,23458,53,allow,199,86,113,2,30,1,1
65496,53,1852,53,allow,198,94,104,2,31,1,1
40072,80,29014,80,allow,1298,370,928,12,15,6,6
49217,53,45409,53,allow,282,93,189,4,45,2,2
49217,53,50933,53,allow,282,93,189,4,45,2,2
49420,80,13977,80,allow,1985,657,1328,11,21,6,5
64149,53,19971,53,allow,301,108,193,4,49,2,2
64961,53,7551,53,allow,243,110,133,2,30,1,1
64758,53,8387,53,allow,734,94,640,2,30,1,1
65260,53,12231,53,allow,184,94,90,2,30,1,1
64332,53,6045,53,allow,167,86,81,2,30,1,1
50116,445,0,0,drop,66,66,0,1,0,1,0
50113,445,0,0,drop,66,66,0,1,0,1,0
50002,445,0,0,drop,70,70,0,1,0,1,0
54701,445,0,0,drop,70,70,0,1,0,1,0
54702,445,0,0,drop,70,70,0,1,0,1,0
54699,445,0,0,drop,70,70,0,1,0,1,0
50102,445,0,0,drop,66,66,0,1,0,1,0
50098,445,0,0,drop,66,66,0,1,0,1,0
50101,445,0,0,drop,66,66,0,1,0,1,0
50100,445,0,0,drop,66,66,0,1,0,1,0
50095,445,0,0,drop,66,66,0,1,0,1,0
50099,445,0,0,drop,66,66,0,1,0,1,0
50097,445,0,0,drop,66,66,0,1,0,1,0
50094,445,0,0,drop,66,66,0,1,0,1,0
49989,445,0,0,drop,70,70,0,1,0,1,0
49986,445,0,0,drop,70,70,0,1,0,1,0
54695,445,0,0,drop,70,70,0,1,0,1,0
54689,445,0,0,drop,70,70,0,1,0,1,0
54688,445,0,0,drop,70,70,0,1,0,1,0
54683,445,0,0,drop,70,70,0,1,0,1,0
50080,445,0,0,drop,66,66,0,1,0,1,0
50082,445,0,0,drop,66,66,0,1,0,1,0
50079,445,0,0,drop,66,66,0,1,0,1,0
49981,445,0,0,drop,70,70,0,1,0,1,0
35974,23,0,0,deny,60,60,0,1,0,1,0
54679,445,0,0,drop,70,70,0,1,0,1,0
49980,445,0,0,drop,70,70,0,1,0,1,0
54678,445,0,0,drop,70,70,0,1,0,1,0
54675,445,0,0,drop,70,70,0,1,0,1,0
54667,445,0,0,drop,70,70,0,1,0,1,0
49978,445,0,0,drop,70,70,0,1,0,1,0
49971,445,0,0,drop,70,70,0,1,0,1,0
54660,445,0,0,drop,70,70,0,1,0,1,0
54657,445,0,0,drop,70,70,0,1,0,1,0
54655,445,0,0,drop,70,70,0,1,0,1,0
49969,445,0,0,drop,70,70,0,1,0,1,0
50068,445,0,0,drop,66,66,0,1,0,1,0
49968,445,0,0,drop,70,70,0,1,0,1,0
49967,445,0,0,drop,70,70,0,1,0,1,0
49966,445,0,0,drop,70,70,0,1,0,1,0
49961,445,0,0,drop,70,70,0,1,0,1,0
49960,445,0,0,drop,70,70,0,1,0,1,0
54654,445,0,0,drop,70,70,0,1,0,1,0
54650,445,0,0,drop,70,70,0,1,0,1,0
49948,445,0,0,drop,70,70,0,1,0,1,0
49945,445,0,0,drop,70,70,0,1,0,1,0
49938,445,0,0,drop,70,70,0,1,0,1,0
49937,445,0,0,drop,70,70,0,1,0,1,0
50055,445,0,0,drop,66,66,0,1,0,1,0
50050,445,0,0,drop,66,66,0,1,0,1,0
54642,445,0,0,drop,70,70,0,1,0,1,0
54640,445,0,0,drop,70,70,0,1,0,1,0
54639,445,0,0,drop,70,70,0,1,0,1,0
54633,445,0,0,drop,70,70,0,1,0,1,0
49926,445,0,0,drop,70,70,0,1,0,1,0
50047,445,0,0,drop,66,66,0,1,0,1,0
50033,445,0,0,drop,66,66,0,1,0,1,0
50043,445,0,0,drop,66,66,0,1,0,1,0
50031,445,0,0,drop,66,66,0,1,0,1,0
50036,445,0,0,drop,66,66,0,1,0,1,0
50040,445,0,0,drop,66,66,0,1,0,1,0
50038,445,0,0,drop,66,66,0,1,0,1,0
50035,445,0,0,drop,66,66,0,1,0,1,0
54629,445,0,0,drop,70,70,0,1,0,1,0
54624,445,0,0,drop,70,70,0,1,0,1,0
54621,445,0,0,drop,70,70,0,1,0,1,0
54620,445,0,0,deny,70,70,0,1,0,1,0
49922,445,0,0,drop,70,70,0,1,0,1,0
49911,445,0,0,drop,70,70,0,1,0,1,0
49910,445,0,0,drop,70,70,0,1,0,1,0
49913,445,0,0,drop,70,70,0,1,0,1,0
49774,80,42910,80,allow,254,128,126,5,15,3,2
64818,53,5282,53,allow,174,89,85,2,30,1,1
57309,53,11380,53,allow,194,99,95,2,30,1,1
55646,53,12583,53,allow,780,93,687,2,30,1,1
64322,53,46348,53,allow,273,90,183,4,32,2,2
56664,80,24275,80,allow,1056,682,374,10,15,6,4
64944,53,44996,53,allow,749,89,660,2,30,1,1
64701,53,64701,53,allow,265,111,154,2,30,1,1
55856,53,9134,53,allow,1410,93,1317,4,59,2,2
49326,53,16602,53,allow,186,95,91,2,30,1,1
49224,53,33872,53,allow,198,101,97,2,30,1,1
55564,53,50276,53,allow,775,103,672,2,30,1,1
49582,53,42965,53,allow,775,103,672,2,30,1,1
62218,53,62218,53,allow,253,99,154,2,33,1,1
53947,867,6908,867,allow,70,70,0,1,5,1,0
41803,53,41803,53,allow,243,104,139,2,30,1,1
50497,53,25431,53,allow,747,93,654,2,30,1,1
55044,53,9273,53,allow,192,98,94,2,30,1,1
44125,53,44125,53,allow,209,79,130,2,30,1,1
64895,53,11867,53,allow,198,101,97,2,30,1,1
65220,53,41846,53,allow,184,94,90,2,30,1,1
63560,53,63560,53,allow,209,79,130,2,30,1,1
55257,53,9976,53,allow,749,89,660,2,30,1,1
65260,53,38236,53,allow,184,94,90,2,30,1,1
49901,53,54026,53,allow,776,102,674,2,30,1,1
65224,53,48832,53,allow,758,93,665,2,30,1,1
55087,53,55975,53,allow,182,93,89,2,31,1,1
64935,53,11961,53,allow,186,95,91,2,31,1,1
55646,53,54569,53,allow,182,93,89,2,30,1,1
57188,53,44023,53,allow,186,95,91,2,30,1,1
57130,53,10466,53,allow,778,103,675,2,31,1,1
55530,53,3862,53,allow,758,93,665,2,31,1,1
36017,53,46700,53,allow,198,93,105,2,31,1,1
45459,53,25942,53,allow,198,93,105,2,31,1,1
54994,53,24459,53,allow,202,103,99,2,31,1,1
55627,53,20054,53,allow,174,89,85,2,31,1,1
64930,53,64696,53,allow,186,95,91,2,31,1,1
65377,53,42499,53,allow,186,95,91,2,31,1,1
55377,53,47893,53,allow,190,97,93,2,31,1,1
55654,53,20360,53,allow,726,85,641,2,31,1,1
55932,53,16236,53,allow,202,103,99,2,31,1,1
56389,53,11725,53,allow,774,101,673,2,31,1,1
49237,53,49766,53,allow,735,88,647,2,31,1,1
49629,53,36000,53,allow,196,100,96,2,31,1,1
56790,53,5516,53,allow,747,92,655,2,31,1,1
56180,53,32734,53,allow,200,102,98,2,31,1,1
49343,53,32839,53,allow,202,103,99,2,31,1,1
44290,53,27070,53,allow,240,76,164,2,31,1,1
55005,53,54882,53,allow,182,93,89,2,31,1,1
55637,53,24847,53,allow,202,103,99,2,31,1,1
55675,53,42703,53,allow,196,100,96,2,31,1,1
56002,53,4276,53,allow,771,101,670,2,31,1,1
55014,53,9068,53,allow,716,95,621,2,31,1,1
57051,53,27315,53,allow,170,87,83,2,31,1,1
64752,53,55237,53,allow,190,97,93,2,31,1,1
56317,53,55686,53,allow,182,93,89,2,31,1,1
56569,53,23106,53,allow,182,93,89,2,31,1,1
57137,53,2649,53,allow,279,96,183,4,31,2,2
65373,53,60314,53,allow,194,99,95,2,31,1,1
57401,53,41706,53,allow,174,89,85,2,31,1,1
49909,445,0,0,deny,70,70,0,1,0,1,0
49905,445,0,0,drop,70,70,0,1,0,1,0
54619,445,0,0,drop,70,70,0,1,0,1,0
54615,445,0,0,drop,70,70,0,1,0,1,0
54612,445,0,0,drop,70,70,0,1,0,1,0
54611,445,0,0,drop,70,70,0,1,0,1,0
50023,445,0,0,drop,66,66,0,1,0,1,0
65530,53,49295,53,allow,381,88,293,4,31,2,2
56660,53,34940,53,allow,183,94,89,2,30,1,1
64712,53,32713,53,allow,210,102,108,2,30,1,1
64469,53,32950,53,allow,342,97,245,4,42,2,2
49907,53,54297,53,allow,199,102,97,2,29,1,1
55044,53,52145,53,allow,196,102,94,2,29,1,1
64146,53,19064,53,allow,212,102,110,2,29,1,1
57188,53,20332,53,allow,193,102,91,2,30,1,1
64332,53,46508,53,allow,167,86,81,2,30,1,1
56724,53,52473,53,allow,195,102,93,2,30,1,1
45195,80,65375,80,allow,1115,534,581,12,15,7,5
64322,53,46298,53,allow,273,90,183,4,32,2,2
49430,53,28668,53,allow,332,99,233,4,45,2,2
65186,53,51165,53,allow,521,90,431,4,43,2,2
57188,53,35661,53,allow,193,102,91,2,29,1,1
64217,53,31853,53,allow,193,102,91,2,29,1,1
63957,53,44993,53,allow,214,94,120,2,29,1,1
56258,53,14638,53,allow,167,86,81,2,29,1,1
64930,53,29648,53,allow,193,102,91,2,29,1,1
57411,53,32246,53,allow,196,102,94,2,29,1,1
49512,53,26273,53,allow,195,102,93,2,30,1,1
56724,53,34585,53,allow,308,97,211,4,45,2,2
46102,80,6915,80,allow,70,70,0,2,5,2,0
64846,53,55957,53,allow,785,110,675,2,30,1,1
64895,53,65185,53,allow,199,102,97,2,30,1,1
49655,53,33441,53,allow,209,110,99,2,30,1,1
55005,53,64520,53,allow,183,94,89,2,30,1,1
64978,53,11316,53,allow,198,102,96,2,30,1,1
64816,123,36690,123,allow,184,94,90,2,30,1,1
57309,53,8457,53,allow,197,102,95,2,30,1,1
65220,53,17734,53,allow,303,94,209,4,32,2,2
52165,80,35107,80,allow,1945,1002,943,11,19,7,4
55087,53,26632,53,allow,183,94,89,2,30,1,1
64685,53,47486,53,allow,785,110,675,2,30,1,1
64978,53,20864,53,allow,198,102,96,2,30,1,1
64818,53,60686,53,allow,179,94,85,2,30,1,1
49520,53,1147,53,allow,209,110,99,2,30,1,1
65144,53,32702,53,allow,653,86,567,4,46,2,2
57137,53,36481,53,allow,279,96,183,4,31,2,2
60803,80,16464,80,allow,254,128,126,5,15,3,2
46101,80,15092,80,allow,70,70,0,2,5,2,0
49491,53,15104,53,allow,492,94,398,4,45,2,2
49196,53,15790,53,allow,181,94,87,2,33,1,1
49888,53,58972,53,allow,363,97,266,4,34,2,2
65220,53,7048,53,allow,184,94,90,2,29,1,1
56724,53,41138,53,allow,195,102,93,2,29,1,1
49629,53,2341,53,allow,198,102,96,2,29,1,1
64895,53,23891,53,allow,199,102,97,2,29,1,1
55026,53,39957,53,allow,164,86,78,2,29,1,1
49483,53,61034,53,allow,319,94,225,2,29,1,1
57309,53,6657,53,allow,197,102,95,2,29,1,1
65496,53,50374,53,allow,183,94,89,2,30,1,1
64937,53,43310,53,allow,183,94,89,2,29,1,1
55646,53,3427,53,allow,183,94,89,2,30,1,1
64355,53,3739,53,allow,213,102,111,2,30,1,1
65496,53,50300,53,allow,183,94,89,2,30,1,1
55600,53,4581,53,allow,209,110,99,2,30,1,1
55939,53,57194,53,allow,193,102,91,2,31,1,1
50137,53,53286,53,allow,448,184,264,6,31,3,3
54979,53,64417,53,allow,183,94,89,2,30,1,1
57375,53,3463,53,allow,198,102,96,2,30,1,1
55637,53,12301,53,allow,209,110,99,2,30,1,1
65373,53,2835,53,allow,197,102,95,2,30,1,1
57270,53,64569,53,allow,200,102,98,2,30,1,1
64930,53,28381,53,allow,193,102,91,2,31,1,1
55477,53,61973,53,allow,183,94,89,2,31,1,1
55087,53,19901,53,allow,183,94,89,2,31,1,1
64578,53,31792,53,allow,193,102,91,2,31,1,1
57067,53,21723,53,allow,183,94,89,2,31,1,1
55675,53,21127,53,allow,198,102,96,2,30,1,1
46103,80,5613,80,allow,70,70,0,2,5,2,0
65260,53,28900,53,allow,184,94,90,2,30,1,1
54979,53,11444,53,allow,183,94,89,2,30,1,1
55060,53,22947,53,allow,195,102,93,2,30,1,1
56317,53,35779,53,allow,183,94,89,2,31,1,1
49326,53,62713,53,allow,193,102,91,2,30,1,1
49224,53,25602,53,allow,199,102,97,2,30,1,1
64332,53,40499,53,allow,167,86,81,2,30,1,1
55224,53,5980,53,allow,209,110,99,2,30,1,1
55224,53,33137,53,allow,209,110,99,2,30,1,1
49376,53,19245,53,allow,209,110,99,2,30,1,1
57401,53,56934,53,allow,179,94,85,2,31,1,1
36926,53,54098,53,allow,164,78,86,2,30,1,1
65462,53,20337,53,allow,196,102,94,2,33,1,1
46099,80,56104,80,allow,70,70,0,2,5,2,0
65350,53,8382,53,allow,390,105,285,4,42,2,2
56660,53,40707,53,allow,183,94,89,2,30,1,1
49782,53,28643,53,allow,228,86,142,2,30,1,1
49269,53,11598,53,allow,254,102,152,2,30,1,1
49655,53,32746,53,allow,209,110,99,2,30,1,1
64911,53,65363,53,allow,232,86,146,2,30,1,1
46902,123,43333,123,allow,184,94,90,2,30,1,1
57411,53,35330,53,allow,196,102,94,2,30,1,1
64217,53,33943,53,allow,193,102,91,2,30,1,1
55820,53,49367,53,allow,194,102,92,2,30,1,1
56317,53,26526,53,allow,183,94,89,2,30,1,1
55377,53,41334,53,allow,195,102,93,2,30,1,1
49734,53,51597,53,allow,259,110,149,2,30,1,1
52859,53,16412,53,allow,164,78,86,2,30,1,1
55477,53,62006,53,allow,183,94,89,2,30,1,1
64637,53,39523,53,allow,194,102,92,2,31,1,1
49277,53,15554,53,allow,199,102,97,2,31,1,1
49488,53,28678,53,allow,194,102,92,2,31,1,1
49376,53,53542,53,allow,209,110,99,2,30,1,1
50296,53,13683,53,allow,183,94,89,2,30,1,1
42060,53,44916,53,allow,164,78,86,2,30,1,1
55675,53,47376,53,allow,198,102,96,2,30,1,1
57375,53,63119,53,allow,198,102,96,2,30,1,1
49546,53,30362,53,allow,193,102,91,2,30,1,1
55060,53,16844,53,allow,195,102,93,2,30,1,1
57270,53,53677,53,allow,200,102,98,2,31,1,1
43093,53,41079,53,allow,242,78,164,2,30,1,1
65385,53,41370,53,allow,259,110,149,2,30,1,1
64869,53,31516,53,allow,195,94,101,2,30,1,1
65373,53,50644,53,allow,197,102,95,2,31,1,1
56754,53,50250,53,allow,209,110,99,2,30,1,1
65356,53,60802,53,allow,197,94,103,2,31,1,1
54994,53,25626,53,allow,209,110,99,2,31,1,1
65106,53,25747,53,allow,772,102,670,2,30,1,1
64899,53,5067,53,allow,199,102,97,2,31,1,1
55627,53,32877,53,allow,179,94,85,2,30,1,1
65336,53,55246,53,allow,200,102,98,2,30,1,1
56754,53,42272,53,allow,209,110,99,2,30,1,1
64899,53,16096,53,allow,199,102,97,2,30,1,1
59366,53,31679,53,allow,242,78,164,2,30,1,1
59951,53,55881,53,allow,237,86,151,2,30,1,1
50437,53,50192,53,allow,413,170,243,6,30,3,3
55377,53,45027,53,allow,195,102,93,2,30,1,1
49907,53,52196,53,allow,199,102,97,2,30,1,1
55763,53,36537,53,allow,197,94,103,2,31,1,1
64957,53,39699,53,allow,196,102,94,2,30,1,1
49294,53,26484,53,allow,723,102,621,2,30,1,1
49680,53,31932,53,allow,749,94,655,2,30,1,1
65403,53,11897,53,allow,199,102,97,2,31,1,1
49629,53,65217,53,allow,198,102,96,2,31,1,1
38149,53,54452,53,allow,199,94,105,2,31,1,1
55932,53,30562,53,allow,209,110,99,2,31,1,1
49539,53,54919,53,allow,198,94,104,2,31,1,1
64957,53,56586,53,allow,196,102,94,2,31,1,1
64322,53,37052,53,allow,273,90,183,4,32,2,2
65377,53,64134,53,allow,404,95,309,4,49,2,2
50021,445,0,0,drop,66,66,0,1,0,1,0
50019,445,0,0,drop,66,66,0,1,0,1,0
50018,445,0,0,drop,66,66,0,1,0,1,0
49900,445,0,0,drop,70,70,0,1,0,1,0
54610,445,0,0,drop,70,70,0,1,0,1,0
54602,445,0,0,drop,70,70,0,1,0,1,0
54594,445,0,0,drop,70,70,0,1,0,1,0
49892,445,0,0,drop,70,70,0,1,0,1,0
49890,445,0,0,drop,70,70,0,1,0,1,0
50007,445,0,0,drop,66,66,0,1,0,1,0
49885,445,0,0,drop,70,70,0,1,0,1,0
49884,445,0,0,drop,70,70,0,1,0,1,0
49999,445,0,0,drop,66,66,0,1,0,1,0
54583,445,0,0,drop,70,70,0,1,0,1,0
49880,445,0,0,drop,70,70,0,1,0,1,0
49997,445,0,0,drop,66,66,0,1,0,1,0
49879,445,0,0,drop,70,70,0,1,0,1,0
46516,80,0,0,deny,60,60,0,1,0,1,0
49990,445,0,0,drop,66,66,0,1,0,1,0
49982,445,0,0,drop,66,66,0,1,0,1,0
49874,445,0,0,drop,70,70,0,1,0,1,0
54573,445,0,0,drop,70,70,0,1,0,1,0
54572,445,0,0,drop,70,70,0,1,0,1,0
54571,445,0,0,drop,70,70,0,1,0,1,0
49966,445,0,0,drop,66,66,0,1,0,1,0
49973,445,0,0,drop,66,66,0,1,0,1,0
49971,445,0,0,drop,66,66,0,1,0,1,0
49972,445,0,0,drop,66,66,0,1,0,1,0
49968,445,0,0,drop,66,66,0,1,0,1,0
49974,445,0,0,drop,66,66,0,1,0,1,0
49970,445,0,0,drop,66,66,0,1,0,1,0
49969,445,0,0,drop,66,66,0,1,0,1,0
49861,445,0,0,drop,70,70,0,1,0,1,0
49858,445,0,0,drop,70,70,0,1,0,1,0
54569,445,0,0,drop,70,70,0,1,0,1,0
54567,445,0,0,drop,70,70,0,1,0,1,0
54563,445,0,0,drop,70,70,0,1,0,1,0
54559,445,0,0,drop,70,70,0,1,0,1,0
49954,445,0,0,drop,66,66,0,1,0,1,0
49952,445,0,0,drop,66,66,0,1,0,1,0
49953,445,0,0,drop,66,66,0,1,0,1,0
49853,445,0,0,drop,70,70,0,1,0,1,0
49852,445,0,0,drop,70,70,0,1,0,1,0
49850,445,0,0,drop,70,70,0,1,0,1,0
54551,445,0,0,drop,70,70,0,1,0,1,0
54550,445,0,0,drop,70,70,0,1,0,1,0
54547,445,0,0,drop,70,70,0,1,0,1,0
54539,445,0,0,drop,70,70,0,1,0,1,0
49843,445,0,0,drop,70,70,0,1,0,1,0
49841,445,0,0,drop,70,70,0,1,0,1,0
54531,445,0,0,drop,70,70,0,1,0,1,0
54529,445,0,0,drop,70,70,0,1,0,1,0
54530,445,0,0,drop,70,70,0,1,0,1,0
49840,445,0,0,drop,70,70,0,1,0,1,0
49839,445,0,0,deny,70,70,0,1,0,1,0
49940,445,0,0,drop,66,66,0,1,0,1,0
49838,445,0,0,drop,70,70,0,1,0,1,0
49832,445,0,0,drop,70,70,0,1,0,1,0
49834,445,0,0,drop,70,70,0,1,0,1,0
49820,445,0,0,drop,70,70,0,1,0,1,0
49818,445,0,0,drop,70,70,0,1,0,1,0
54526,445,0,0,drop,70,70,0,1,0,1,0
49813,445,0,0,drop,70,70,0,1,0,1,0
49809,445,0,0,drop,70,70,0,1,0,1,0
49808,445,0,0,drop,70,70,0,1,0,1,0
54525,445,0,0,drop,70,70,0,1,0,1,0
49927,445,0,0,drop,66,66,0,1,0,1,0
49924,445,0,0,drop,66,66,0,1,0,1,0
49797,445,0,0,drop,70,70,0,1,0,1,0
54516,445,0,0,drop,70,70,0,1,0,1,0
54510,445,0,0,drop,70,70,0,1,0,1,0
54506,445,0,0,drop,70,70,0,1,0,1,0
54508,445,0,0,drop,70,70,0,1,0,1,0
49920,445,0,0,drop,66,66,0,1,0,1,0
40780,80,6352,80,allow,1155,781,374,10,16,6,4
55999,53,41388,53,allow,774,101,673,2,30,1,1
53751,53,53289,53,allow,578,286,292,9,16,5,4
52172,80,27126,80,allow,362,240,122,7,17,5,2
64957,53,47584,53,allow,192,98,94,2,30,1,1
57067,53,57189,53,allow,182,93,89,2,30,1,1
40039,80,57862,80,allow,1155,781,374,10,15,6,4
41620,53,41620,53,allow,257,101,156,2,32,1,1
59924,443,2445,443,allow,682,310,372,12,68,6,6
52169,80,44471,80,allow,362,240,122,7,17,5,2
55555,53,19089,53,allow,778,103,675,2,30,1,1
50336,53,11367,53,allow,240,76,164,2,30,1,1
49618,53,25113,53,allow,774,101,673,2,30,1,1
56330,53,9857,53,allow,271,95,176,4,48,2,2
64899,53,35861,53,allow,198,101,97,2,30,1,1
56715,53,5613,53,allow,1384,88,1296,4,32,2,2
57452,53,53868,53,allow,776,102,674,2,30,1,1
56385,53,50019,53,allow,249,85,164,4,56,2,2
64559,53,6054,53,allow,196,100,96,2,31,1,1
64578,53,53350,53,allow,186,95,91,2,31,1,1
52170,80,60754,80,allow,362,240,122,7,17,5,2
52173,80,40738,80,allow,362,240,122,7,17,5,2
64340,53,64340,53,allow,237,91,146,2,33,1,1
47276,443,53172,443,allow,190,70,120,4,15,2,2
61822,53,61822,53,allow,237,91,146,2,33,1,1
57356,53,60821,53,allow,198,101,97,2,30,1,1
65370,53,60115,53,allow,186,95,91,2,31,1,1
65346,53,45745,53,allow,182,93,89,2,31,1,1
64204,53,3889,53,allow,186,95,91,2,31,1,1
55933,53,2538,53,allow,180,92,88,2,30,1,1
51052,53,0,0,allow,82,82,0,1,30,1,0
50356,53,7944,53,allow,176,90,86,2,31,1,1
49382,53,52485,53,allow,200,102,98,2,31,1,1
49671,53,37210,53,allow,182,93,89,2,31,1,1
65127,53,25987,53,allow,780,104,676,2,31,1,1
55436,53,43899,53,allow,774,101,673,2,30,1,1
56672,53,28355,53,allow,198,101,97,2,31,1,1
64569,53,10194,53,allow,182,93,89,2,31,1,1
57035,53,19895,53,allow,198,101,97,2,31,1,1
49798,53,59206,53,allow,192,98,94,2,31,1,1
64048,53,43444,53,allow,202,103,99,2,31,1,1
49869,53,53726,53,allow,202,103,99,2,31,1,1
55951,53,2710,53,allow,780,104,676,2,31,1,1
56951,53,25007,53,allow,198,101,97,2,31,1,1
56941,53,4680,53,allow,192,98,94,2,31,1,1
65292,53,23690,53,allow,190,97,93,2,31,1,1
49380,53,10250,53,allow,198,101,97,2,31,1,1
65526,53,17062,53,allow,198,101,97,2,31,1,1
64288,53,10803,53,allow,182,93,89,2,31,1,1
49331,53,64999,53,allow,180,92,88,2,31,1,1
49911,445,0,0,drop,66,66,0,1,0,1,0
49909,445,0,0,drop,66,66,0,1,0,1,0
49914,445,0,0,drop,66,66,0,1,0,1,0
49910,445,0,0,drop,66,66,0,1,0,1,0
49905,445,0,0,drop,66,66,0,1,0,1,0
49908,445,0,0,drop,66,66,0,1,0,1,0
49903,445,0,0,drop,66,66,0,1,0,1,0
38503,25,0,0,deny,60,60,0,1,0,1,0
54501,445,0,0,drop,70,70,0,1,0,1,0
49793,445,0,0,drop,70,70,0,1,0,1,0
65530,53,21720,53,allow,167,86,81,2,30,1,1
56569,53,13010,53,allow,183,94,89,2,30,1,1
56385,53,3618,53,allow,249,85,164,4,55,2,2
49277,53,20518,53,allow,199,102,97,2,30,1,1
64752,53,29277,53,allow,195,102,93,2,30,1,1
64276,53,2363,53,allow,354,102,252,2,30,1,1
55933,53,42992,53,allow,182,94,88,2,30,1,1
54994,53,3788,53,allow,209,110,99,2,30,1,1
49437,53,23949,53,allow,199,102,97,2,30,1,1
57356,53,19968,53,allow,199,102,97,2,30,1,1
55600,53,6191,53,allow,209,110,99,2,29,1,1
53373,53,58629,53,allow,242,78,164,2,29,1,1
57067,53,18004,53,allow,183,94,89,2,29,1,1
65403,53,40925,53,allow,199,102,97,2,29,1,1
49546,53,27218,53,allow,193,102,91,2,30,1,1
64238,53,6347,53,allow,215,102,113,2,30,1,1
56330,53,48374,53,allow,271,95,176,4,47,2,2
49437,53,10171,53,allow,199,102,97,2,30,1,1
52128,80,31768,80,allow,366,240,126,7,26,5,2
54139,80,14592,80,allow,1515,481,1034,11,15,6,5
52124,80,5847,80,allow,366,240,126,7,26,5,2
36145,443,14544,443,allow,1439,878,561,15,17,10,5
49479,53,55939,53,allow,213,94,119,2,29,1,1
55005,53,24549,53,allow,183,94,89,2,30,1,1
65339,53,4097,53,allow,775,102,673,2,30,1,1
64559,53,8772,53,allow,198,102,96,2,30,1,1
64048,53,38443,53,allow,209,110,99,2,30,1,1
49382,53,23594,53,allow,200,102,98,2,30,1,1
49552,53,39720,53,allow,102,102,0,1,30,1,0
49869,53,64308,53,allow,209,110,99,2,30,1,1
37602,53,37602,53,allow,260,106,154,2,32,1,1
55939,53,43027,53,allow,193,102,91,2,30,1,1
56330,53,40178,53,allow,271,95,176,4,48,2,2
36101,53,61383,53,allow,168,78,90,2,30,1,1
55749,53,21707,53,allow,413,170,243,6,30,3,3
55637,53,58251,53,allow,209,110,99,2,30,1,1
56569,53,53689,53,allow,183,94,89,2,30,1,1
55932,53,22197,53,allow,209,110,99,2,30,1,1
55653,53,34737,53,allow,199,102,97,2,30,1,1
64559,53,63710,53,allow,198,102,96,2,30,1,1
49629,53,5781,53,allow,198,102,96,2,30,1,1
57295,53,34997,53,allow,448,184,264,6,30,3,3
56941,53,63824,53,allow,196,102,94,2,30,1,1
56941,53,56569,53,allow,193,102,91,2,30,1,1
55675,53,48589,53,allow,198,102,96,2,30,1,1
55182,53,17791,53,allow,199,102,97,2,30,1,1
65292,53,4110,53,allow,195,102,93,2,30,1,1
55182,53,55293,53,allow,199,102,97,2,30,1,1
56941,53,44223,53,allow,196,102,94,2,30,1,1
65260,53,8952,53,allow,199,102,97,2,30,1,1
64976,53,35202,53,allow,229,102,127,2,30,1,1
56672,53,28150,53,allow,199,102,97,2,30,1,1
41322,53,41322,53,allow,244,98,146,2,32,1,1
56180,53,31487,53,allow,200,102,98,2,30,1,1
54106,53,53865,53,allow,164,78,86,2,30,1,1
55933,53,60713,53,allow,182,94,88,2,30,1,1
57401,53,48123,53,allow,179,94,85,2,30,1,1
57356,53,26396,53,allow,199,102,97,2,30,1,1
55932,53,3248,53,allow,209,110,99,2,30,1,1
65260,53,3983,53,allow,199,102,97,2,30,1,1
55764,53,63898,53,allow,250,94,156,2,30,1,1
54994,53,62711,53,allow,209,110,99,2,30,1,1
55377,53,33641,53,allow,195,102,93,2,30,1,1
56180,53,37696,53,allow,200,102,98,2,30,1,1
49343,53,1518,53,allow,209,110,99,2,30,1,1
65513,53,51212,53,allow,216,102,114,2,30,1,1
49284,53,41000,53,allow,195,86,109,2,30,1,1
56180,53,15802,53,allow,200,102,98,2,30,1,1
49650,53,58699,53,allow,539,97,442,4,58,2,2
56330,53,41814,53,allow,271,95,176,4,47,2,2
39194,53,39194,53,allow,414,268,146,3,32,2,1
38977,53,0,0,allow,82,82,0,2,40,2,0
64132,53,20663,53,allow,381,102,279,4,42,2,2
57188,53,28885,53,allow,193,102,91,2,29,1,1
49520,53,8068,53,allow,209,110,99,2,29,1,1
55637,53,5558,53,allow,209,110,99,2,29,1,1
64935,53,54508,53,allow,193,102,91,2,29,1,1
50296,53,43204,53,allow,183,94,89,2,29,1,1
38608,80,62728,80,allow,1289,303,986,12,16,5,7
55005,53,53050,53,allow,183,94,89,2,29,1,1
49662,53,29879,53,allow,211,102,109,2,29,1,1
60591,80,30981,80,allow,1364,860,504,13,17,8,5
65336,53,9283,53,allow,200,102,98,2,29,1,1
64686,53,47974,53,allow,214,102,112,2,29,1,1
65196,53,54719,53,allow,392,90,302,4,55,2,2
38948,53,19233,53,allow,242,78,164,2,29,1,1
56385,53,22600,53,allow,249,85,164,4,55,2,2
64752,53,50636,53,allow,195,102,93,2,30,1,1
57258,53,33746,53,allow,215,102,113,2,30,1,1
65370,53,23524,53,allow,193,102,91,2,30,1,1
50401,53,50401,53,allow,200,90,110,2,30,1,1
56544,53,54094,53,allow,224,102,122,2,30,1,1
64637,53,52362,53,allow,194,102,92,2,30,1,1
56951,53,9479,53,allow,199,102,97,2,30,1,1
56805,53,39519,53,allow,178,94,84,2,30,1,1
49331,53,5900,53,allow,182,94,88,2,31,1,1
56884,53,35715,53,allow,199,102,97,2,30,1,1
49382,53,23586,53,allow,200,102,98,2,30,1,1
65292,53,3636,53,allow,195,102,93,2,30,1,1
56186,53,56186,53,allow,233,98,135,2,30,1,1
36146,443,34524,443,allow,1147,660,487,11,17,7,4
55933,53,55116,53,allow,330,92,238,4,43,2,2
49543,53,24051,53,allow,880,189,691,6,75,3,3
56941,53,56687,53,allow,193,102,91,2,30,1,1
55653,53,53327,53,allow,199,102,97,2,30,1,1
64569,53,17459,53,allow,183,94,89,2,30,1,1
51446,53,21490,53,allow,168,78,90,2,30,1,1
64066,80,28023,80,allow,314,192,122,6,15,4,2
53101,443,12106,443,allow,1287,800,487,13,16,9,4
56385,53,50438,53,allow,249,85,164,4,56,2,2
55201,53,9810,53,allow,168,78,90,2,30,1,1
49343,53,21551,53,allow,209,110,99,2,30,1,1
57051,53,56096,53,allow,185,102,83,2,30,1,1
64821,53,30415,53,allow,775,102,673,2,30,1,1
50234,53,63121,53,allow,720,94,626,2,30,1,1
49488,53,56220,53,allow,194,102,92,2,31,1,1
60661,53,54714,53,allow,278,102,176,2,31,1,1
65526,53,37729,53,allow,199,102,97,2,30,1,1
53102,443,27329,443,allow,983,496,487,9,16,5,4
44893,53,32339,53,allow,199,94,105,2,30,1,1
56569,53,42369,53,allow,183,94,89,2,30,1,1
64578,53,30124,53,allow,193,102,91,2,30,1,1
56672,53,60163,53,allow,199,102,97,2,30,1,1
64055,53,3603,53,allow,233,94,139,2,30,1,1
65258,53,62928,53,allow,178,94,84,2,30,1,1
64569,53,45660,53,allow,183,94,89,2,30,1,1
50356,53,30610,53,allow,180,94,86,2,30,1,1
57067,53,11799,53,allow,183,94,89,2,30,1,1
64288,53,3103,53,allow,183,94,89,2,31,1,1
56725,53,48111,53,allow,180,94,86,2,31,1,1
49869,53,29655,53,allow,209,110,99,2,30,1,1
56317,53,15827,53,allow,183,94,89,2,30,1,1
65258,53,21767,53,allow,178,94,84,2,30,1,1
65370,53,10592,53,allow,193,102,91,2,30,1,1
56005,53,10080,53,allow,199,102,97,2,30,1,1
64935,53,65195,53,allow,193,102,91,2,30,1,1
55078,53,15054,53,allow,246,94,152,2,30,1,1
49610,53,51833,53,allow,212,102,110,2,30,1,1
49380,53,58826,53,allow,199,102,97,2,31,1,1
65346,53,19469,53,allow,183,94,89,2,30,1,1
49671,53,47128,53,allow,183,94,89,2,30,1,1
57401,53,55696,53,allow,179,94,85,2,31,1,1
64957,53,58925,53,allow,196,102,94,2,30,1,1
57035,53,3817,53,allow,199,102,97,2,30,1,1
49838,53,52067,53,allow,183,94,89,2,31,1,1
64204,53,35802,53,allow,193,102,91,2,30,1,1
64204,53,37090,53,allow,193,102,91,2,31,1,1
57035,53,5245,53,allow,199,102,97,2,30,1,1
49382,53,52583,53,allow,200,102,98,2,31,1,1
56805,53,61616,53,allow,178,94,84,2,31,1,1
65370,53,21172,53,allow,193,102,91,2,30,1,1
50018,53,63073,53,allow,350,91,259,4,41,2,2
49869,53,17507,53,allow,414,103,311,4,31,2,2
49364,53,13056,53,allow,307,307,0,4,60,4,0
37898,53,37898,53,allow,244,98,146,2,33,1,1
54496,445,0,0,drop,70,70,0,1,0,1,0
54492,445,0,0,drop,70,70,0,1,0,1,0
54493,445,0,0,drop,70,70,0,1,0,1,0
63487,129,0,0,deny,60,60,0,1,0,1,0
49781,445,0,0,drop,70,70,0,1,0,1,0
49784,445,0,0,drop,70,70,0,1,0,1,0
49782,445,0,0,drop,70,70,0,1,0,1,0
49780,445,0,0,drop,70,70,0,1,0,1,0
49777,445,0,0,drop,70,70,0,1,0,1,0
54491,445,0,0,drop,70,70,0,1,0,1,0
54488,445,0,0,drop,70,70,0,1,0,1,0
54485,445,0,0,drop,70,70,0,1,0,1,0
49897,445,0,0,drop,66,66,0,1,0,1,0
54483,445,0,0,drop,70,70,0,1,0,1,0
49894,445,0,0,drop,66,66,0,1,0,1,0
49893,445,0,0,drop,66,66,0,1,0,1,0
49891,445,0,0,drop,66,66,0,1,0,1,0
49769,445,0,0,drop,70,70,0,1,0,1,0
49889,445,0,0,drop,66,66,0,1,0,1,0
49761,445,0,0,drop,70,70,0,1,0,1,0
54478,445,0,0,drop,70,70,0,1,0,1,0
49760,445,0,0,drop,70,70,0,1,0,1,0
54471,445,0,0,drop,70,70,0,1,0,1,0
54465,445,0,0,drop,70,70,0,1,0,1,0
49754,445,0,0,drop,70,70,0,1,0,1,0
49878,445,0,0,drop,66,66,0,1,0,1,0
49753,445,0,0,drop,70,70,0,1,0,1,0
49749,445,0,0,drop,70,70,0,1,0,1,0
49871,445,0,0,drop,66,66,0,1,0,1,0
54455,445,0,0,drop,70,70,0,1,0,1,0
49748,445,0,0,drop,70,70,0,1,0,1,0
49869,445,0,0,drop,66,66,0,1,0,1,0
49862,445,0,0,drop,66,66,0,1,0,1,0
49743,445,0,0,drop,70,70,0,1,0,1,0
49853,445,0,0,drop,66,66,0,1,0,1,0
54446,445,0,0,drop,70,70,0,1,0,1,0
54443,445,0,0,drop,70,70,0,1,0,1,0
54444,445,0,0,drop,70,70,0,1,0,1,0
49844,445,0,0,drop,66,66,0,1,0,1,0
49842,445,0,0,drop,66,66,0,1,0,1,0
49846,445,0,0,drop,66,66,0,1,0,1,0
49845,445,0,0,drop,66,66,0,1,0,1,0
49840,445,0,0,drop,66,66,0,1,0,1,0
49843,445,0,0,drop,66,66,0,1,0,1,0
49841,445,0,0,drop,66,66,0,1,0,1,0
49838,445,0,0,drop,66,66,0,1,0,1,0
49730,445,0,0,drop,70,70,0,1,0,1,0
49727,445,0,0,drop,70,70,0,1,0,1,0
54441,445,0,0,drop,70,70,0,1,0,1,0
54434,445,0,0,drop,70,70,0,1,0,1,0
54432,445,0,0,drop,70,70,0,1,0,1,0
54428,445,0,0,drop,70,70,0,1,0,1,0
49723,445,0,0,drop,70,70,0,1,0,1,0
49826,445,0,0,drop,66,66,0,1,0,1,0
49825,445,0,0,drop,66,66,0,1,0,1,0
49824,445,0,0,drop,66,66,0,1,0,1,0
49721,445,0,0,drop,70,70,0,1,0,1,0
62716,23,0,0,deny,60,60,0,1,0,1,0
49719,445,0,0,drop,70,70,0,1,0,1,0
54423,445,0,0,drop,70,70,0,1,0,1,0
54418,445,0,0,drop,70,70,0,1,0,1,0
54419,445,0,0,drop,70,70,0,1,0,1,0
54415,445,0,0,drop,70,70,0,1,0,1,0
49712,445,0,0,drop,70,70,0,1,0,1,0
49710,445,0,0,drop,70,70,0,1,0,1,0
49709,445,0,0,drop,70,70,0,1,0,1,0
54404,445,0,0,drop,70,70,0,1,0,1,0
54403,445,0,0,drop,70,70,0,1,0,1,0
54399,445,0,0,drop,70,70,0,1,0,1,0
49708,445,0,0,drop,70,70,0,1,0,1,0
49707,445,0,0,drop,70,70,0,1,0,1,0
49701,445,0,0,drop,70,70,0,1,0,1,0
49702,445,0,0,drop,70,70,0,1,0,1,0
49812,445,0,0,drop,66,66,0,1,0,1,0
49689,445,0,0,drop,70,70,0,1,0,1,0
49687,445,0,0,drop,70,70,0,1,0,1,0
49686,445,0,0,drop,70,70,0,1,0,1,0
49678,445,0,0,drop,70,70,0,1,0,1,0
49679,445,0,0,drop,70,70,0,1,0,1,0
49488,53,14006,53,allow,188,96,92,2,30,1,1
56805,53,35322,53,allow,172,88,84,2,30,1,1
64637,53,50285,53,allow,188,96,92,2,30,1,1
49984,53,41486,53,allow,172,88,84,2,30,1,1
49319,53,3849,53,allow,198,101,97,2,30,1,1
42956,53,20926,53,allow,168,78,90,2,30,1,1
56725,53,37417,53,allow,176,90,86,3,55,2,1
49838,53,8093,53,allow,182,93,89,2,31,1,1
55796,53,55796,53,allow,253,99,154,2,32,1,1
58666,53,58666,53,allow,235,90,145,2,32,1,1
65530,53,20818,53,allow,166,85,81,2,30,1,1
43934,53,43934,53,allow,310,94,216,2,30,1,1
57319,53,22543,53,allow,176,90,86,2,30,1,1
56100,53,56100,53,allow,265,111,154,2,30,1,1
65189,53,20195,53,allow,176,90,86,2,31,1,1
64143,53,9554,53,allow,174,89,85,2,31,1,1
55704,53,48604,53,allow,186,95,91,2,31,1,1
54398,445,0,0,drop,70,70,0,1,0,1,0
54397,445,0,0,drop,70,70,0,1,0,1,0
46275,23,0,0,deny,60,60,0,1,0,1,0
49797,445,0,0,drop,66,66,0,1,0,1,0
49795,445,0,0,drop,66,66,0,1,0,1,0
65442,80,64392,80,allow,366,180,186,7,28,4,3
49380,53,47715,53,allow,199,102,97,2,30,1,1
56805,53,60553,53,allow,178,94,84,2,30,1,1
49667,445,0,0,drop,70,70,0,1,0,1,0
54387,445,0,0,drop,70,70,0,1,0,1,0
54383,445,0,0,drop,70,70,0,1,0,1,0
54376,445,0,0,drop,70,70,0,1,0,1,0
36484,67,0,0,deny,60,60,0,1,0,1,0
49790,445,0,0,drop,66,66,0,1,0,1,0
49785,445,0,0,drop,66,66,0,1,0,1,0
49784,445,0,0,drop,66,66,0,1,0,1,0
49783,445,0,0,drop,66,66,0,1,0,1,0
49776,445,0,0,drop,66,66,0,1,0,1,0
49779,445,0,0,drop,66,66,0,1,0,1,0
49777,445,0,0,drop,66,66,0,1,0,1,0
49778,445,0,0,drop,66,66,0,1,0,1,0
49662,445,0,0,drop,70,70,0,1,0,1,0
54371,445,0,0,drop,70,70,0,1,0,1,0
54367,445,0,0,drop,70,70,0,1,0,1,0
54365,445,0,0,drop,70,70,0,1,0,1,0
54364,445,0,0,drop,70,70,0,1,0,1,0
49652,445,0,0,drop,70,70,0,1,0,1,0
49653,445,0,0,drop,70,70,0,1,0,1,0
49654,445,0,0,drop,70,70,0,1,0,1,0
49650,445,0,0,drop,70,70,0,1,0,1,0
49646,445,0,0,drop,70,70,0,1,0,1,0
49984,53,22558,53,allow,178,94,84,2,30,1,1
64637,53,26983,53,allow,194,102,92,2,31,1,1
50927,80,64147,80,allow,876,519,357,10,75,6,4
56403,53,56403,53,allow,244,98,146,2,32,1,1
53399,53,53399,53,allow,414,268,146,3,32,2,1
49772,53,51587,53,allow,531,188,343,6,58,3,3
65222,53,38822,53,allow,197,94,103,2,29,1,1
56078,53,50373,53,allow,178,94,84,2,29,1,1
56884,53,20649,53,allow,199,102,97,2,29,1,1
64048,53,43496,53,allow,209,110,99,2,29,1,1
49671,53,11585,53,allow,183,94,89,2,29,1,1
65346,53,42988,53,allow,183,94,89,2,29,1,1
55485,53,55524,53,allow,720,94,626,2,29,1,1
65373,53,10645,53,allow,197,102,95,2,29,1,1
64288,53,49667,53,allow,183,94,89,2,29,1,1
57319,53,20750,53,allow,180,94,86,2,29,1,1
64107,53,23798,53,allow,212,102,110,2,29,1,1
56951,53,31350,53,allow,199,102,97,2,30,1,1
65443,80,29432,80,allow,366,180,186,7,28,4,3
56725,53,45081,53,allow,262,90,172,4,53,2,2
60290,53,35403,53,allow,213,86,127,2,30,1,1
49433,53,51324,53,allow,278,94,184,2,30,1,1
52237,53,52237,53,allow,220,90,130,2,30,1,1
49380,53,64533,53,allow,199,102,97,2,30,1,1
40368,123,25473,123,allow,184,94,90,2,30,1,1
65189,53,27284,53,allow,180,94,86,2,30,1,1
64266,53,14538,53,allow,255,102,153,2,30,1,1
49838,53,33413,53,allow,183,94,89,2,30,1,1
47886,80,46758,80,allow,1767,751,1016,10,15,6,4
49798,53,8655,53,allow,196,102,94,2,30,1,1
50928,80,36754,80,allow,875,518,357,10,75,6,4
65430,80,47649,80,allow,306,180,126,6,29,4,2
52093,80,65106,80,allow,366,240,126,7,26,5,2
65441,80,26203,80,allow,366,180,186,7,28,4,3
49331,53,35223,53,allow,182,94,88,2,30,1,1
60384,80,50302,80,allow,1420,715,705,12,16,7,5
49174,53,10035,53,allow,264,110,154,2,30,1,1
56941,53,42543,53,allow,196,102,94,2,30,1,1
56725,53,46910,53,allow,262,90,172,4,59,2,2
56951,53,23495,53,allow,199,102,97,2,30,1,1
50547,53,45838,53,allow,210,110,100,2,30,1,1
41950,53,0,0,allow,86,86,0,1,30,1,0
58771,53,46484,53,allow,168,78,90,2,30,1,1
49798,53,43543,53,allow,196,102,94,2,30,1,1
64569,53,30065,53,allow,183,94,89,2,30,1,1
64143,53,33110,53,allow,179,94,85,2,30,1,1
65346,53,64945,53,allow,183,94,89,2,30,1,1
54402,53,53139,53,allow,291,86,205,2,30,1,1
49184,53,41219,53,allow,199,94,105,2,30,1,1
65440,80,8468,80,allow,366,180,186,7,28,4,3
49798,53,23227,53,allow,196,102,94,2,30,1,1
57035,53,29329,53,allow,199,102,97,2,30,1,1
49984,53,7504,53,allow,178,94,84,2,30,1,1
65428,80,59063,80,allow,366,180,186,7,29,4,3
50547,53,5293,53,allow,210,110,100,2,30,1,1
49319,53,62578,53,allow,199,102,97,2,30,1,1
65189,53,45878,53,allow,180,94,86,2,30,1,1
53970,1024,11868,1024,allow,260,140,120,5,6,3,2
56661,443,57675,443,allow,334,70,264,5,17,1,4
65432,80,46367,80,allow,486,240,246,9,28,5,4
56005,53,33914,53,allow,199,102,97,2,29,1,1
65530,53,20918,53,allow,167,86,81,2,29,1,1
53724,53,53724,53,allow,268,114,154,2,29,1,1
65526,53,17627,53,allow,199,102,97,2,29,1,1
61291,53,61291,53,allow,261,106,155,2,29,1,1
37639,53,37639,53,allow,245,106,139,2,29,1,1
64578,53,11531,53,allow,193,102,91,2,30,1,1
57356,53,7268,53,allow,199,102,97,2,29,1,1
56078,53,48093,53,allow,178,94,84,2,29,1,1
64048,53,15990,53,allow,209,110,99,2,30,1,1
65526,53,9344,53,allow,199,102,97,2,30,1,1
56672,53,24787,53,allow,199,102,97,2,29,1,1
64899,53,12836,53,allow,199,102,97,2,29,1,1
49488,53,29306,53,allow,194,102,92,2,30,1,1
49554,53,40462,53,allow,210,110,100,2,31,1,1
65425,80,38267,80,allow,366,180,186,7,29,4,3
52110,80,18812,80,allow,422,240,182,8,26,5,3
52106,80,35207,80,allow,422,240,182,8,26,5,3
50013,53,57171,53,allow,258,102,156,2,30,1,1
57001,53,34470,53,allow,210,110,100,2,30,1,1
64143,53,3333,53,allow,179,94,85,2,30,1,1
65292,53,37185,53,allow,195,102,93,2,30,1,1
65429,80,58851,80,allow,366,180,186,7,29,4,3
65444,80,16519,80,allow,486,240,246,9,28,5,4
65433,80,53822,80,allow,486,240,246,9,28,5,4
52116,80,18216,80,allow,422,240,182,8,26,5,3
52120,80,3357,80,allow,366,240,126,7,26,5,2
52109,80,35580,80,allow,422,240,182,8,26,5,3
52105,80,43976,80,allow,422,240,182,8,26,5,3
58087,53,39920,53,allow,168,78,90,2,30,1,1
49319,53,9038,53,allow,199,102,97,2,30,1,1
57001,53,50963,53,allow,210,110,100,2,30,1,1
65438,443,60459,443,allow,572,320,252,10,28,6,4
64770,53,5158,53,allow,360,93,267,3,37,2,1
52802,80,4743,80,allow,1465,729,736,12,16,7,5
64950,53,37238,53,allow,725,277,448,8,61,4,4
49331,53,37708,53,allow,182,94,88,2,30,1,1
49806,53,64642,53,allow,331,102,229,2,30,1,1
58614,53,27670,53,allow,218,78,140,2,31,1,1
49838,53,31499,53,allow,183,94,89,2,31,1,1
47809,53,47809,53,allow,260,106,154,2,32,1,1
46326,443,42575,443,allow,430,152,278,7,32,3,4
54361,445,0,0,drop,70,70,0,1,0,1,0
54360,445,0,0,drop,70,70,0,1,0,1,0
54358,445,0,0,drop,70,70,0,1,0,1,0
49769,445,0,0,drop,66,66,0,1,0,1,0
54355,445,0,0,drop,70,70,0,1,0,1,0
49641,445,0,0,drop,70,70,0,1,0,1,0
49767,445,0,0,drop,66,66,0,1,0,1,0
41577,53,41577,53,allow,265,111,154,2,0,1,1
49765,445,0,0,drop,66,66,0,1,0,1,0
49764,445,0,0,drop,66,66,0,1,0,1,0
49761,445,0,0,drop,66,66,0,1,0,1,0
49633,445,0,0,drop,70,70,0,1,0,1,0
49631,445,0,0,drop,70,70,0,1,0,1,0
54351,445,0,0,drop,70,70,0,1,0,1,0
54343,445,0,0,drop,70,70,0,1,0,1,0
54339,445,0,0,drop,70,70,0,1,0,1,0
49627,445,0,0,drop,70,70,0,1,0,1,0
49625,445,0,0,drop,70,70,0,1,0,1,0
49750,445,0,0,drop,66,66,0,1,0,1,0
49621,445,0,0,drop,70,70,0,1,0,1,0
49743,445,0,0,drop,66,66,0,1,0,1,0
49620,445,0,0,drop,70,70,0,1,0,1,0
54327,445,0,0,drop,70,70,0,1,0,1,0
49741,445,0,0,drop,66,66,0,1,0,1,0
49615,445,0,0,drop,70,70,0,1,0,1,0
49734,445,0,0,drop,66,66,0,1,0,1,0
49726,445,0,0,drop,66,66,0,1,0,1,0
49602,445,0,0,drop,70,70,0,1,0,1,0
54319,445,0,0,drop,70,70,0,1,0,1,0
54315,445,0,0,drop,70,70,0,1,0,1,0
54316,445,0,0,drop,70,70,0,1,0,1,0
49716,445,0,0,drop,66,66,0,1,0,1,0
49714,445,0,0,drop,66,66,0,1,0,1,0
49718,445,0,0,drop,66,66,0,1,0,1,0
49715,445,0,0,drop,66,66,0,1,0,1,0
49713,445,0,0,drop,66,66,0,1,0,1,0
49712,445,0,0,drop,66,66,0,1,0,1,0
49711,445,0,0,drop,66,66,0,1,0,1,0
49710,445,0,0,drop,66,66,0,1,0,1,0
49599,445,0,0,drop,70,70,0,1,0,1,0
54314,445,0,0,drop,70,70,0,1,0,1,0
54306,445,0,0,drop,70,70,0,1,0,1,0
54307,445,0,0,drop,70,70,0,1,0,1,0
54302,445,0,0,drop,70,70,0,1,0,1,0
49594,445,0,0,drop,70,70,0,1,0,1,0
49593,445,0,0,drop,70,70,0,1,0,1,0
49695,445,0,0,drop,66,66,0,1,0,1,0
49698,445,0,0,drop,66,66,0,1,0,1,0
49696,445,0,0,drop,66,66,0,1,0,1,0
49591,445,0,0,drop,70,70,0,1,0,1,0
54295,445,0,0,drop,70,70,0,1,0,1,0
54293,445,0,0,drop,70,70,0,1,0,1,0
54289,445,0,0,drop,70,70,0,1,0,1,0
54288,445,0,0,drop,70,70,0,1,0,1,0
49584,445,0,0,drop,70,70,0,1,0,1,0
49582,445,0,0,drop,70,70,0,1,0,1,0
49581,445,0,0,drop,70,70,0,1,0,1,0
50272,53,9644,53,allow,744,95,649,2,30,1,1
52096,80,38227,80,allow,366,240,126,7,25,5,2
52076,80,2859,80,allow,366,240,126,7,26,5,2
52077,80,35958,80,allow,366,240,126,7,26,5,2
64670,53,38301,53,allow,186,95,91,2,31,1,1
52167,80,36480,80,allow,1734,800,934,10,16,6,4
60415,53,0,0,allow,82,82,0,1,30,1,0
44013,53,44013,53,allow,197,76,121,2,30,1,1
58255,123,13070,123,allow,184,94,90,2,30,1,1
46508,80,61419,80,allow,1056,682,374,10,15,6,4
44675,53,44675,53,allow,197,76,121,2,30,1,1
49554,53,13063,53,allow,204,104,100,2,30,1,1
56739,53,56739,53,allow,825,99,726,2,30,1,1
40471,53,40471,53,allow,194,87,107,2,31,1,1
49580,445,0,0,drop,70,70,0,1,0,1,0
49579,445,0,0,drop,70,70,0,1,0,1,0
49577,445,0,0,drop,70,70,0,1,0,1,0
49576,445,0,0,drop,70,70,0,1,0,1,0
54278,445,0,0,drop,70,70,0,1,0,1,0
54275,445,0,0,drop,70,70,0,1,0,1,0
54277,445,0,0,drop,70,70,0,1,0,1,0
49984,53,11243,53,allow,373,88,285,4,58,2,2
65045,53,38314,53,allow,339,105,234,4,53,2,2
60219,53,60219,53,allow,414,268,146,3,32,2,1
65189,53,46273,53,allow,328,93,235,4,29,2,2
49319,53,39564,53,allow,199,102,97,2,29,1,1
64670,53,60367,53,allow,193,102,91,2,30,1,1
49684,445,0,0,drop,66,66,0,1,0,1,0
49561,445,0,0,drop,70,70,0,1,0,1,0
49560,445,0,0,drop,70,70,0,1,0,1,0
51135,80,13103,80,allow,366,240,126,7,21,5,2
59808,53,0,0,allow,86,86,0,1,30,1,0
49719,53,33096,53,allow,209,110,99,2,30,1,1
64670,53,24174,53,allow,193,102,91,2,30,1,1
49554,53,50726,53,allow,210,110,100,2,30,1,1
65253,53,35458,53,allow,321,150,171,2,30,1,1
52062,80,7748,80,allow,366,240,126,7,26,5,2
51136,80,1499,80,allow,366,240,126,7,21,5,2
52063,80,12503,80,allow,366,240,126,7,26,5,2
65534,53,65534,53,allow,414,268,146,3,31,2,1
64075,1026,16814,1026,allow,66,66,0,2,7,2,0
52336,443,7480,443,allow,134,60,74,3,10,2,1
52108,80,27420,80,allow,182,60,122,4,25,2,2
52085,80,49733,80,allow,360,240,120,7,25,5,2
52073,80,46138,80,allow,482,300,182,9,26,6,3
36828,53,40804,53,allow,168,78,90,2,30,1,1
64714,53,41976,53,allow,212,102,110,2,30,1,1
57061,53,24920,53,allow,197,94,103,2,29,1,1
64143,53,3615,53,allow,179,94,85,2,30,1,1
49357,53,3200,53,allow,211,102,109,2,30,1,1
52092,80,44323,80,allow,426,240,186,8,25,5,3
55704,53,57746,53,allow,193,102,91,2,30,1,1
52072,80,26468,80,allow,482,300,182,9,26,6,3
55704,53,41998,53,allow,193,102,91,2,30,1,1
55704,53,62671,53,allow,193,102,91,2,30,1,1
64596,53,7572,53,allow,237,110,127,2,30,1,1
56687,53,1087,53,allow,225,110,115,2,30,1,1
52065,80,44925,80,allow,692,300,392,9,26,6,3
52066,80,29968,80,allow,692,300,392,9,26,6,3
52074,80,8248,80,allow,422,240,182,8,26,5,3
49554,445,0,0,drop,70,70,0,1,0,1,0
49551,445,0,0,drop,70,70,0,1,0,1,0
49550,445,0,0,drop,70,70,0,1,0,1,0
54270,445,0,0,drop,70,70,0,1,0,1,0
54268,445,0,0,drop,70,70,0,1,0,1,0
49671,445,0,0,drop,66,66,0,1,0,1,0
49670,445,0,0,drop,66,66,0,1,0,1,0
49539,445,0,0,drop,70,70,0,1,0,1,0
54259,445,0,0,drop,70,70,0,1,0,1,0
54252,445,0,0,drop,70,70,0,1,0,1,0
54251,445,0,0,drop,70,70,0,1,0,1,0
54249,445,0,0,drop,70,70,0,1,0,1,0
49664,445,0,0,drop,66,66,0,1,0,1,0
49534,445,0,0,drop,70,70,0,1,0,1,0
49648,445,0,0,drop,66,66,0,1,0,1,0
49656,445,0,0,drop,66,66,0,1,0,1,0
49654,445,0,0,drop,66,66,0,1,0,1,0
49653,445,0,0,drop,66,66,0,1,0,1,0
49652,445,0,0,drop,66,66,0,1,0,1,0
49659,445,0,0,drop,66,66,0,1,0,1,0
49649,445,0,0,drop,66,66,0,1,0,1,0
49525,445,0,0,drop,70,70,0,1,0,1,0
49524,445,0,0,drop,70,70,0,1,0,1,0
49523,445,0,0,drop,70,70,0,1,0,1,0
54243,445,0,0,drop,70,70,0,1,0,1,0
49520,445,0,0,drop,70,70,0,1,0,1,0
54240,445,0,0,drop,70,70,0,1,0,1,0
54238,445,0,0,drop,70,70,0,1,0,1,0
54236,445,0,0,drop,70,70,0,1,0,1,0
49518,445,0,0,drop,70,70,0,1,0,1,0
49512,445,0,0,drop,70,70,0,1,0,1,0
54234,445,0,0,drop,70,70,0,1,0,1,0
54231,445,0,0,drop,70,70,0,1,0,1,0
54228,445,0,0,drop,70,70,0,1,0,1,0
49640,445,0,0,drop,66,66,0,1,0,1,0
54227,445,0,0,drop,70,70,0,1,0,1,0
49639,445,0,0,drop,66,66,0,1,0,1,0
49637,445,0,0,drop,66,66,0,1,0,1,0
49635,445,0,0,drop,66,66,0,1,0,1,0
49505,445,0,0,drop,70,70,0,1,0,1,0
49634,445,0,0,drop,66,66,0,1,0,1,0
49502,445,0,0,drop,70,70,0,1,0,1,0
54225,445,0,0,drop,70,70,0,1,0,1,0
49499,445,0,0,drop,70,70,0,1,0,1,0
54216,445,0,0,drop,70,70,0,1,0,1,0
54210,445,0,0,drop,70,70,0,1,0,1,0
49497,445,0,0,drop,70,70,0,1,0,1,0
49622,445,0,0,drop,66,66,0,1,0,1,0
49493,445,0,0,drop,70,70,0,1,0,1,0
49491,445,0,0,drop,70,70,0,1,0,1,0
49615,445,0,0,drop,66,66,0,1,0,1,0
54201,445,0,0,drop,70,70,0,1,0,1,0
49613,445,0,0,drop,66,66,0,1,0,1,0
49487,445,0,0,drop,70,70,0,1,0,1,0
49606,445,0,0,drop,66,66,0,1,0,1,0
49598,445,0,0,drop,66,66,0,1,0,1,0
49474,445,0,0,drop,70,70,0,1,0,1,0
54192,445,0,0,drop,70,70,0,1,0,1,0
54189,445,0,0,drop,70,70,0,1,0,1,0
54187,445,0,0,drop,70,70,0,1,0,1,0
49584,445,0,0,drop,66,66,0,1,0,1,0
49589,445,0,0,drop,66,66,0,1,0,1,0
49590,445,0,0,drop,66,66,0,1,0,1,0
49588,445,0,0,drop,66,66,0,1,0,1,0
49585,445,0,0,drop,66,66,0,1,0,1,0
49583,445,0,0,drop,66,66,0,1,0,1,0
49586,445,0,0,drop,66,66,0,1,0,1,0
49582,445,0,0,drop,66,66,0,1,0,1,0
49471,445,0,0,drop,70,70,0,1,0,1,0
44378,995,0,0,deny,60,60,0,1,0,1,0
56451,995,0,0,deny,60,60,0,1,0,1,0
49467,445,0,0,drop,70,70,0,1,0,1,0
49465,445,0,0,drop,70,70,0,1,0,1,0
54184,445,0,0,drop,70,70,0,1,0,1,0
54178,445,0,0,drop,70,70,0,1,0,1,0
54179,445,0,0,drop,70,70,0,1,0,1,0
54172,445,0,0,drop,70,70,0,1,0,1,0
49463,445,0,0,drop,70,70,0,1,0,1,0
49568,445,0,0,drop,66,66,0,1,0,1,0
49570,445,0,0,drop,66,66,0,1,0,1,0
49567,445,0,0,drop,66,66,0,1,0,1,0
49288,80,52653,80,allow,1056,682,374,10,15,6,4
52070,80,7371,80,allow,362,240,122,7,25,5,2
58895,443,55555,443,allow,148,82,66,2,10,1,1
52071,80,35794,80,allow,362,240,122,7,25,5,2
52067,80,33886,80,allow,362,240,122,7,25,5,2
60524,443,60524,443,allow,1088,641,447,10,26,6,4
56928,53,56928,53,allow,823,98,725,2,30,1,1
52078,80,58261,80,allow,366,240,126,7,25,5,2
52079,80,61511,80,allow,366,240,126,7,25,5,2
52069,80,30929,80,allow,362,240,122,7,25,5,2
52068,80,54676,80,allow,362,240,122,7,25,5,2
60525,443,60525,443,allow,1088,641,447,10,26,6,4
36672,53,36672,53,allow,234,93,141,2,30,1,1
47674,53,47674,53,allow,200,90,110,2,30,1,1
50313,53,50313,53,allow,202,91,111,2,30,1,1
54167,445,0,0,drop,70,70,0,1,0,1,0
54166,445,0,0,drop,70,70,0,1,0,1,0
54162,445,0,0,drop,70,70,0,1,0,1,0
54157,445,0,0,drop,70,70,0,1,0,1,0
49456,445,0,0,drop,70,70,0,1,0,1,0
49454,445,0,0,drop,70,70,0,1,0,1,0
55457,53,65037,53,allow,372,126,246,2,29,1,1
52060,80,41226,80,allow,366,240,126,7,25,5,2
64560,53,40808,53,allow,578,179,399,6,56,3,3
52059,80,19994,80,allow,426,240,186,8,25,5,3
52166,80,3955,80,allow,2110,1066,1044,12,15,7,5
52061,80,7969,80,allow,366,240,126,7,25,5,2
64381,53,4400,53,allow,168,86,82,2,32,1,1
36628,80,34664,80,allow,78,78,0,1,4,1,0
55267,53,45498,53,allow,168,78,90,2,29,1,1
65084,53,19424,53,allow,215,102,113,2,29,1,1
51156,53,46247,53,allow,168,78,90,2,29,1,1
52043,80,5658,80,allow,1484,805,679,11,25,7,4
56750,53,18998,53,allow,279,118,161,2,30,1,1
56102,53,33083,53,allow,199,94,105,2,30,1,1
53723,443,52693,443,allow,70,70,0,2,8,2,0
60522,443,60522,443,allow,1088,641,447,10,25,6,4
60523,443,60523,443,allow,1088,641,447,10,25,6,4
48163,53,27599,53,allow,199,94,105,2,30,1,1
49378,53,26888,53,allow,210,94,116,2,30,1,1
65066,53,65066,53,allow,240,98,142,2,30,1,1
52039,80,39126,80,allow,366,240,126,7,25,5,2
51132,80,62444,80,allow,426,240,186,8,21,5,3
35797,53,35797,53,allow,217,90,127,2,30,1,1
49488,53,49488,53,allow,823,98,725,2,30,1,1
49171,53,63019,53,allow,301,102,199,2,30,1,1
57445,66,60334,66,allow,70,70,0,1,5,1,0
52000,80,36562,80,allow,416,210,206,7,26,4,3
51671,53,51671,53,allow,200,90,110,2,30,1,1
52064,80,33091,80,allow,692,300,392,9,25,6,3
52075,80,29185,80,allow,422,240,182,8,25,5,3
49927,80,6147,80,allow,1141,636,505,10,45,6,4
52057,80,6987,80,allow,422,240,182,8,25,5,3
52058,80,14075,80,allow,362,240,122,7,25,5,2
62640,53,62640,53,allow,414,268,146,3,32,2,1
56363,53,60359,53,allow,269,94,175,2,30,1,1
64670,53,61851,53,allow,193,102,91,2,29,1,1
64849,53,44145,53,allow,216,102,114,2,29,1,1
57492,53,57492,53,allow,218,90,128,2,30,1,1
40711,53,40711,53,allow,200,90,110,2,30,1,1
55155,53,55155,53,allow,240,98,142,2,30,1,1
49346,53,28098,53,allow,212,102,110,2,30,1,1
48424,53,48424,53,allow,220,90,130,2,30,1,1
56644,53,3506,53,allow,199,94,105,2,30,1,1
64049,53,41804,53,allow,209,102,107,2,30,1,1
36536,53,36536,53,allow,414,268,146,3,32,2,1
56808,53,42088,53,allow,180,94,86,2,35,1,1
56662,443,10328,443,allow,318,192,126,6,15,4,2
52490,53,52490,53,allow,240,98,142,2,30,1,1
47518,53,47518,53,allow,414,268,146,3,32,2,1
51615,53,53355,53,allow,207,86,121,2,30,1,1
63139,53,41966,53,allow,78,78,0,1,30,1,0
55628,53,53766,53,allow,199,94,105,2,30,1,1
38905,53,58412,53,allow,86,86,0,1,30,1,0
63384,53,63384,53,allow,198,90,108,2,30,1,1
65172,53,3984,53,allow,211,102,109,2,30,1,1
52021,80,35964,80,allow,422,240,182,8,25,5,3
50678,80,52506,80,allow,1549,1097,452,9,21,5,4
52034,80,60212,80,allow,366,240,126,7,25,5,2
49453,445,0,0,drop,70,70,0,1,0,1,0
49452,445,0,0,drop,70,70,0,1,0,1,0
49451,445,0,0,drop,70,70,0,1,0,1,0
49445,445,0,0,drop,70,70,0,1,0,1,0
54148,445,0,0,drop,70,70,0,1,0,1,0
54146,445,0,0,drop,70,70,0,1,0,1,0
54144,445,0,0,drop,70,70,0,1,0,1,0
49433,445,0,0,drop,70,70,0,1,0,1,0
49432,445,0,0,drop,70,70,0,1,0,1,0
49427,445,0,0,drop,70,70,0,1,0,1,0
49558,445,0,0,drop,66,66,0,1,0,1,0
49423,445,0,0,drop,70,70,0,1,0,1,0
49422,445,0,0,drop,70,70,0,1,0,1,0
54142,445,0,0,drop,70,70,0,1,0,1,0
54141,445,0,0,drop,70,70,0,1,0,1,0
49411,445,0,0,drop,70,70,0,1,0,1,0
49543,445,0,0,drop,66,66,0,1,0,1,0
49542,445,0,0,drop,66,66,0,1,0,1,0
63380,23,0,0,deny,60,60,0,1,0,1,0
54132,445,0,0,drop,70,70,0,1,0,1,0
54129,445,0,0,drop,70,70,0,1,0,1,0
54127,445,0,0,drop,70,70,0,1,0,1,0
54120,445,0,0,drop,70,70,0,1,0,1,0
49407,445,0,0,drop,70,70,0,1,0,1,0
49535,445,0,0,drop,66,66,0,1,0,1,0
49398,445,0,0,drop,70,70,0,1,0,1,0
49395,445,0,0,drop,70,70,0,1,0,1,0
49396,445,0,0,drop,70,70,0,1,0,1,0
49522,445,0,0,drop,66,66,0,1,0,1,0
49520,445,0,0,drop,66,66,0,1,0,1,0
49530,445,0,0,drop,66,66,0,1,0,1,0
49531,445,0,0,drop,66,66,0,1,0,1,0
49527,445,0,0,drop,66,66,0,1,0,1,0
49524,445,0,0,drop,66,66,0,1,0,1,0
49393,445,0,0,drop,70,70,0,1,0,1,0
49391,445,0,0,drop,70,70,0,1,0,1,0
54115,445,0,0,drop,70,70,0,1,0,1,0
54112,445,0,0,drop,70,70,0,1,0,1,0
54108,445,0,0,drop,70,70,0,1,0,1,0
54110,445,0,0,drop,70,70,0,1,0,1,0
49384,445,0,0,drop,70,70,0,1,0,1,0
54104,445,0,0,drop,70,70,0,1,0,1,0
54106,445,0,0,drop,70,70,0,1,0,1,0
54101,445,0,0,drop,70,70,0,1,0,1,0
49513,445,0,0,drop,66,66,0,1,0,1,0
54099,445,0,0,drop,70,70,0,1,0,1,0
49511,445,0,0,drop,66,66,0,1,0,1,0
49377,445,0,0,drop,70,70,0,1,0,1,0
49508,445,0,0,drop,66,66,0,1,0,1,0
49507,445,0,0,drop,66,66,0,1,0,1,0
49375,445,0,0,drop,70,70,0,1,0,1,0
49505,445,0,0,drop,66,66,0,1,0,1,0
49371,445,0,0,drop,70,70,0,1,0,1,0
49369,445,0,0,drop,70,70,0,1,0,1,0
54094,445,0,0,drop,70,70,0,1,0,1,0
54088,445,0,0,drop,70,70,0,1,0,1,0
54084,445,0,0,drop,70,70,0,1,0,1,0
49365,445,0,0,drop,70,70,0,1,0,1,0
49494,445,0,0,drop,66,66,0,1,0,1,0
49363,445,0,0,drop,70,70,0,1,0,1,0
49487,445,0,0,drop,66,66,0,1,0,1,0
54071,445,0,0,drop,70,70,0,1,0,1,0
49359,445,0,0,drop,70,70,0,1,0,1,0
49484,445,0,0,drop,66,66,0,1,0,1,0
49476,445,0,0,drop,66,66,0,1,0,1,0
49470,445,0,0,drop,66,66,0,1,0,1,0
49346,445,0,0,drop,70,70,0,1,0,1,0
49343,445,0,0,drop,70,70,0,1,0,1,0
54063,445,0,0,drop,70,70,0,1,0,1,0
54059,445,0,0,drop,70,70,0,1,0,1,0
54060,445,0,0,drop,70,70,0,1,0,1,0
49454,445,0,0,drop,66,66,0,1,0,1,0
49461,445,0,0,drop,66,66,0,1,0,1,0
49462,445,0,0,drop,66,66,0,1,0,1,0
49457,445,0,0,drop,66,66,0,1,0,1,0
49458,445,0,0,drop,66,66,0,1,0,1,0
49455,445,0,0,drop,66,66,0,1,0,1,0
49456,445,0,0,drop,66,66,0,1,0,1,0
49460,445,0,0,drop,66,66,0,1,0,1,0
54420,80,23681,80,allow,1596,511,1085,10,15,5,5
55181,53,13217,53,allow,711,87,624,2,30,1,1
52012,80,40658,80,allow,366,240,126,7,25,5,2
60068,443,30976,443,allow,2227,1018,1209,17,16,8,9
52037,80,5136,80,allow,366,240,126,7,25,5,2
52038,80,27418,80,allow,366,240,126,7,25,5,2
52024,80,44508,80,allow,422,240,182,8,25,5,3
52026,80,21940,80,allow,422,240,182,8,25,5,3
49339,445,0,0,drop,70,70,0,1,0,1,0
49337,445,0,0,drop,70,70,0,1,0,1,0
61616,23,0,0,deny,60,60,0,1,0,1,0
47730,22,0,0,deny,60,60,0,1,0,1,0
49335,445,0,0,drop,70,70,0,1,0,1,0
46014,53,46014,53,allow,414,268,146,3,33,2,1
46975,443,49913,443,allow,70,70,0,1,5,1,0
57808,53,57808,53,allow,222,90,132,2,30,1,1
52036,80,8626,80,allow,366,240,126,7,24,5,2
55039,443,11955,443,allow,62,62,0,1,4,1,0
65436,53,8668,53,allow,234,94,140,2,29,1,1
60758,53,57238,53,allow,199,94,105,2,30,1,1
52035,80,21577,80,allow,426,240,186,8,24,5,3
52028,80,63717,80,allow,422,240,182,8,24,5,3
51555,443,44960,443,allow,876,390,486,12,39,4,8
49572,443,43054,443,allow,1820,1101,719,18,18,10,8
54924,443,37000,443,allow,62,62,0,1,4,1,0
52040,80,54028,80,allow,366,240,126,7,24,5,2
55040,443,46427,443,allow,62,62,0,1,4,1,0
52022,80,47623,80,allow,422,240,182,8,24,5,3
52023,80,55578,80,allow,366,240,126,7,24,5,2
59581,53,59581,53,allow,823,98,725,2,29,1,1
52012,443,5821,443,allow,126,60,66,3,10,2,1
49440,53,37784,53,allow,210,102,108,2,29,1,1
59779,443,64471,443,allow,70,70,0,1,5,1,0
65485,53,20874,53,allow,718,94,624,2,30,1,1
55204,53,55204,53,allow,239,98,141,2,30,1,1
56753,80,58241,80,allow,1462,703,759,8,16,5,3
38568,53,38568,53,allow,247,98,149,2,33,1,1
40633,53,51896,53,allow,168,78,90,2,30,1,1
65165,53,5142,53,allow,177,94,83,2,30,1,1
49152,514,0,0,allow,142,142,0,2,30,2,0
55152,53,56189,53,allow,177,94,83,2,30,1,1
64898,53,12662,53,allow,487,201,286,6,42,3,3
46266,53,15636,53,allow,308,118,190,2,30,1,1
48656,80,8880,80,allow,1114,534,580,12,15,7,5
60779,80,5237,80,allow,1248,516,732,9,15,4,5
52020,80,57766,80,allow,426,240,186,8,24,5,3
50265,80,26557,80,allow,2100,1146,954,13,46,6,7
49319,53,4413,53,allow,199,94,105,2,30,1,1
46112,53,33823,53,allow,168,78,90,2,30,1,1
52019,80,54297,80,allow,426,240,186,8,24,5,3
50695,80,16857,80,allow,1426,865,561,9,15,5,4
47638,53,47638,53,allow,212,98,114,2,30,1,1
64613,53,11249,53,allow,212,102,110,2,30,1,1
64956,53,40414,53,allow,402,118,284,2,29,1,1
49949,53,8662,53,allow,307,110,197,2,30,1,1
52831,53,52831,53,allow,200,90,110,2,30,1,1
65411,53,12985,53,allow,194,94,100,2,30,1,1
65114,53,42555,53,allow,380,86,294,2,30,1,1
49797,53,51758,53,allow,718,94,624,2,30,1,1
55152,53,31927,53,allow,177,94,83,2,30,1,1
40781,443,27911,443,allow,362,302,60,2,5,1,1
51130,80,19465,80,allow,366,240,126,7,21,5,2
65165,53,64230,53,allow,177,94,83,2,30,1,1
46899,443,24525,443,allow,70,70,0,1,5,1,0
64070,53,27144,53,allow,258,110,148,2,30,1,1
53872,53,43483,53,allow,70,70,0,1,30,1,0
49153,53,53527,53,allow,280,94,186,2,30,1,1
46824,53,42441,53,allow,326,78,248,2,30,1,1
52001,80,13411,80,allow,546,300,246,10,25,6,4
50865,53,50865,53,allow,242,98,144,2,30,1,1
56120,53,62724,53,allow,168,78,90,2,30,1,1
51270,443,53083,443,allow,190,70,120,4,15,2,2
53226,80,34049,80,allow,1054,602,452,10,20,5,5
49948,53,31917,53,allow,177,94,83,2,30,1,1
49948,53,46968,53,allow,177,94,83,2,30,1,1
55817,53,51311,53,allow,177,94,83,2,30,1,1
56141,53,48700,53,allow,277,134,143,2,30,1,1
65533,53,35566,53,allow,277,134,143,2,30,1,1
54053,445,0,0,drop,70,70,0,1,0,1,0
54056,445,0,0,drop,70,70,0,1,0,1,0
54054,445,0,0,drop,70,70,0,1,0,1,0
54048,445,0,0,drop,70,70,0,1,0,1,0
49442,445,0,0,drop,66,66,0,1,0,1,0
49440,445,0,0,drop,66,66,0,1,0,1,0
49439,445,0,0,drop,66,66,0,1,0,1,0
49328,445,0,0,drop,70,70,0,1,0,1,0
54040,445,0,0,drop,70,70,0,1,0,1,0
54034,445,0,0,drop,70,70,0,1,0,1,0
54033,445,0,0,drop,70,70,0,1,0,1,0
54028,445,0,0,drop,70,70,0,1,0,1,0
49326,445,0,0,drop,70,70,0,1,0,1,0
49325,445,0,0,drop,70,70,0,1,0,1,0
49324,445,0,0,drop,70,70,0,1,0,1,0
49323,445,0,0,drop,70,70,0,1,0,1,0
49318,445,0,0,drop,70,70,0,1,0,1,0
49321,445,0,0,drop,70,70,0,1,0,1,0
49305,445,0,0,drop,70,70,0,1,0,1,0
49304,445,0,0,drop,70,70,0,1,0,1,0
54022,445,0,0,drop,70,70,0,1,0,1,0
54021,445,0,0,drop,70,70,0,1,0,1,0
54015,445,0,0,drop,70,70,0,1,0,1,0
49302,445,0,0,drop,70,70,0,1,0,1,0
49294,445,0,0,drop,70,70,0,1,0,1,0
49295,445,0,0,drop,70,70,0,1,0,1,0
49428,445,0,0,drop,66,66,0,1,0,1,0
54014,445,0,0,drop,70,70,0,1,0,1,0
49283,445,0,0,drop,70,70,0,1,0,1,0
54013,445,0,0,drop,70,70,0,1,0,1,0
49414,445,0,0,drop,66,66,0,1,0,1,0
49411,445,0,0,drop,66,66,0,1,0,1,0
49279,445,0,0,drop,70,70,0,1,0,1,0
53929,443,27958,443,allow,499,425,74,4,0,3,1
53928,443,61918,443,allow,499,425,74,4,0,3,1
54002,445,0,0,drop,70,70,0,1,0,1,0
54001,445,0,0,drop,70,70,0,1,0,1,0
53995,445,0,0,drop,70,70,0,1,0,1,0
53993,445,0,0,drop,70,70,0,1,0,1,0
49408,445,0,0,drop,66,66,0,1,0,1,0
49267,445,0,0,drop,70,70,0,1,0,1,0
49269,445,0,0,drop,70,70,0,1,0,1,0
49268,445,0,0,drop,70,70,0,1,0,1,0
49265,445,0,0,drop,70,70,0,1,0,1,0
49262,445,0,0,drop,70,70,0,1,0,1,0
49401,445,0,0,drop,66,66,0,1,0,1,0
49396,445,0,0,drop,66,66,0,1,0,1,0
49403,445,0,0,drop,66,66,0,1,0,1,0
49392,445,0,0,drop,66,66,0,1,0,1,0
49402,445,0,0,drop,66,66,0,1,0,1,0
49393,445,0,0,drop,66,66,0,1,0,1,0
49395,445,0,0,drop,66,66,0,1,0,1,0
53987,445,0,0,drop,70,70,0,1,0,1,0
53984,445,0,0,drop,70,70,0,1,0,1,0
53981,445,0,0,drop,70,70,0,1,0,1,0
53980,445,0,0,drop,70,70,0,1,0,1,0
49257,445,0,0,drop,70,70,0,1,0,1,0
53979,445,0,0,drop,70,70,0,1,0,1,0
53972,445,0,0,drop,70,70,0,1,0,1,0
53973,445,0,0,drop,70,70,0,1,0,1,0
49384,445,0,0,drop,66,66,0,1,0,1,0
49249,445,0,0,drop,70,70,0,1,0,1,0
53971,445,0,0,drop,70,70,0,1,0,1,0
49248,445,0,0,drop,70,70,0,1,0,1,0
49383,445,0,0,drop,66,66,0,1,0,1,0
49379,445,0,0,drop,66,66,0,1,0,1,0
49381,445,0,0,drop,66,66,0,1,0,1,0
49378,445,0,0,drop,66,66,0,1,0,1,0
49242,445,0,0,drop,70,70,0,1,0,1,0
49241,445,0,0,drop,70,70,0,1,0,1,0
53964,445,0,0,drop,70,70,0,1,0,1,0
53962,445,0,0,drop,70,70,0,1,0,1,0
53956,445,0,0,drop,70,70,0,1,0,1,0
49237,445,0,0,drop,70,70,0,1,0,1,0
49236,445,0,0,drop,70,70,0,1,0,1,0
49367,445,0,0,drop,66,66,0,1,0,1,0
49359,445,0,0,drop,66,66,0,1,0,1,0
49231,445,0,0,drop,70,70,0,1,0,1,0
53943,445,0,0,drop,70,70,0,1,0,1,0
49356,445,0,0,drop,66,66,0,1,0,1,0
49349,445,0,0,drop,66,66,0,1,0,1,0
55681,53,52185,53,allow,711,87,624,2,30,1,1
56334,53,55727,53,allow,170,87,83,2,30,1,1
57069,53,40804,53,allow,1335,87,1248,4,32,2,2
53947,867,53640,867,allow,70,70,0,2,8,2,0
55157,53,58441,53,allow,711,87,624,2,30,1,1
55710,53,65057,53,allow,198,93,105,2,30,1,1
54352,53,16730,53,allow,578,286,292,9,16,5,4
53075,53,27228,53,allow,168,78,90,2,30,1,1
43368,443,39927,443,allow,190,70,120,4,15,2,2
57240,53,57240,53,allow,198,89,109,2,30,1,1
56680,53,24501,53,allow,711,87,624,2,30,1,1
43024,53,45972,53,allow,198,93,105,2,30,1,1
55936,53,2278,53,allow,170,87,83,2,30,1,1
49343,445,0,0,drop,66,66,0,1,0,1,0
49218,445,0,0,drop,70,70,0,1,0,1,0
49215,445,0,0,drop,70,70,0,1,0,1,0
54957,53,32234,53,allow,102,102,0,1,30,1,0
41451,53,15515,53,allow,359,86,273,2,30,1,1
53934,445,0,0,drop,70,70,0,1,0,1,0
53932,445,0,0,drop,70,70,0,1,0,1,0
53931,445,0,0,drop,70,70,0,1,0,1,0
49328,445,0,0,drop,66,66,0,1,0,1,0
49331,445,0,0,drop,66,66,0,1,0,1,0
49333,445,0,0,drop,66,66,0,1,0,1,0
49332,445,0,0,drop,66,66,0,1,0,1,0
49329,445,0,0,drop,66,66,0,1,0,1,0
49326,445,0,0,drop,66,66,0,1,0,1,0
49211,445,0,0,drop,70,70,0,1,0,1,0
49207,445,0,0,drop,70,70,0,1,0,1,0
49205,445,0,0,drop,70,70,0,1,0,1,0
53930,445,0,0,drop,70,70,0,1,0,1,0
53923,445,0,0,drop,70,70,0,1,0,1,0
53922,445,0,0,drop,70,70,0,1,0,1,0
53916,445,0,0,drop,70,70,0,1,0,1,0
39293,443,5290,443,allow,70,70,0,1,4,1,0
57835,53,49650,53,allow,308,118,190,2,29,1,1
57700,53,7203,53,allow,308,118,190,2,29,1,1
58459,53,37044,53,allow,307,86,221,2,29,1,1
56038,53,40238,53,allow,177,94,83,2,29,1,1
55047,53,41022,53,allow,308,94,214,2,29,1,1
52599,53,38138,53,allow,338,94,244,2,29,1,1
64945,53,47640,53,allow,292,126,166,2,29,1,1
55936,53,21289,53,allow,177,94,83,2,30,1,1
49658,53,2388,53,allow,195,102,93,2,30,1,1
50241,53,25762,53,allow,728,102,626,2,30,1,1
56334,53,34646,53,allow,177,94,83,2,30,1,1
45032,53,45032,53,allow,216,82,134,2,33,1,1
57665,53,28556,53,allow,168,78,90,2,30,1,1
50377,53,9572,53,allow,167,78,89,2,30,1,1
42574,53,42574,53,allow,262,106,156,2,32,1,1
41664,53,40771,53,allow,376,78,298,2,30,1,1
56334,53,19616,53,allow,177,94,83,2,30,1,1
56324,53,13523,53,allow,177,94,83,2,30,1,1
52182,53,34693,53,allow,199,94,105,2,30,1,1
59116,53,59116,53,allow,203,82,121,2,30,1,1
58369,53,2783,53,allow,167,78,89,2,30,1,1
50378,53,37644,53,allow,167,78,89,2,30,1,1
49454,53,42230,53,allow,248,118,130,2,30,1,1
56324,53,52043,53,allow,177,94,83,2,30,1,1
46461,53,27823,53,allow,199,94,105,2,30,1,1
38728,53,38728,53,allow,414,268,146,3,33,2,1
65126,53,19594,53,allow,216,94,122,2,30,1,1
49634,53,7065,53,allow,257,102,155,2,30,1,1
58368,53,61007,53,allow,167,78,89,2,30,1,1
53831,443,42938,443,allow,190,70,120,4,15,2,2
52002,80,36032,80,allow,546,300,246,10,24,6,4
54957,53,30594,53,allow,197,102,95,2,33,1,1
56751,80,54705,80,allow,1462,703,759,8,16,5,3
64282,53,55682,53,allow,215,94,121,2,30,1,1
65453,53,23093,53,allow,311,94,217,2,30,1,1
55936,53,1988,53,allow,177,94,83,2,29,1,1
49757,53,24825,53,allow,212,94,118,2,29,1,1
55817,53,47066,53,allow,177,94,83,2,30,1,1
56582,53,17999,53,allow,196,102,94,2,32,1,1
58366,53,25101,53,allow,167,78,89,2,30,1,1
58367,53,2848,53,allow,167,78,89,2,30,1,1
56038,53,12140,53,allow,177,94,83,2,30,1,1
44577,53,21603,53,allow,199,94,105,2,30,1,1
58365,53,51432,53,allow,260,86,174,2,30,1,1
57464,53,0,0,allow,86,86,0,1,30,1,0
59183,53,39038,53,allow,260,86,174,2,30,1,1
64059,80,17237,80,allow,374,192,182,7,15,4,3
64432,53,45233,53,allow,482,188,294,6,44,3,3
46225,53,7961,53,allow,199,94,105,2,30,1,1
46912,53,4234,53,allow,168,78,90,2,30,1,1
51115,80,32483,80,allow,1426,930,496,10,22,7,3
64381,53,35709,53,allow,168,86,82,2,32,1,1
51804,53,51804,53,allow,247,98,149,2,33,1,1
49071,443,20590,443,allow,130,70,60,3,5,2,1
56752,80,35742,80,allow,1462,703,759,8,16,5,3
57075,53,34299,53,allow,212,102,110,2,30,1,1
64994,53,18089,53,allow,216,102,114,2,30,1,1
49789,53,40494,53,allow,177,94,83,2,30,1,1
64690,53,18350,53,allow,338,110,228,2,30,1,1
56887,53,19033,53,allow,177,94,83,2,31,1,1
49573,443,10413,443,allow,1326,876,450,11,55,6,5
55936,53,60791,53,allow,177,94,83,2,30,1,1
49227,53,48621,53,allow,718,94,624,2,30,1,1
50489,443,45489,443,allow,1268,638,630,12,17,7,5
49595,80,13926,80,allow,1285,772,513,11,53,6,5
64985,53,50795,53,allow,412,97,315,4,58,2,2
49847,23,0,0,deny,60,60,0,1,0,1,0
49314,445,0,0,drop,66,66,0,1,0,1,0
49312,445,0,0,drop,66,66,0,1,0,1,0
49311,445,0,0,drop,66,66,0,1,0,1,0
49197,445,0,0,drop,70,70,0,1,0,1,0
49195,445,0,0,drop,70,70,0,1,0,1,0
53911,445,0,0,drop,70,70,0,1,0,1,0
53910,445,0,0,drop,70,70,0,1,0,1,0
53902,445,0,0,drop,70,70,0,1,0,1,0
53901,445,0,0,drop,70,70,0,1,0,1,0
49194,445,0,0,drop,70,70,0,1,0,1,0
49193,445,0,0,drop,70,70,0,1,0,1,0
52944,23,0,0,deny,60,60,0,1,0,1,0
49192,445,0,0,drop,70,70,0,1,0,1,0
49189,445,0,0,drop,70,70,0,1,0,1,0
49190,445,0,0,drop,70,70,0,1,0,1,0
49172,445,0,0,drop,70,70,0,1,0,1,0
49171,445,0,0,drop,70,70,0,1,0,1,0
49169,445,0,0,drop,70,70,0,1,0,1,0
49160,445,0,0,drop,70,70,0,1,0,1,0
49161,445,0,0,drop,70,70,0,1,0,1,0
53892,445,0,0,drop,70,70,0,1,0,1,0
53889,445,0,0,drop,70,70,0,1,0,1,0
53887,445,0,0,drop,70,70,0,1,0,1,0
49300,445,0,0,drop,66,66,0,1,0,1,0
65529,445,0,0,drop,70,70,0,1,0,1,0
53193,22,53193,22,deny,295,126,169,4,0,2,2
53886,445,0,0,drop,70,70,0,1,0,1,0
53884,445,0,0,drop,70,70,0,1,0,1,0
49283,445,0,0,drop,66,66,0,1,0,1,0
49286,445,0,0,drop,66,66,0,1,0,1,0
65525,445,0,0,drop,70,70,0,1,0,1,0
53874,445,0,0,drop,70,70,0,1,0,1,0
53867,445,0,0,drop,70,70,0,1,0,1,0
53866,445,0,0,drop,70,70,0,1,0,1,0
53864,445,0,0,drop,70,70,0,1,0,1,0
65516,445,0,0,drop,70,70,0,1,0,1,0
65513,445,0,0,drop,70,70,0,1,0,1,0
65514,445,0,0,drop,70,70,0,1,0,1,0
65511,445,0,0,drop,70,70,0,1,0,1,0
65508,445,0,0,drop,70,70,0,1,0,1,0
49281,445,0,0,drop,66,66,0,1,0,1,0
49272,445,0,0,drop,66,66,0,1,0,1,0
49274,445,0,0,drop,66,66,0,1,0,1,0
49264,445,0,0,drop,66,66,0,1,0,1,0
49269,445,0,0,drop,66,66,0,1,0,1,0
49271,445,0,0,drop,66,66,0,1,0,1,0
49267,445,0,0,drop,66,66,0,1,0,1,0
49263,445,0,0,drop,66,66,0,1,0,1,0
53860,445,0,0,drop,70,70,0,1,0,1,0
53856,445,0,0,drop,70,70,0,1,0,1,0
53854,445,0,0,drop,70,70,0,1,0,1,0
53852,445,0,0,drop,70,70,0,1,0,1,0
65503,445,0,0,drop,70,70,0,1,0,1,0
65495,445,0,0,drop,70,70,0,1,0,1,0
65493,445,0,0,drop,70,70,0,1,0,1,0
53850,445,0,0,drop,70,70,0,1,0,1,0
53845,445,0,0,drop,70,70,0,1,0,1,0
53844,445,0,0,drop,70,70,0,1,0,1,0
49256,445,0,0,drop,66,66,0,1,0,1,0
53843,445,0,0,drop,70,70,0,1,0,1,0
49254,445,0,0,drop,66,66,0,1,0,1,0
49252,445,0,0,drop,66,66,0,1,0,1,0
49250,445,0,0,drop,66,66,0,1,0,1,0
65489,445,0,0,drop,70,70,0,1,0,1,0
49248,445,0,0,drop,66,66,0,1,0,1,0
65487,445,0,0,drop,70,70,0,1,0,1,0
65483,445,0,0,drop,70,70,0,1,0,1,0
53836,445,0,0,drop,70,70,0,1,0,1,0
53830,445,0,0,drop,70,70,0,1,0,1,0
53827,445,0,0,drop,70,70,0,1,0,1,0
65482,445,0,0,drop,70,70,0,1,0,1,0
55586,23,0,0,deny,60,60,0,1,0,1,0
56887,53,57938,53,allow,170,87,83,2,30,1,1
64231,443,45459,443,allow,2227,1018,1209,17,16,8,9
55376,53,17927,53,allow,711,87,624,2,30,1,1
57093,53,32863,53,allow,711,87,624,2,30,1,1
61614,53,61614,53,allow,257,101,156,2,33,1,1
39223,80,40485,80,allow,1052,612,440,10,15,5,5
65462,53,18628,53,allow,98,98,0,1,30,1,0
49196,53,19330,53,allow,91,91,0,1,30,1,0
64095,53,19951,53,allow,170,87,83,2,30,1,1
55602,53,61633,53,allow,711,87,624,2,30,1,1
57288,53,40155,53,allow,170,87,83,2,30,1,1
55127,53,18845,53,allow,253,87,166,4,44,2,2
55456,53,57964,53,allow,711,87,624,2,30,1,1
56658,53,1646,53,allow,170,87,83,2,30,1,1
56945,53,29864,53,allow,711,87,624,2,30,1,1
55097,53,65390,53,allow,170,87,83,2,31,1,1
49481,53,49481,53,allow,222,101,121,2,31,1,1
57052,53,52166,53,allow,170,87,83,2,31,1,1
55833,53,54382,53,allow,170,87,83,2,31,1,1
65477,445,0,0,drop,70,70,0,1,0,1,0
49230,445,0,0,drop,66,66,0,1,0,1,0
53815,445,0,0,drop,70,70,0,1,0,1,0
56658,53,51855,53,allow,177,94,83,2,30,1,1
49559,443,14886,443,allow,1332,876,456,11,56,6,5
53214,443,52186,443,allow,526,156,370,8,14,3,5
64117,53,35902,53,allow,350,94,256,2,29,1,1
53227,53,11040,53,allow,78,78,0,1,29,1,0
56031,53,65070,53,allow,177,94,83,2,30,1,1
56611,53,59791,53,allow,181,94,87,2,31,1,1
49989,53,19506,53,allow,301,85,216,4,53,2,2
49658,53,46008,53,allow,195,102,93,2,29,1,1
55695,53,3075,53,allow,177,94,83,2,29,1,1
50412,80,26565,80,allow,1524,341,1183,11,36,4,7
49994,53,33575,53,allow,86,86,0,1,29,1,0
56658,53,42222,53,allow,177,94,83,2,29,1,1
65254,53,46437,53,allow,459,94,365,4,45,2,2
56668,53,61814,53,allow,177,94,83,2,29,1,1
64095,53,40106,53,allow,177,94,83,2,30,1,1
55695,53,64745,53,allow,177,94,83,2,29,1,1
57288,53,46993,53,allow,177,94,83,2,30,1,1
55541,53,64093,53,allow,177,94,83,2,30,1,1
43228,443,18463,443,allow,1527,940,587,14,22,8,6
55127,53,39994,53,allow,253,87,166,4,43,2,2
57288,53,13037,53,allow,177,94,83,2,30,1,1
51118,80,35500,80,allow,366,240,126,7,21,5,2
50272,53,50516,53,allow,168,78,90,2,30,1,1
57375,443,64184,443,allow,130,70,60,2,15,1,1
64973,53,14211,53,allow,210,102,108,2,30,1,1
49633,53,37557,53,allow,210,102,108,2,30,1,1
64784,53,13638,53,allow,226,102,124,2,30,1,1
57052,53,26525,53,allow,177,94,83,2,30,1,1
64095,53,56290,53,allow,177,94,83,2,30,1,1
57316,53,12512,53,allow,177,94,83,2,30,1,1
57316,53,3738,53,allow,177,94,83,2,30,1,1
50276,53,20646,53,allow,94,94,0,1,30,1,0
57288,53,40505,53,allow,177,94,83,2,30,1,1
55541,53,4475,53,allow,177,94,83,2,30,1,1
50486,443,7512,443,allow,1043,556,487,10,16,6,4
52910,53,52910,53,allow,414,268,146,3,32,2,1
51135,80,18450,80,allow,254,128,126,5,15,3,2
51120,80,28128,80,allow,366,240,126,7,21,5,2
65303,53,28109,53,allow,94,94,0,1,29,1,0
65068,53,6356,53,allow,336,111,225,4,29,2,2
56668,53,54886,53,allow,177,94,83,2,29,1,1
64036,53,37626,53,allow,692,224,468,6,49,3,3
64095,53,63030,53,allow,177,94,83,2,29,1,1
56334,53,1244,53,allow,177,94,83,2,29,1,1
49434,53,25380,53,allow,183,86,97,2,29,1,1
56658,53,20785,53,allow,177,94,83,2,29,1,1
56031,53,4995,53,allow,177,94,83,2,29,1,1
49789,53,65450,53,allow,177,94,83,2,30,1,1
65221,53,28071,53,allow,196,86,110,2,30,1,1
65221,53,13826,53,allow,168,86,82,2,30,1,1
57052,53,38641,53,allow,177,94,83,2,30,1,1
61686,53,52741,53,allow,196,86,110,2,30,1,1
50012,53,43824,53,allow,94,94,0,1,30,1,0
56887,53,35999,53,allow,177,94,83,2,30,1,1
56172,53,39320,53,allow,216,102,114,2,30,1,1
53958,80,11138,80,allow,130,70,60,2,15,1,1
39980,443,41321,443,allow,130,70,60,2,15,1,1
55127,53,60626,53,allow,253,87,166,4,44,2,2
49424,53,36639,53,allow,210,102,108,2,30,1,1
56887,53,63111,53,allow,177,94,83,2,30,1,1
49609,53,45961,53,allow,177,94,83,2,31,1,1
49469,53,17330,53,allow,718,94,624,2,30,1,1
65448,53,13119,53,allow,209,110,99,2,30,1,1
58320,53,15987,53,allow,331,86,245,2,30,1,1
55189,53,54191,53,allow,211,102,109,2,30,1,1
55677,53,59623,53,allow,177,94,83,2,30,1,1
57052,53,21671,53,allow,177,94,83,2,30,1,1
56291,53,26927,53,allow,177,94,83,2,31,1,1
57673,53,25100,53,allow,273,94,179,2,30,1,1
56375,53,31585,53,allow,177,94,83,2,31,1,1
64106,53,22227,53,allow,309,102,207,4,53,2,2
55127,53,49558,53,allow,253,87,166,4,44,2,2
55929,80,55929,80,allow,450,246,204,8,29,5,3
46683,443,34091,443,allow,416,210,206,7,28,4,3
55926,80,55926,80,allow,450,246,204,8,29,5,3
55927,80,55927,80,allow,450,246,204,8,29,5,3
49227,445,0,0,drop,66,66,0,1,0,1,0
49220,445,0,0,drop,66,66,0,1,0,1,0
65464,445,0,0,drop,70,70,0,1,0,1,0
49216,445,0,0,drop,66,66,0,1,0,1,0
65461,445,0,0,drop,70,70,0,1,0,1,0
53806,445,0,0,drop,70,70,0,1,0,1,0
53804,445,0,0,drop,70,70,0,1,0,1,0
53803,445,0,0,drop,70,70,0,1,0,1,0
49204,445,0,0,drop,66,66,0,1,0,1,0
49198,445,0,0,drop,66,66,0,1,0,1,0
49199,445,0,0,drop,66,66,0,1,0,1,0
49201,445,0,0,drop,66,66,0,1,0,1,0
49203,445,0,0,drop,66,66,0,1,0,1,0
49202,445,0,0,drop,66,66,0,1,0,1,0
49200,445,0,0,drop,66,66,0,1,0,1,0
49196,445,0,0,drop,66,66,0,1,0,1,0
65456,445,0,0,drop,70,70,0,1,0,1,0
65455,445,0,0,drop,70,70,0,1,0,1,0
65453,445,0,0,drop,70,70,0,1,0,1,0
53800,445,0,0,drop,70,70,0,1,0,1,0
53801,445,0,0,drop,70,70,0,1,0,1,0
53799,445,0,0,drop,70,70,0,1,0,1,0
53794,445,0,0,drop,70,70,0,1,0,1,0
49184,445,0,0,drop,66,66,0,1,0,1,0
49182,445,0,0,drop,66,66,0,1,0,1,0
49183,445,0,0,drop,66,66,0,1,0,1,0
65446,445,0,0,drop,70,70,0,1,0,1,0
65444,445,0,0,drop,70,70,0,1,0,1,0
65443,445,0,0,drop,70,70,0,1,0,1,0
53783,445,0,0,drop,70,70,0,1,0,1,0
65442,445,0,0,drop,70,70,0,1,0,1,0
65441,445,0,0,drop,70,70,0,1,0,1,0
53781,445,0,0,drop,70,70,0,1,0,1,0
53777,445,0,0,drop,70,70,0,1,0,1,0
53776,445,0,0,drop,70,70,0,1,0,1,0
65439,445,0,0,drop,70,70,0,1,0,1,0
65438,445,0,0,deny,70,70,0,1,0,1,0
53927,443,24116,443,allow,495,421,74,4,0,3,1
53923,443,32187,443,allow,499,425,74,4,0,3,1
65423,445,0,0,drop,70,70,0,1,0,1,0
65422,445,0,0,drop,70,70,0,1,0,1,0
65418,445,0,0,drop,70,70,0,1,0,1,0
65413,445,0,0,drop,70,70,0,1,0,1,0
65412,445,0,0,drop,70,70,0,1,0,1,0
53764,445,0,0,drop,70,70,0,1,0,1,0
53761,445,0,0,drop,70,70,0,1,0,1,0
53759,445,0,0,drop,70,70,0,1,0,1,0
49172,445,0,0,drop,66,66,0,1,0,1,0
65401,445,0,0,drop,70,70,0,1,0,1,0
42453,17,0,0,deny,60,60,0,1,0,1,0
53758,445,0,0,drop,70,70,0,1,0,1,0
53757,445,0,0,drop,70,70,0,1,0,1,0
65397,445,0,0,drop,70,70,0,1,0,1,0
49156,445,0,0,drop,66,66,0,1,0,1,0
65533,445,0,0,drop,66,66,0,1,0,1,0
65388,445,0,0,drop,70,70,0,1,0,1,0
65387,445,0,0,drop,70,70,0,1,0,1,0
65386,445,0,0,drop,70,70,0,1,0,1,0
65382,445,0,0,drop,70,70,0,1,0,1,0
53748,445,0,0,drop,70,70,0,1,0,1,0
53745,445,0,0,drop,70,70,0,1,0,1,0
53746,445,0,0,drop,70,70,0,1,0,1,0
53737,445,0,0,drop,70,70,0,1,0,1,0
65381,445,0,0,drop,70,70,0,1,0,1,0
65530,445,0,0,drop,66,66,0,1,0,1,0
61911,1,0,0,deny,146,146,0,1,0,1,0
65519,445,0,0,drop,66,66,0,1,0,1,0
65522,445,0,0,drop,66,66,0,1,0,1,0
65513,445,0,0,drop,66,66,0,1,0,1,0
65524,445,0,0,drop,66,66,0,1,0,1,0
65521,445,0,0,drop,66,66,0,1,0,1,0
65515,445,0,0,drop,66,66,0,1,0,1,0
65518,445,0,0,drop,66,66,0,1,0,1,0
53730,445,0,0,drop,70,70,0,1,0,1,0
65374,445,0,0,drop,70,70,0,1,0,1,0
53728,445,0,0,drop,70,70,0,1,0,1,0
53724,445,0,0,drop,70,70,0,1,0,1,0
53726,445,0,0,drop,70,70,0,1,0,1,0
65367,445,0,0,drop,70,70,0,1,0,1,0
65365,445,0,0,drop,70,70,0,1,0,1,0
53722,445,0,0,drop,70,70,0,1,0,1,0
53718,445,0,0,drop,70,70,0,1,0,1,0
53717,445,0,0,drop,70,70,0,1,0,1,0
65506,445,0,0,drop,66,66,0,1,0,1,0
53715,445,0,0,drop,70,70,0,1,0,1,0
65360,445,0,0,drop,70,70,0,1,0,1,0
65503,445,0,0,drop,66,66,0,1,0,1,0
65359,445,0,0,drop,70,70,0,1,0,1,0
65502,445,0,0,drop,66,66,0,1,0,1,0
65500,445,0,0,drop,66,66,0,1,0,1,0
65499,445,0,0,drop,66,66,0,1,0,1,0
65355,445,0,0,drop,70,70,0,1,0,1,0
56951,53,51481,53,allow,250,86,164,4,31,2,2
49800,53,17712,53,allow,87,87,0,1,30,1,0
49609,53,22044,53,allow,170,87,83,2,30,1,1
55276,53,33496,53,allow,170,87,83,2,31,1,1
55277,53,53790,53,allow,701,88,613,2,30,1,1
57880,53,57880,53,allow,231,97,134,2,30,1,1
55967,53,9494,53,allow,701,88,613,2,30,1,1
64381,53,43493,53,allow,168,86,82,2,31,1,1
55375,53,46240,53,allow,711,87,624,2,31,1,1
46212,443,28562,443,allow,190,70,120,4,15,2,2
50460,443,50460,443,allow,1159,668,491,11,31,6,5
56756,53,22443,53,allow,711,87,624,2,30,1,1
46211,443,37976,443,allow,190,70,120,4,16,2,2
56985,53,26642,53,allow,916,86,830,2,30,1,1
57220,53,51033,53,allow,701,88,613,2,30,1,1
57340,53,41414,53,allow,711,87,624,2,30,1,1
56375,53,7933,53,allow,170,87,83,2,30,1,1
53709,445,0,0,drop,70,70,0,1,0,1,0
65354,445,0,0,drop,70,70,0,1,0,1,0
53706,445,0,0,drop,70,70,0,1,0,1,0
53701,445,0,0,drop,70,70,0,1,0,1,0
65487,445,0,0,drop,66,66,0,1,0,1,0
65349,445,0,0,drop,70,70,0,1,0,1,0
50454,80,50454,80,allow,450,246,204,8,33,5,3
53921,443,59413,443,allow,499,425,74,4,0,3,1
53912,443,42597,443,allow,499,425,74,4,0,3,1
53922,443,26654,443,allow,499,425,74,4,0,3,1
53920,443,44819,443,allow,499,425,74,4,0,3,1
53915,443,3997,443,allow,499,425,74,4,0,3,1
53911,443,51915,443,allow,499,425,74,4,0,3,1
53909,443,45501,443,allow,499,425,74,4,0,3,1
53919,443,62398,443,allow,499,425,74,4,0,3,1
53916,443,57375,443,allow,499,425,74,4,0,3,1
53907,443,41234,443,allow,499,425,74,4,0,3,1
53917,443,58017,443,allow,499,425,74,4,0,3,1
53918,443,16862,443,allow,499,425,74,4,0,3,1
53908,443,36300,443,allow,499,425,74,4,0,3,1
53914,443,31627,443,allow,499,425,74,4,0,3,1
53906,443,56748,443,allow,499,425,74,4,0,3,1
53913,443,40081,443,allow,499,425,74,4,0,3,1
53910,443,14287,443,allow,499,425,74,4,0,3,1
53905,443,17585,443,allow,499,425,74,4,0,3,1
65480,445,0,0,drop,66,66,0,1,0,1,0
53687,445,0,0,drop,70,70,0,1,0,1,0
65478,445,0,0,drop,66,66,0,1,0,1,0
55833,53,8720,53,allow,177,94,83,2,30,1,1
57271,53,1300,53,allow,228,102,126,2,30,1,1
55097,53,14648,53,allow,177,94,83,2,29,1,1
55097,53,54198,53,allow,177,94,83,2,29,1,1
50393,80,25546,80,allow,366,180,186,7,26,4,3
50391,80,6997,80,allow,300,180,120,6,26,4,2
55276,53,62860,53,allow,177,94,83,2,30,1,1
57350,53,14841,53,allow,177,94,83,2,30,1,1
56273,53,48350,53,allow,197,102,95,2,33,1,1
50395,80,11837,80,allow,487,180,307,6,26,4,2
50394,80,50061,80,allow,306,180,126,6,26,4,2
40358,53,40358,53,allow,414,268,146,3,32,2,1
64898,53,64087,53,allow,487,201,286,6,39,3,3
56273,53,58204,53,allow,197,102,95,2,30,1,1
56375,53,41703,53,allow,177,94,83,2,30,1,1
57408,53,37720,53,allow,195,102,93,2,30,1,1
65469,53,36424,53,allow,308,110,198,2,30,1,1
57350,53,37868,53,allow,177,94,83,2,30,1,1
57408,53,13747,53,allow,195,102,93,2,33,1,1
50392,80,28117,80,allow,306,180,126,6,26,4,2
64758,53,44548,53,allow,311,102,209,2,30,1,1
56291,53,26835,53,allow,177,94,83,2,30,1,1
49609,53,44498,53,allow,177,94,83,2,30,1,1
56066,53,13837,53,allow,184,102,82,2,30,1,1
50396,80,52675,80,allow,487,180,307,6,26,4,2
55924,80,55924,80,allow,450,246,204,8,28,5,3
55925,80,55925,80,allow,450,246,204,8,28,5,3
52111,80,49500,80,allow,1582,866,716,11,20,7,4
50453,80,50453,80,allow,450,246,204,8,30,5,3
64798,53,18186,53,allow,177,94,83,2,29,1,1
56795,53,50687,53,allow,177,94,83,2,29,1,1
64798,53,6106,53,allow,177,94,83,2,29,1,1
49960,53,57227,53,allow,198,94,104,2,29,1,1
55677,53,14201,53,allow,177,94,83,2,29,1,1
65329,53,20205,53,allow,278,102,176,2,29,1,1
49215,53,25508,53,allow,214,102,112,2,30,1,1
49954,53,47734,53,allow,228,110,118,2,30,1,1
56795,53,22826,53,allow,177,94,83,2,30,1,1
55833,53,34904,53,allow,177,94,83,2,30,1,1
36079,53,36079,53,allow,235,90,145,2,32,1,1
55276,53,58176,53,allow,177,94,83,2,30,1,1
50390,80,49086,80,allow,360,180,180,7,26,4,3
56066,53,44669,53,allow,196,86,110,2,30,1,1
56375,53,48204,53,allow,177,94,83,2,30,1,1
50389,443,61820,443,allow,306,180,126,6,26,4,2
42630,53,12099,53,allow,168,78,90,2,30,1,1
56476,53,12813,53,allow,94,94,0,1,30,1,0
54955,53,60657,53,allow,177,94,83,2,31,1,1
55939,53,41055,53,allow,177,94,83,2,30,1,1
64780,53,37698,53,allow,627,224,403,6,56,3,3
55375,53,40220,53,allow,222,102,120,2,30,1,1
55833,53,32426,53,allow,177,94,83,2,30,1,1
49246,53,17908,53,allow,177,94,83,2,30,1,1
56143,53,50780,53,allow,177,94,83,2,30,1,1
41914,443,49039,443,allow,466,392,74,4,0,3,1
65336,445,0,0,drop,70,70,0,1,0,1,0
65469,445,0,0,drop,66,66,0,1,0,1,0
65463,445,0,0,drop,66,66,0,1,0,1,0
65333,445,0,0,drop,70,70,0,1,0,1,0
65328,445,0,0,drop,70,70,0,1,0,1,0
53678,445,0,0,drop,70,70,0,1,0,1,0
53676,445,0,0,drop,70,70,0,1,0,1,0
53674,445,0,0,drop,70,70,0,1,0,1,0
65327,445,0,0,drop,70,70,0,1,0,1,0
65451,445,0,0,drop,66,66,0,1,0,1,0
65453,445,0,0,drop,66,66,0,1,0,1,0
65448,445,0,0,drop,66,66,0,1,0,1,0
65450,445,0,0,drop,66,66,0,1,0,1,0
65449,445,0,0,drop,66,66,0,1,0,1,0
65452,445,0,0,drop,66,66,0,1,0,1,0
65447,445,0,0,drop,66,66,0,1,0,1,0
65325,445,0,0,drop,70,70,0,1,0,1,0
50311,443,61436,443,allow,466,392,74,4,0,3,1
53672,445,0,0,drop,70,70,0,1,0,1,0
53666,445,0,0,drop,70,70,0,1,0,1,0
53665,445,0,0,drop,70,70,0,1,0,1,0
53661,445,0,0,drop,70,70,0,1,0,1,0
65318,445,0,0,drop,70,70,0,1,0,1,0
65316,445,0,0,drop,70,70,0,1,0,1,0
65435,445,0,0,drop,66,66,0,1,0,1,0
65434,445,0,0,drop,66,66,0,1,0,1,0
65433,445,0,0,drop,66,66,0,1,0,1,0
65315,445,0,0,drop,70,70,0,1,0,1,0
65314,445,0,0,drop,70,70,0,1,0,1,0
65313,445,0,0,drop,70,70,0,1,0,1,0
65308,445,0,0,drop,70,70,0,1,0,1,0
65307,445,0,0,drop,70,70,0,1,0,1,0
53654,445,0,0,drop,70,70,0,1,0,1,0
53646,445,0,0,drop,70,70,0,1,0,1,0
53644,445,0,0,drop,70,70,0,1,0,1,0
53643,445,0,0,drop,70,70,0,1,0,1,0
65295,445,0,0,drop,70,70,0,1,0,1,0
65294,445,0,0,drop,70,70,0,1,0,1,0
65291,445,0,0,drop,70,70,0,1,0,1,0
65285,445,0,0,drop,70,70,0,1,0,1,0
65284,445,0,0,drop,70,70,0,1,0,1,0
39380,1,0,0,deny,146,146,0,1,0,1,0
53637,445,0,0,drop,70,70,0,1,0,1,0
53635,445,0,0,drop,70,70,0,1,0,1,0
53633,445,0,0,drop,70,70,0,1,0,1,0
65421,445,0,0,drop,66,66,0,1,0,1,0
65273,445,0,0,drop,70,70,0,1,0,1,0
53629,445,0,0,drop,70,70,0,1,0,1,0
53626,445,0,0,drop,70,70,0,1,0,1,0
65268,445,0,0,drop,70,70,0,1,0,1,0
65407,445,0,0,drop,66,66,0,1,0,1,0
65403,445,0,0,drop,66,66,0,1,0,1,0
65260,445,0,0,drop,70,70,0,1,0,1,0
65258,445,0,0,drop,70,70,0,1,0,1,0
65257,445,0,0,drop,70,70,0,1,0,1,0
65255,445,0,0,drop,70,70,0,1,0,1,0
39809,23,0,0,deny,60,60,0,1,0,1,0
65252,445,0,0,drop,70,70,0,1,0,1,0
53614,445,0,0,drop,70,70,0,1,0,1,0
53608,445,0,0,drop,70,70,0,1,0,1,0
53611,445,0,0,drop,70,70,0,1,0,1,0
53609,445,0,0,drop,70,70,0,1,0,1,0
65401,445,0,0,drop,66,66,0,1,0,1,0
65394,445,0,0,drop,66,66,0,1,0,1,0
65392,445,0,0,drop,66,66,0,1,0,1,0
65393,445,0,0,drop,66,66,0,1,0,1,0
65396,445,0,0,drop,66,66,0,1,0,1,0
65388,445,0,0,drop,66,66,0,1,0,1,0
65389,445,0,0,drop,66,66,0,1,0,1,0
65386,445,0,0,drop,66,66,0,1,0,1,0
65247,445,0,0,drop,70,70,0,1,0,1,0
53602,445,0,0,drop,70,70,0,1,0,1,0
53599,445,0,0,drop,70,70,0,1,0,1,0
53597,445,0,0,drop,70,70,0,1,0,1,0
53595,445,0,0,drop,70,70,0,1,0,1,0
65239,445,0,0,drop,70,70,0,1,0,1,0
65236,445,0,0,drop,70,70,0,1,0,1,0
43563,443,50861,443,allow,466,392,74,4,0,3,1
52010,80,6411,80,allow,1327,822,505,11,21,7,4
55133,53,7400,53,allow,711,87,624,2,30,1,1
55647,53,47322,53,allow,711,87,624,2,30,1,1
56893,53,37100,53,allow,170,87,83,2,31,1,1
57150,53,24486,53,allow,170,87,83,2,30,1,1
40379,53,38675,53,allow,168,78,90,2,30,1,1
55496,80,55496,80,allow,124,60,64,2,5,1,1
56217,53,65360,53,allow,711,87,624,2,30,1,1
64279,53,15836,53,allow,170,87,83,2,30,1,1
56597,53,51184,53,allow,711,87,624,2,30,1,1
56998,53,18836,53,allow,711,87,624,2,30,1,1
55757,53,46754,53,allow,170,87,83,2,30,1,1
54955,53,57414,53,allow,170,87,83,2,30,1,1
36812,53,60347,53,allow,168,78,90,2,31,1,1
57192,53,34742,53,allow,170,87,83,2,31,1,1
56924,53,50260,53,allow,170,87,83,2,31,1,1
49985,53,61904,53,allow,312,90,222,2,31,1,1
53591,445,0,0,drop,70,70,0,1,0,1,0
53589,445,0,0,drop,70,70,0,1,0,1,0
53588,445,0,0,drop,70,70,0,1,0,1,0
65233,445,0,0,drop,70,70,0,1,0,1,0
65377,445,0,0,drop,66,66,0,1,0,1,0
65231,445,0,0,drop,70,70,0,1,0,1,0
53586,445,0,0,drop,70,70,0,1,0,1,0
65376,445,0,0,drop,66,66,0,1,0,1,0
65374,445,0,0,drop,66,66,0,1,0,1,0
65373,445,0,0,drop,66,66,0,1,0,1,0
49246,53,4565,53,allow,177,94,83,2,30,1,1
56143,53,46074,53,allow,177,94,83,2,30,1,1
55588,53,19559,53,allow,168,86,82,2,30,1,1
49274,53,43421,53,allow,212,102,110,2,29,1,1
55276,53,25720,53,allow,177,94,83,2,29,1,1
55757,53,24073,53,allow,177,94,83,2,30,1,1
64279,53,29219,53,allow,177,94,83,2,29,1,1
65023,53,34897,53,allow,587,104,483,4,40,2,2
65082,53,42896,53,allow,305,94,211,4,35,2,2
55605,53,59793,53,allow,198,102,96,2,33,1,1
55646,53,7208,53,allow,216,94,122,2,30,1,1
64381,53,44937,53,allow,952,291,661,8,68,4,4
55605,53,59160,53,allow,198,102,96,2,30,1,1
65177,53,43720,53,allow,258,110,148,2,30,1,1
55601,53,58800,53,allow,177,94,83,2,30,1,1
59182,53,44334,53,allow,260,86,174,2,30,1,1
63970,53,19074,53,allow,228,110,118,2,30,1,1
57150,53,64897,53,allow,177,94,83,2,30,1,1
56566,53,0,0,allow,86,86,0,1,30,1,0
55584,53,28071,53,allow,177,94,83,2,30,1,1
65226,53,19267,53,allow,79,79,0,2,34,2,0
51113,80,51632,80,allow,1948,1092,856,10,20,7,3
42226,53,42226,53,allow,259,114,145,2,29,1,1
49609,53,20657,53,allow,177,94,83,2,29,1,1
55939,53,47586,53,allow,177,94,83,2,29,1,1
54955,53,54702,53,allow,177,94,83,2,29,1,1
50214,53,15199,53,allow,718,94,624,2,29,1,1
56951,53,31366,53,allow,168,86,82,2,29,1,1
65456,53,31398,53,allow,364,102,262,2,29,1,1
56808,53,18042,53,allow,180,94,86,2,35,1,1
55013,53,63318,53,allow,728,102,626,2,29,1,1
56951,53,44679,53,allow,168,86,82,2,29,1,1
63419,53,63419,53,allow,216,90,126,2,30,1,1
55959,53,27240,53,allow,216,102,114,2,29,1,1
50021,53,13540,53,allow,821,102,719,2,30,1,1
56951,53,25030,53,allow,168,86,82,2,29,1,1
56893,53,21610,53,allow,177,94,83,2,30,1,1
64279,53,42792,53,allow,177,94,83,2,30,1,1
57395,53,57395,53,allow,208,82,126,2,30,1,1
55757,53,45063,53,allow,177,94,83,2,30,1,1
54955,53,32337,53,allow,177,94,83,2,30,1,1
47548,53,51360,53,allow,168,78,90,2,30,1,1
64951,53,50176,53,allow,402,118,284,2,30,1,1
57150,53,36180,53,allow,177,94,83,2,30,1,1
64783,53,10599,53,allow,214,94,120,2,30,1,1
58920,80,59955,80,allow,318,192,126,6,37,4,2
49472,53,52589,53,allow,209,102,107,2,30,1,1
55778,53,1773,53,allow,94,94,0,1,30,1,0
50284,53,6888,53,allow,168,78,90,2,30,1,1
41348,53,0,0,allow,86,86,0,1,30,1,0
64279,53,4406,53,allow,177,94,83,2,30,1,1
56893,53,56270,53,allow,177,94,83,2,30,1,1
55757,53,50237,53,allow,177,94,83,2,30,1,1
52097,80,35130,80,allow,1621,896,725,11,19,7,4
37435,53,37435,53,allow,414,268,146,3,32,2,1
55601,53,28384,53,allow,177,94,83,2,30,1,1
57385,53,16664,53,allow,177,94,83,2,30,1,1
55588,53,33228,53,allow,168,86,82,2,30,1,1
44351,53,3058,53,allow,168,78,90,2,30,1,1
55067,53,26485,53,allow,178,94,84,2,31,1,1
56924,53,38205,53,allow,177,94,83,2,31,1,1
65227,53,53714,53,allow,180,86,94,2,30,1,1
51551,53,57627,53,allow,304,86,218,2,30,1,1
57385,53,42061,53,allow,177,94,83,2,30,1,1
55921,53,32858,53,allow,177,94,83,2,30,1,1
38323,443,27893,443,allow,130,70,60,2,15,1,1
54957,53,54042,53,allow,197,102,95,2,35,1,1
57007,80,33678,80,allow,214,140,74,4,31,3,1
57008,80,59299,80,allow,214,140,74,4,31,3,1
57012,80,14292,80,allow,214,140,74,4,31,3,1
55067,53,40121,53,allow,178,94,84,2,30,1,1
57015,80,24329,80,allow,214,140,74,4,31,3,1
56893,53,50861,53,allow,177,94,83,2,30,1,1
65152,53,13700,53,allow,177,94,83,2,30,1,1
55498,53,32880,53,allow,177,94,83,2,31,1,1
65371,445,0,0,drop,66,66,0,1,0,1,0
65227,445,0,0,drop,70,70,0,1,0,1,0
65226,445,0,0,drop,70,70,0,1,0,1,0
49923,443,51816,443,allow,466,392,74,4,1,3,1
53580,445,0,0,drop,70,70,0,1,0,1,0
53573,445,0,0,drop,70,70,0,1,0,1,0
53571,445,0,0,drop,70,70,0,1,0,1,0
65221,445,0,0,drop,70,70,0,1,0,1,0
65360,445,0,0,drop,66,66,0,1,0,1,0
65352,445,0,0,drop,66,66,0,1,0,1,0
53559,445,0,0,drop,70,70,0,1,0,1,0
65349,445,0,0,drop,66,66,0,1,0,1,0
65208,445,0,0,drop,70,70,0,1,0,1,0
65205,445,0,0,drop,70,70,0,1,0,1,0
65342,445,0,0,drop,66,66,0,1,0,1,0
65335,445,0,0,drop,66,66,0,1,0,1,0
65201,445,0,0,drop,70,70,0,1,0,1,0
65199,445,0,0,drop,70,70,0,1,0,1,0
53550,445,0,0,drop,70,70,0,1,0,1,0
53548,445,0,0,drop,70,70,0,1,0,1,0
53546,445,0,0,drop,70,70,0,1,0,1,0
65197,445,0,0,drop,70,70,0,1,0,1,0
65324,445,0,0,drop,66,66,0,1,0,1,0
65321,445,0,0,drop,66,66,0,1,0,1,0
65325,445,0,0,drop,66,66,0,1,0,1,0
65326,445,0,0,drop,66,66,0,1,0,1,0
65319,445,0,0,drop,66,66,0,1,0,1,0
65327,445,0,0,drop,66,66,0,1,0,1,0
65323,445,0,0,drop,66,66,0,1,0,1,0
65320,445,0,0,drop,66,66,0,1,0,1,0
65190,445,0,0,drop,70,70,0,1,0,1,0
53543,445,0,0,drop,70,70,0,1,0,1,0
53532,445,0,0,drop,70,70,0,1,0,1,0
53531,445,0,0,drop,70,70,0,1,0,1,0
53529,445,0,0,drop,70,70,0,1,0,1,0
65188,445,0,0,drop,70,70,0,1,0,1,0
65306,445,0,0,drop,66,66,0,1,0,1,0
65305,445,0,0,drop,66,66,0,1,0,1,0
65304,445,0,0,drop,66,66,0,1,0,1,0
65187,445,0,0,drop,70,70,0,1,0,1,0
65186,445,0,0,drop,70,70,0,1,0,1,0
65185,445,0,0,drop,70,70,0,1,0,1,0
65183,445,0,0,drop,70,70,0,1,0,1,0
65181,445,0,0,drop,70,70,0,1,0,1,0
53527,445,0,0,drop,70,70,0,1,0,1,0
53524,445,0,0,drop,70,70,0,1,0,1,0
53523,445,0,0,drop,70,70,0,1,0,1,0
53520,445,0,0,drop,70,70,0,1,0,1,0
65167,445,0,0,drop,70,70,0,1,0,1,0
65166,445,0,0,drop,70,70,0,1,0,1,0
65161,445,0,0,drop,70,70,0,1,0,1,0
65157,445,0,0,drop,70,70,0,1,0,1,0
65156,445,0,0,drop,70,70,0,1,0,1,0
53508,445,0,0,drop,70,70,0,1,0,1,0
53507,445,0,0,drop,70,70,0,1,0,1,0
53503,445,0,0,drop,70,70,0,1,0,1,0
36405,443,39984,443,allow,466,392,74,4,0,3,1
65145,445,0,0,drop,70,70,0,1,0,1,0
65292,445,0,0,drop,66,66,0,1,0,1,0
51548,995,0,0,deny,60,60,0,1,0,1,0
53501,445,0,0,drop,70,70,0,1,0,1,0
65141,445,0,0,drop,70,70,0,1,0,1,0
53499,445,0,0,drop,70,70,0,1,0,1,0
65132,445,0,0,drop,70,70,0,1,0,1,0
65130,445,0,0,drop,70,70,0,1,0,1,0
65131,445,0,0,drop,70,70,0,1,0,1,0
65126,445,0,0,drop,70,70,0,1,0,1,0
65280,445,0,0,drop,66,66,0,1,0,1,0
65276,445,0,0,drop,66,66,0,1,0,1,0
57172,17,0,0,deny,60,60,0,1,0,1,0
65125,445,0,0,deny,70,70,0,1,0,1,0
53487,445,0,0,drop,70,70,0,1,0,1,0
53486,445,0,0,drop,70,70,0,1,0,1,0
53482,445,0,0,drop,70,70,0,1,0,1,0
53481,445,0,0,drop,70,70,0,1,0,1,0
65271,445,0,0,drop,66,66,0,1,0,1,0
55588,53,17857,53,allow,168,86,82,2,34,1,1
59244,53,54257,53,allow,168,78,90,2,30,1,1
53915,1026,61852,1026,allow,70,70,0,1,5,1,0
49531,80,9012,80,allow,78,78,0,1,5,1,0
57004,80,5611,80,allow,214,140,74,4,30,3,1
57010,80,42816,80,allow,214,140,74,4,30,3,1
45628,80,45628,80,allow,1243,530,713,10,20,5,5
50116,22,50116,22,allow,60,60,0,1,5,1,0
44885,443,34599,443,allow,296,78,218,4,19,1,3
60332,53,8836,53,allow,419,111,308,2,31,1,1
44884,443,49689,443,allow,296,78,218,4,19,1,3
65445,80,60875,80,allow,1279,714,565,11,19,6,5
65152,53,43515,53,allow,170,87,83,2,30,1,1
55067,53,8321,53,allow,172,88,84,2,30,1,1
55498,53,58802,53,allow,170,87,83,2,30,1,1
56519,53,32715,53,allow,711,87,624,2,30,1,1
65119,445,0,0,drop,70,70,0,1,0,1,0
65263,445,0,0,drop,66,66,0,1,0,1,0
65262,445,0,0,drop,66,66,0,1,0,1,0
65268,445,0,0,drop,66,66,0,1,0,1,0
65267,445,0,0,drop,66,66,0,1,0,1,0
65259,445,0,0,drop,66,66,0,1,0,1,0
65264,445,0,0,drop,66,66,0,1,0,1,0
65257,445,0,0,drop,66,66,0,1,0,1,0
53473,445,0,0,drop,70,70,0,1,0,1,0
53471,445,0,0,drop,70,70,0,1,0,1,0
53469,445,0,0,drop,70,70,0,1,0,1,0
53467,445,0,0,drop,70,70,0,1,0,1,0
65111,445,0,0,drop,70,70,0,1,0,1,0
65109,445,0,0,drop,70,70,0,1,0,1,0
65104,445,0,0,drop,70,70,0,1,0,1,0
65103,445,0,0,drop,70,70,0,1,0,1,0
53462,445,0,0,drop,70,70,0,1,0,1,0
53460,445,0,0,drop,70,70,0,1,0,1,0
53459,445,0,0,drop,70,70,0,1,0,1,0
65250,445,0,0,drop,66,66,0,1,0,1,0
53458,445,0,0,drop,70,70,0,1,0,1,0
65248,445,0,0,drop,66,66,0,1,0,1,0
53704,23,0,0,deny,60,60,0,1,0,1,0
65099,445,0,0,drop,70,70,0,1,0,1,0
65246,445,0,0,drop,66,66,0,1,0,1,0
65244,445,0,0,drop,66,66,0,1,0,1,0
65242,445,0,0,drop,66,66,0,1,0,1,0
65098,445,0,0,drop,70,70,0,1,0,1,0
53456,445,0,0,drop,70,70,0,1,0,1,0
53448,445,0,0,drop,70,70,0,1,0,1,0
53442,445,0,0,drop,70,70,0,1,0,1,0
65093,445,0,0,drop,70,70,0,1,0,1,0
65232,445,0,0,drop,66,66,0,1,0,1,0
64653,53,13693,53,allow,241,94,147,2,30,1,1
55075,53,27475,53,allow,168,78,90,2,30,1,1
56742,443,19670,443,allow,1327,918,409,10,34,6,4
39011,80,17481,80,allow,1114,534,580,12,15,7,5
57150,53,60378,53,allow,177,94,83,2,29,1,1
55921,53,64539,53,allow,177,94,83,2,29,1,1
42520,53,41857,53,allow,168,78,90,2,30,1,1
55957,53,34097,53,allow,178,94,84,2,30,1,1
57006,80,58727,80,allow,214,140,74,4,30,3,1
57014,80,25497,80,allow,214,140,74,4,30,3,1
57011,80,37769,80,allow,214,140,74,4,30,3,1
57009,80,12239,80,allow,214,140,74,4,30,3,1
57013,80,33223,80,allow,526,304,222,8,30,5,3
58983,53,44611,53,allow,168,78,90,2,29,1,1
49985,53,62790,53,allow,227,102,125,2,29,1,1
57192,53,44126,53,allow,177,94,83,2,30,1,1
57192,53,42489,53,allow,177,94,83,2,30,1,1
39852,53,51714,53,allow,223,78,145,2,30,1,1
46881,53,46881,53,allow,197,90,107,2,30,1,1
56414,53,14395,53,allow,178,94,84,2,30,1,1
64985,53,10267,53,allow,86,86,0,1,60,1,0
64630,53,37942,53,allow,350,94,256,2,30,1,1
49407,53,49407,53,allow,247,98,149,2,32,1,1
65431,53,65431,53,allow,262,106,156,2,31,1,1
55244,53,11760,53,allow,168,78,90,2,30,1,1
55498,53,29212,53,allow,177,94,83,2,30,1,1
55407,53,58404,53,allow,195,94,101,2,30,1,1
56924,53,57471,53,allow,177,94,83,2,30,1,1
55498,53,62567,53,allow,177,94,83,2,30,1,1
40430,80,30893,80,allow,1566,754,812,10,15,6,4
65152,53,60141,53,allow,177,94,83,2,30,1,1
56182,80,62619,80,allow,2085,797,1288,10,15,6,4
57005,80,30107,80,allow,214,140,74,4,30,3,1
57445,66,37294,66,allow,70,70,0,2,8,2,0
50684,80,15318,80,allow,62,62,0,1,5,1,0
55584,53,38540,53,allow,177,94,83,2,29,1,1
64398,53,23095,53,allow,181,86,95,2,29,1,1
65152,53,30200,53,allow,177,94,83,2,30,1,1
54979,53,4787,53,allow,102,102,0,1,59,1,0
65075,53,31161,53,allow,293,94,199,2,29,1,1
55199,53,60419,53,allow,223,78,145,2,30,1,1
49861,53,46345,53,allow,261,94,167,2,30,1,1
49996,53,34015,53,allow,210,102,108,2,30,1,1
56994,53,32105,53,allow,177,94,83,2,30,1,1
49201,53,24647,53,allow,243,86,157,2,30,1,1
52651,53,52651,53,allow,414,268,146,3,31,2,1
57396,443,49419,443,allow,362,302,60,2,5,1,1
56924,53,46939,53,allow,177,94,83,2,30,1,1
36946,123,44700,123,allow,184,94,90,2,30,1,1
59038,53,59038,53,allow,832,106,726,2,30,1,1
65403,53,49597,53,allow,359,94,265,2,30,1,1
65092,53,51583,53,allow,263,94,169,2,30,1,1
65319,53,54613,53,allow,200,94,106,2,30,1,1
57354,53,4539,53,allow,177,94,83,2,30,1,1
58732,443,10734,443,allow,1038,502,536,16,33,8,8
44979,443,29869,443,allow,130,70,60,3,5,2,1
43513,443,9885,443,allow,224,164,60,3,5,2,1
50629,443,56409,443,allow,70,70,0,1,5,1,0
55067,53,59893,53,allow,178,94,84,2,30,1,1
40554,53,2086,53,allow,223,78,145,2,30,1,1
64470,53,40171,53,allow,261,94,167,2,30,1,1
65194,53,61837,53,allow,402,142,260,2,31,1,1
64049,1029,15442,1029,allow,70,70,0,1,5,1,0
57192,53,38984,53,allow,177,94,83,2,30,1,1
64260,53,38791,53,allow,211,78,133,2,30,1,1
65224,445,0,0,drop,66,66,0,1,0,1,0
53431,445,0,0,drop,70,70,0,1,0,1,0
65080,445,0,0,drop,70,70,0,1,0,1,0
65221,445,0,0,drop,66,66,0,1,0,1,0
65077,445,0,0,drop,70,70,0,1,0,1,0
65215,445,0,0,drop,66,66,0,1,0,1,0
65207,445,0,0,drop,66,66,0,1,0,1,0
65072,445,0,0,drop,70,70,0,1,0,1,0
65071,445,0,0,drop,70,70,0,1,0,1,0
65069,445,0,0,drop,70,70,0,1,0,1,0
53423,445,0,0,drop,70,70,0,1,0,1,0
53419,445,0,0,drop,70,70,0,1,0,1,0
53418,445,0,0,drop,70,70,0,1,0,1,0
65198,445,0,0,drop,66,66,0,1,0,1,0
65195,445,0,0,drop,66,66,0,1,0,1,0
65192,445,0,0,drop,66,66,0,1,0,1,0
65199,445,0,0,drop,66,66,0,1,0,1,0
65196,445,0,0,drop,66,66,0,1,0,1,0
65197,445,0,0,drop,66,66,0,1,0,1,0
65193,445,0,0,drop,66,66,0,1,0,1,0
65191,445,0,0,drop,66,66,0,1,0,1,0
57677,23,0,0,deny,60,60,0,1,0,1,0
65062,445,0,0,drop,70,70,0,1,0,1,0
65060,445,0,0,drop,70,70,0,1,0,1,0
53416,445,0,0,drop,70,70,0,1,0,1,0
53408,445,0,0,drop,70,70,0,1,0,1,0
53404,445,0,0,drop,70,70,0,1,0,1,0
53403,445,0,0,drop,70,70,0,1,0,1,0
65059,445,0,0,drop,70,70,0,1,0,1,0
65058,445,0,0,drop,70,70,0,1,0,1,0
65057,445,0,0,drop,70,70,0,1,0,1,0
65178,445,0,0,drop,66,66,0,1,0,1,0
65177,445,0,0,drop,66,66,0,1,0,1,0
65176,445,0,0,drop,66,66,0,1,0,1,0
65055,445,0,0,drop,70,70,0,1,0,1,0
65051,445,0,0,drop,70,70,0,1,0,1,0
53398,445,0,0,drop,70,70,0,1,0,1,0
65039,445,0,0,drop,70,70,0,1,0,1,0
65038,445,0,0,drop,70,70,0,1,0,1,0
65034,445,0,0,drop,70,70,0,1,0,1,0
53395,445,0,0,drop,70,70,0,1,0,1,0
53394,445,0,0,drop,70,70,0,1,0,1,0
53392,445,0,0,drop,70,70,0,1,0,1,0
65029,445,0,0,drop,70,70,0,1,0,1,0
65028,445,0,0,drop,70,70,0,1,0,1,0
65017,445,0,0,drop,70,70,0,1,0,1,0
53380,445,0,0,deny,70,70,0,1,0,1,0
53379,445,0,0,drop,70,70,0,1,0,1,0
53375,445,0,0,drop,70,70,0,1,0,1,0
65165,445,0,0,drop,66,66,0,1,0,1,0
65013,445,0,0,drop,70,70,0,1,0,1,0
53373,445,0,0,drop,70,70,0,1,0,1,0
55521,53,16753,53,allow,711,87,624,2,30,1,1
55440,53,50711,53,allow,711,87,624,2,30,1,1
54957,53,36470,53,allow,99,99,0,1,30,1,0
64898,53,23347,53,allow,487,201,286,6,37,3,3
49878,53,34561,53,allow,216,94,122,2,30,1,1
55772,53,55772,53,allow,194,87,107,2,30,1,1
37319,80,37445,80,allow,1056,682,374,10,15,6,4
56998,53,8754,53,allow,170,87,83,2,31,1,1
56808,53,41016,53,allow,90,90,0,1,30,1,0
56994,53,65507,53,allow,170,87,83,2,30,1,1
55957,53,38699,53,allow,172,88,84,2,30,1,1
56273,53,61553,53,allow,194,99,95,2,30,1,1
50584,53,13408,53,allow,793,101,692,2,30,1,1
65498,53,22566,53,allow,752,93,659,2,31,1,1
53366,445,0,0,drop,70,70,0,1,0,1,0
65003,445,0,0,drop,70,70,0,1,0,1,0
65002,445,0,0,drop,70,70,0,1,0,1,0
65001,445,0,0,drop,70,70,0,1,0,1,0
65000,445,0,0,drop,70,70,0,1,0,1,0
64997,445,0,0,drop,70,70,0,1,0,1,0
65150,445,0,0,drop,66,66,0,1,0,1,0
65147,445,0,0,drop,66,66,0,1,0,1,0
53360,445,0,0,drop,70,70,0,1,0,1,0
53358,445,0,0,drop,70,70,0,1,0,1,0
53354,445,0,0,drop,70,70,0,1,0,1,0
53352,445,0,0,drop,70,70,0,1,0,1,0
64990,445,0,0,drop,70,70,0,1,0,1,0
65143,445,0,0,drop,66,66,0,1,0,1,0
65135,445,0,0,drop,66,66,0,1,0,1,0
65136,445,0,0,drop,66,66,0,1,0,1,0
65138,445,0,0,drop,66,66,0,1,0,1,0
65130,445,0,0,drop,66,66,0,1,0,1,0
65131,445,0,0,drop,66,66,0,1,0,1,0
65132,445,0,0,drop,66,66,0,1,0,1,0
65128,445,0,0,drop,66,66,0,1,0,1,0
53346,445,0,0,drop,70,70,0,1,0,1,0
64981,445,0,0,drop,70,70,0,1,0,1,0
64980,445,0,0,drop,70,70,0,1,0,1,0
53343,445,0,0,drop,70,70,0,1,0,1,0
53342,445,0,0,drop,70,70,0,1,0,1,0
53340,445,0,0,drop,70,70,0,1,0,1,0
64974,445,0,0,drop,70,70,0,1,0,1,0
64973,445,0,0,drop,70,70,0,1,0,1,0
53337,445,0,0,drop,70,70,0,1,0,1,0
53336,445,0,0,drop,70,70,0,1,0,1,0
53335,445,0,0,drop,70,70,0,1,0,1,0
65121,445,0,0,drop,66,66,0,1,0,1,0
53330,445,0,0,drop,70,70,0,1,0,1,0
64969,445,0,0,drop,70,70,0,1,0,1,0
65120,445,0,0,drop,66,66,0,1,0,1,0
65117,445,0,0,drop,66,66,0,1,0,1,0
42065,53,0,0,allow,86,86,0,1,30,1,0
56414,53,12496,53,allow,178,94,84,2,29,1,1
55957,53,35891,53,allow,178,94,84,2,29,1,1
55957,53,33865,53,allow,178,94,84,2,30,1,1
56922,53,40001,53,allow,168,86,82,2,30,1,1
56126,53,5534,53,allow,177,94,83,2,30,1,1
64852,53,45042,53,allow,209,110,99,2,30,1,1
64966,53,61255,53,allow,347,100,247,4,49,2,2
56273,53,51229,53,allow,197,102,95,2,33,1,1
49768,53,39040,53,allow,459,103,356,4,43,2,2
57149,53,34608,53,allow,382,94,288,2,30,1,1
49435,53,64990,53,allow,608,199,409,6,69,3,3
56654,53,47578,53,allow,102,102,0,1,30,1,0
65035,53,56043,53,allow,234,102,132,2,30,1,1
56998,53,31320,53,allow,177,94,83,2,30,1,1
56998,53,64754,53,allow,177,94,83,2,30,1,1
62995,53,21772,53,allow,102,102,0,1,30,1,0
53166,53,17813,53,allow,168,78,90,2,30,1,1
65374,53,40635,53,allow,376,102,274,4,47,2,2
64932,53,8604,53,allow,230,102,128,2,30,1,1
57121,53,54174,53,allow,257,110,147,2,30,1,1
65352,53,23820,53,allow,416,102,314,2,30,1,1
65323,53,53376,53,allow,247,118,129,2,30,1,1
64406,53,3194,53,allow,102,102,0,1,30,1,0
57158,53,11939,53,allow,969,86,883,2,30,1,1
46525,53,46525,53,allow,404,259,145,3,32,2,1
64041,80,63585,80,allow,314,192,122,6,15,4,2
49196,53,18490,53,allow,230,91,139,3,47,2,1
49746,53,11363,53,allow,236,94,142,2,29,1,1
65313,53,20235,53,allow,802,288,514,8,75,4,4
57354,53,26026,53,allow,177,94,83,2,29,1,1
55048,53,48265,53,allow,215,94,121,2,29,1,1
49432,53,40864,53,allow,338,118,220,2,29,1,1
57273,53,29269,53,allow,177,94,83,2,30,1,1
53791,53,19031,53,allow,102,102,0,1,30,1,0
52758,53,52758,53,allow,197,90,107,2,30,1,1
51166,53,27662,53,allow,168,78,90,2,30,1,1
55218,53,56966,53,allow,402,142,260,2,30,1,1
56994,53,35888,53,allow,177,94,83,2,30,1,1
54553,53,37407,53,allow,102,102,0,1,30,1,0
55305,53,21908,53,allow,94,94,0,1,30,1,0
36502,53,33412,53,allow,168,78,90,2,30,1,1
46351,53,46351,53,allow,262,106,156,2,31,1,1
49766,53,54774,53,allow,234,102,132,2,30,1,1
60438,53,64563,53,allow,78,78,0,1,30,1,0
55786,53,55786,53,allow,247,98,149,2,32,1,1
57273,53,15438,53,allow,177,94,83,2,30,1,1
59182,53,59092,53,allow,168,78,90,2,30,1,1
56922,53,64459,53,allow,168,86,82,2,30,1,1
64631,53,53048,53,allow,226,102,124,2,30,1,1
61637,53,21621,53,allow,86,86,0,1,30,1,0
55445,53,8991,53,allow,102,102,0,1,30,1,0
56994,53,19050,53,allow,177,94,83,2,30,1,1
57408,53,58963,53,allow,195,102,93,2,33,1,1
50634,53,32177,53,allow,218,86,132,2,30,1,1
64764,53,35102,53,allow,211,102,109,2,30,1,1
50426,53,48591,53,allow,889,404,485,10,30,5,5
56126,53,21706,53,allow,177,94,83,2,30,1,1
49702,53,29408,53,allow,771,102,669,2,31,1,1
54986,53,53684,53,allow,164,78,86,2,30,1,1
36291,53,42350,53,allow,199,94,105,2,31,1,1
65116,445,0,0,drop,66,66,0,1,0,1,0
64968,445,0,0,drop,70,70,0,1,0,1,0
65115,445,0,0,drop,66,66,0,1,0,1,0
53327,445,0,0,drop,70,70,0,1,0,1,0
64963,445,0,0,drop,70,70,0,1,0,1,0
53317,445,0,0,drop,70,70,0,1,0,1,0
53316,445,0,0,drop,70,70,0,1,0,1,0
65103,445,0,0,drop,66,66,0,1,0,1,0
65096,445,0,0,drop,66,66,0,1,0,1,0
53302,445,0,0,drop,70,70,0,1,0,1,0
64950,445,0,0,drop,70,70,0,1,0,1,0
64947,445,0,0,drop,70,70,0,1,0,1,0
65093,445,0,0,drop,66,66,0,1,0,1,0
65085,445,0,0,drop,66,66,0,1,0,1,0
65078,445,0,0,drop,66,66,0,1,0,1,0
64942,445,0,0,drop,70,70,0,1,0,1,0
64941,445,0,0,drop,70,70,0,1,0,1,0
64939,445,0,0,drop,70,70,0,1,0,1,0
53294,445,0,0,drop,70,70,0,1,0,1,0
53292,445,0,0,drop,70,70,0,1,0,1,0
53291,445,0,0,drop,70,70,0,1,0,1,0
65063,445,0,0,drop,66,66,0,1,0,1,0
65065,445,0,0,drop,66,66,0,1,0,1,0
65069,445,0,0,drop,66,66,0,1,0,1,0
65066,445,0,0,drop,66,66,0,1,0,1,0
65070,445,0,0,drop,66,66,0,1,0,1,0
65068,445,0,0,drop,66,66,0,1,0,1,0
65071,445,0,0,drop,66,66,0,1,0,1,0
65067,445,0,0,drop,66,66,0,1,0,1,0
64932,445,0,0,drop,70,70,0,1,0,1,0
64930,445,0,0,drop,70,70,0,1,0,1,0
64929,445,0,0,drop,70,70,0,1,0,1,0
64928,445,0,0,drop,70,70,0,1,0,1,0
53289,445,0,0,drop,70,70,0,1,0,1,0
53287,445,0,0,drop,70,70,0,1,0,1,0
53283,445,0,0,drop,70,70,0,1,0,1,0
53277,445,0,0,drop,70,70,0,1,0,1,0
64927,445,0,0,drop,70,70,0,1,0,1,0
51769,17,0,0,deny,60,60,0,1,0,1,0
64921,445,0,0,drop,70,70,0,1,0,1,0
64922,445,0,0,drop,70,70,0,1,0,1,0
65050,445,0,0,drop,66,66,0,1,0,1,0
65049,445,0,0,drop,66,66,0,1,0,1,0
65047,445,0,0,drop,66,66,0,1,0,1,0
53669,23,0,0,deny,60,60,0,1,0,1,0
64909,445,0,0,drop,70,70,0,1,0,1,0
64908,445,0,0,drop,70,70,0,1,0,1,0
64904,445,0,0,drop,70,70,0,1,0,1,0
64898,445,0,0,drop,70,70,0,1,0,1,0
64899,445,0,0,drop,70,70,0,1,0,1,0
53270,445,0,0,drop,70,70,0,1,0,1,0
53265,445,0,0,drop,70,70,0,1,0,1,0
53263,445,0,0,drop,70,70,0,1,0,1,0
53259,445,0,0,drop,70,70,0,1,0,1,0
64887,445,0,0,drop,70,70,0,1,0,1,0
55605,53,56113,53,allow,196,100,96,2,30,1,1
56099,53,33681,53,allow,701,88,613,2,30,1,1
56228,53,46587,53,allow,711,87,624,2,30,1,1
58149,443,24568,443,allow,153,93,60,2,5,1,1
57408,53,58813,53,allow,190,97,93,2,30,1,1
56374,53,54087,53,allow,711,87,624,2,30,1,1
58402,53,52417,53,allow,578,286,292,9,15,5,4
57368,53,6129,53,allow,701,88,613,2,30,1,1
49240,53,28241,53,allow,198,101,97,2,30,1,1
55830,53,42279,53,allow,170,87,83,2,30,1,1
58664,53,14984,53,allow,192,90,102,2,30,1,1
65316,53,63877,53,allow,780,93,687,2,30,1,1
56738,53,36120,53,allow,264,87,177,4,37,2,2
55601,53,41824,53,allow,815,95,720,2,30,1,1
55850,53,58369,53,allow,816,97,719,2,30,1,1
50408,53,36344,53,allow,182,93,89,2,31,1,1
50579,53,55360,53,allow,174,89,85,2,31,1,1
49708,53,5780,53,allow,172,88,84,2,31,1,1
64125,53,8672,53,allow,198,101,97,2,31,1,1
56848,53,54786,53,allow,764,99,665,2,31,1,1
53250,445,0,0,drop,70,70,0,1,0,1,0
53252,445,0,0,drop,70,70,0,1,0,1,0
53247,445,0,0,drop,70,70,0,1,0,1,0
65038,445,0,0,drop,66,66,0,1,0,1,0
64883,445,0,0,drop,70,70,0,1,0,1,0
65529,53,12629,53,allow,199,102,97,2,30,1,1
64872,445,0,0,drop,70,70,0,1,0,1,0
64874,445,0,0,drop,70,70,0,1,0,1,0
64871,445,0,0,drop,70,70,0,1,0,1,0
53245,445,0,0,drop,70,70,0,1,0,1,0
64869,445,0,0,drop,70,70,0,1,0,1,0
53244,445,0,0,drop,70,70,0,1,0,1,0
64867,445,0,0,drop,70,70,0,1,0,1,0
40120,23,0,0,deny,60,60,0,1,0,1,0
65023,445,0,0,drop,66,66,0,1,0,1,0
65019,445,0,0,drop,66,66,0,1,0,1,0
64860,445,0,0,drop,70,70,0,1,0,1,0
53233,445,0,0,drop,70,70,0,1,0,1,0
53230,445,0,0,drop,70,70,0,1,0,1,0
56738,53,8511,53,allow,264,87,177,4,37,2,2
64801,53,57986,53,allow,211,102,109,2,29,1,1
49240,53,11212,53,allow,199,102,97,2,29,1,1
49271,53,54358,53,allow,186,102,84,2,30,1,1
52125,80,43801,80,allow,2178,1003,1175,10,15,6,4
57691,53,57691,53,allow,247,98,149,2,32,1,1
64899,53,42372,53,allow,767,102,665,2,29,1,1
40839,53,42784,53,allow,78,78,0,1,29,1,0
53910,1024,45263,1024,allow,70,70,0,1,4,1,0
49240,53,18179,53,allow,199,102,97,2,30,1,1
65282,53,39898,53,allow,193,102,91,2,30,1,1
55830,53,20748,53,allow,177,94,83,2,30,1,1
49240,53,19807,53,allow,330,101,229,4,47,2,2
49271,53,62549,53,allow,178,94,84,2,30,1,1
44401,53,44401,53,allow,197,90,107,2,30,1,1
55683,53,63904,53,allow,391,134,257,2,30,1,1
49922,53,18616,53,allow,583,105,478,4,42,2,2
57208,53,43799,53,allow,184,86,98,2,30,1,1
65529,53,2543,53,allow,199,102,97,2,30,1,1
61044,53,61044,53,allow,180,82,98,2,30,1,1
64610,53,2406,53,allow,292,102,190,2,30,1,1
56231,53,14277,53,allow,268,94,174,2,30,1,1
57161,53,62554,53,allow,196,94,102,2,30,1,1
65196,53,20787,53,allow,164,86,78,2,30,1,1
65282,53,16283,53,allow,193,102,91,2,30,1,1
49442,53,12597,53,allow,326,110,216,2,30,1,1
65057,53,20625,53,allow,397,102,295,2,30,1,1
56840,53,4523,53,allow,242,110,132,2,30,1,1
65465,53,17852,53,allow,755,102,653,2,29,1,1
56738,53,23984,53,allow,264,87,177,4,37,2,2
56998,53,58740,53,allow,177,94,83,2,29,1,1
52308,53,36287,53,allow,70,70,0,1,29,1,0
65462,53,17722,53,allow,102,102,0,1,30,1,0
55988,53,26621,53,allow,353,94,259,2,30,1,1
52077,53,26834,53,allow,199,94,105,2,30,1,1
55039,53,9278,53,allow,177,94,83,2,30,1,1
55039,53,21186,53,allow,177,94,83,2,30,1,1
64823,53,48646,53,allow,210,102,108,2,30,1,1
55830,53,13004,53,allow,177,94,83,2,30,1,1
65130,53,36063,53,allow,266,110,156,2,30,1,1
55830,53,38726,53,allow,177,94,83,2,29,1,1
56185,53,59066,53,allow,216,94,122,2,30,1,1
64220,53,21263,53,allow,265,110,155,2,30,1,1
59399,53,32458,53,allow,232,94,138,2,30,1,1
56326,53,62646,53,allow,177,94,83,2,30,1,1
64125,53,22287,53,allow,199,102,97,2,31,1,1
58345,123,37586,123,allow,184,94,90,2,30,1,1
65343,53,9995,53,allow,197,102,95,2,30,1,1
65082,53,20499,53,allow,183,94,89,2,31,1,1
55293,53,52510,53,allow,230,110,120,2,30,1,1
65100,53,63534,53,allow,199,102,97,2,30,1,1
64912,53,63953,53,allow,356,118,238,2,30,1,1
65218,53,61017,53,allow,193,102,91,2,31,1,1
44894,443,39327,443,allow,1849,1130,719,17,36,9,8
50640,80,59027,80,allow,2374,936,1438,13,45,7,6
64426,53,20042,53,allow,289,101,188,4,51,2,2
49582,53,29592,53,allow,168,78,90,2,30,1,1
54613,53,0,0,allow,86,86,0,1,30,1,0
58771,53,58771,53,allow,226,106,120,2,30,1,1
65343,53,45711,53,allow,197,102,95,2,30,1,1
57442,53,59819,53,allow,411,110,301,2,30,1,1
55423,53,31871,53,allow,177,94,83,2,31,1,1
64259,53,65307,53,allow,211,78,133,2,31,1,1
49515,53,61596,53,allow,195,102,93,2,31,1,1
49516,53,19547,53,allow,183,94,89,2,31,1,1
65355,53,61445,53,allow,741,94,647,2,30,1,1
65100,53,16934,53,allow,199,102,97,2,30,1,1
51987,443,55315,443,allow,134,60,74,3,5,2,1
50408,53,10616,53,allow,183,94,89,2,30,1,1
54978,80,11814,80,allow,1448,539,909,17,32,9,8
49860,53,46004,53,allow,212,102,110,2,30,1,1
58058,53,0,0,allow,86,86,0,1,30,1,0
53226,445,0,0,drop,70,70,0,1,0,1,0
53223,445,0,0,drop,70,70,0,1,0,1,0
65014,445,0,0,drop,66,66,0,1,0,1,0
65006,445,0,0,drop,66,66,0,1,0,1,0
65009,445,0,0,drop,66,66,0,1,0,1,0
65008,445,0,0,drop,66,66,0,1,0,1,0
65005,445,0,0,drop,66,66,0,1,0,1,0
64999,445,0,0,drop,66,66,0,1,0,1,0
65002,445,0,0,drop,66,66,0,1,0,1,0
65000,445,0,0,drop,66,66,0,1,0,1,0
64853,445,0,0,drop,70,70,0,1,0,1,0
64850,445,0,0,drop,70,70,0,1,0,1,0
53220,445,0,0,drop,70,70,0,1,0,1,0
53215,445,0,0,drop,70,70,0,1,0,1,0
53214,445,0,0,drop,70,70,0,1,0,1,0
53211,445,0,0,drop,70,70,0,1,0,1,0
64846,445,0,0,drop,70,70,0,1,0,1,0
64845,445,0,0,drop,70,70,0,1,0,1,0
64841,445,0,0,drop,70,70,0,1,0,1,0
53206,445,0,0,drop,70,70,0,1,0,1,0
53204,445,0,0,drop,70,70,0,1,0,1,0
53203,445,0,0,drop,70,70,0,1,0,1,0
64993,445,0,0,drop,66,66,0,1,0,1,0
53202,445,0,0,drop,70,70,0,1,0,1,0
64840,445,0,0,drop,70,70,0,1,0,1,0
64991,445,0,0,drop,66,66,0,1,0,1,0
64988,445,0,0,drop,66,66,0,1,0,1,0
64987,445,0,0,drop,66,66,0,1,0,1,0
64985,445,0,0,drop,66,66,0,1,0,1,0
64835,445,0,0,drop,70,70,0,1,0,1,0
53197,445,0,0,drop,70,70,0,1,0,1,0
53193,445,0,0,drop,70,70,0,1,0,1,0
53191,445,0,0,drop,70,70,0,1,0,1,0
64975,445,0,0,deny,66,66,0,1,0,1,0
64822,445,0,0,drop,70,70,0,1,0,1,0
64967,445,0,0,drop,66,66,0,1,0,1,0
53176,445,0,0,drop,70,70,0,1,0,1,0
64819,445,0,0,drop,70,70,0,1,0,1,0
64965,445,0,0,drop,66,66,0,1,0,1,0
64815,445,0,0,drop,70,70,0,1,0,1,0
64958,445,0,0,drop,66,66,0,1,0,1,0
64813,445,0,0,drop,70,70,0,1,0,1,0
64954,445,0,0,drop,66,66,0,1,0,1,0
64811,445,0,0,drop,70,70,0,1,0,1,0
53166,445,0,0,drop,70,70,0,1,0,1,0
53165,445,0,0,drop,70,70,0,1,0,1,0
53162,445,0,0,drop,70,70,0,1,0,1,0
64940,445,0,0,drop,66,66,0,1,0,1,0
64939,445,0,0,drop,66,66,0,1,0,1,0
64937,445,0,0,drop,66,66,0,1,0,1,0
64941,445,0,0,drop,66,66,0,1,0,1,0
64936,445,0,0,drop,66,66,0,1,0,1,0
64938,445,0,0,drop,66,66,0,1,0,1,0
64934,445,0,0,drop,66,66,0,1,0,1,0
64933,445,0,0,drop,66,66,0,1,0,1,0
64804,445,0,0,drop,70,70,0,1,0,1,0
64802,445,0,0,drop,70,70,0,1,0,1,0
64801,445,0,0,drop,70,70,0,1,0,1,0
64800,445,0,0,drop,70,70,0,1,0,1,0
64799,445,0,0,drop,70,70,0,1,0,1,0
64793,445,0,0,drop,70,70,0,1,0,1,0
64795,445,0,0,drop,70,70,0,1,0,1,0
53160,445,0,0,drop,70,70,0,1,0,1,0
53157,445,0,0,drop,70,70,0,1,0,1,0
53155,445,0,0,drop,70,70,0,1,0,1,0
53144,445,0,0,drop,70,70,0,1,0,1,0
64921,445,0,0,drop,66,66,0,1,0,1,0
64920,445,0,0,drop,66,66,0,1,0,1,0
64918,445,0,0,drop,66,66,0,1,0,1,0
64781,445,0,0,drop,70,70,0,1,0,1,0
64780,445,0,0,drop,70,70,0,1,0,1,0
64775,445,0,0,drop,70,70,0,1,0,1,0
64770,445,0,0,drop,70,70,0,1,0,1,0
64771,445,0,0,drop,70,70,0,1,0,1,0
56088,53,17141,53,allow,774,101,673,2,30,1,1
56582,53,45513,53,allow,98,98,0,1,30,1,0
64426,53,47787,53,allow,289,101,188,4,50,2,2
56611,53,8939,53,allow,91,91,0,1,30,1,0
65343,53,12324,53,allow,194,99,95,2,30,1,1
65082,53,15912,53,allow,182,93,89,2,31,1,1
50109,53,61948,53,allow,768,99,669,2,30,1,1
54998,53,17431,53,allow,711,87,624,2,30,1,1
55797,53,14709,53,allow,735,88,647,2,30,1,1
59959,80,18461,80,allow,1052,612,440,10,16,5,5
64886,53,27053,53,allow,295,101,194,4,31,2,2
49932,53,49932,53,allow,404,259,145,3,32,2,1
51930,80,17993,80,allow,1669,865,804,13,76,8,5
56712,53,57306,53,allow,170,87,83,2,31,1,1
49516,53,27772,53,allow,182,93,89,2,31,1,1
55434,53,17321,53,allow,1335,87,1248,4,38,2,2
55423,53,7848,53,allow,170,87,83,2,30,1,1
50408,53,52200,53,allow,182,93,89,2,30,1,1
65228,53,60799,53,allow,267,93,174,4,47,2,2
56640,53,60510,53,allow,733,93,640,2,31,1,1
64842,53,17214,53,allow,802,104,698,2,31,1,1
55790,53,7477,53,allow,170,87,83,2,31,1,1
49256,53,34162,53,allow,174,89,85,2,31,1,1
56273,53,26440,53,allow,182,93,89,2,31,1,1
58383,53,25867,53,allow,357,87,270,2,31,1,1
54979,53,3280,53,allow,97,97,0,1,61,1,0
56830,53,57872,53,allow,190,97,93,2,31,1,1
53142,445,0,0,drop,70,70,0,1,0,1,0
53138,445,0,0,drop,70,70,0,1,0,1,0
53133,445,0,0,drop,70,70,0,1,0,1,0
53132,445,0,0,drop,70,70,0,1,0,1,0
64759,445,0,0,drop,70,70,0,1,0,1,0
63538,80,37199,80,allow,578,518,60,2,5,1,1
65266,53,11513,53,allow,754,94,660,2,30,1,1
53123,445,0,0,drop,70,70,0,1,0,1,0
53120,445,0,0,drop,70,70,0,1,0,1,0
53119,445,0,0,drop,70,70,0,1,0,1,0
58897,23,0,0,deny,60,60,0,1,0,1,0
64755,445,0,0,drop,70,70,0,1,0,1,0
64908,445,0,0,drop,66,66,0,1,0,1,0
64744,445,0,0,drop,70,70,0,1,0,1,0
64746,445,0,0,drop,70,70,0,1,0,1,0
64743,445,0,0,drop,70,70,0,1,0,1,0
64740,445,0,0,drop,70,70,0,1,0,1,0
64739,445,0,0,drop,70,70,0,1,0,1,0
53117,445,0,0,drop,70,70,0,1,0,1,0
53116,445,0,0,drop,70,70,0,1,0,1,0
64892,445,0,0,drop,66,66,0,1,0,1,0
64890,445,0,0,drop,66,66,0,1,0,1,0
37826,23,0,0,deny,60,60,0,1,0,1,0
64733,445,0,0,drop,70,70,0,1,0,1,0
45412,53,45412,53,allow,220,90,130,2,30,1,1
54573,80,38100,80,allow,2091,823,1268,12,45,7,5
49991,53,62734,53,allow,257,102,155,2,29,1,1
50433,53,63561,53,allow,193,102,91,2,29,1,1
58894,443,56665,443,allow,354,294,60,2,4,1,1
52098,80,42506,80,allow,1955,913,1042,10,15,6,4
65228,53,63836,53,allow,267,93,174,4,46,2,2
64674,53,13295,53,allow,183,94,89,2,29,1,1
53119,53,39459,53,allow,326,102,224,2,29,1,1
64986,53,51778,53,allow,734,94,640,2,29,1,1
57106,53,23546,53,allow,214,94,120,2,29,1,1
41008,53,32302,53,allow,168,78,90,2,29,1,1
64488,53,18852,53,allow,291,102,189,2,29,1,1
65196,53,56319,53,allow,172,94,78,2,29,1,1
64674,53,50248,53,allow,183,94,89,2,29,1,1
50148,53,50148,53,allow,198,90,108,2,29,1,1
50433,53,29987,53,allow,193,102,91,2,30,1,1
50559,53,33553,53,allow,178,94,84,2,29,1,1
55340,53,25572,53,allow,324,110,214,2,29,1,1
65365,53,21509,53,allow,178,94,84,2,29,1,1
49708,53,32399,53,allow,178,94,84,2,30,1,1
55417,53,4838,53,allow,199,102,97,2,30,1,1
49364,53,30235,53,allow,183,94,89,2,30,1,1
64270,53,47275,53,allow,455,102,353,4,33,2,2
56712,53,17239,53,allow,177,94,83,2,30,1,1
65104,53,20417,53,allow,198,94,104,2,30,1,1
49364,53,20144,53,allow,183,94,89,2,30,1,1
64705,53,6395,53,allow,213,102,111,2,30,1,1
56611,53,54736,53,allow,181,94,87,2,32,1,1
65343,53,45519,53,allow,328,99,229,4,45,2,2
55843,53,63569,53,allow,177,94,83,2,30,1,1
49518,53,62825,53,allow,266,110,156,2,30,1,1
55423,53,51640,53,allow,177,94,83,2,30,1,1
49413,53,49413,53,allow,225,90,135,2,30,1,1
64258,53,3209,53,allow,260,86,174,2,30,1,1
55487,53,39202,53,allow,195,102,93,2,30,1,1
56997,53,32024,53,allow,273,102,171,2,30,1,1
64125,53,26967,53,allow,199,102,97,2,30,1,1
64718,53,58761,53,allow,266,110,156,2,30,1,1
50579,53,23674,53,allow,179,94,85,2,30,1,1
49932,53,55615,53,allow,195,102,93,2,30,1,1
56712,53,47464,53,allow,177,94,83,2,30,1,1
55417,53,14562,53,allow,199,102,97,2,30,1,1
55944,53,13576,53,allow,194,94,100,2,30,1,1
65324,53,23853,53,allow,748,94,654,2,30,1,1
40781,443,52827,443,allow,448,78,370,7,20,2,5
57260,53,31217,53,allow,211,102,109,2,30,1,1
58000,17,58000,17,allow,66,66,0,1,30,1,0
36712,53,0,0,allow,139,70,69,2,30,1,1
49312,53,27461,53,allow,772,102,670,2,30,1,1
49708,53,64935,53,allow,178,94,84,2,30,1,1
56532,53,29846,53,allow,291,88,203,4,50,2,2
45376,80,8854,80,allow,2259,1068,1191,12,31,8,4
65228,53,34659,53,allow,267,93,174,4,46,2,2
64674,53,62663,53,allow,183,94,89,2,29,1,1
49515,53,58908,53,allow,195,102,93,2,29,1,1
56738,53,54145,53,allow,264,87,177,4,36,2,2
50424,53,64071,53,allow,195,102,93,2,29,1,1
63877,53,63877,53,allow,247,98,149,2,32,1,1
64897,53,12641,53,allow,266,110,156,2,30,1,1
65269,53,18855,53,allow,226,102,124,2,30,1,1
56830,53,55667,53,allow,195,102,93,2,30,1,1
55423,53,64857,53,allow,177,94,83,2,30,1,1
60367,53,22365,53,allow,233,110,123,2,30,1,1
56326,53,18129,53,allow,177,94,83,2,29,1,1
52221,53,60196,53,allow,164,78,86,2,29,1,1
50424,53,47336,53,allow,195,102,93,2,30,1,1
64125,53,18557,53,allow,199,102,97,2,30,1,1
55843,53,38678,53,allow,177,94,83,2,30,1,1
65331,53,20706,53,allow,767,102,665,2,29,1,1
49575,53,46030,53,allow,775,102,673,2,29,1,1
45395,53,0,0,allow,86,86,0,1,30,1,0
55291,53,55867,53,allow,243,94,149,2,31,1,1
49516,53,32390,53,allow,183,94,89,2,31,1,1
64886,53,36555,53,allow,199,102,97,2,30,1,1
65092,53,7341,53,allow,197,102,95,2,30,1,1
55908,53,13210,53,allow,389,110,279,2,30,1,1
49752,53,13383,53,allow,199,86,113,2,31,1,1
49852,53,14933,53,allow,230,102,128,2,31,1,1
64987,53,8755,53,allow,357,107,250,4,36,2,2
62499,443,53888,443,allow,1332,876,456,11,26,6,5
49482,53,61985,53,allow,460,84,376,4,46,2,2
63672,53,63672,53,allow,198,90,108,2,30,1,1
49516,53,40491,53,allow,183,94,89,2,30,1,1
49926,53,10749,53,allow,266,110,156,2,30,1,1
65287,53,18878,53,allow,180,94,86,2,31,1,1
56582,53,45398,53,allow,196,102,94,2,33,1,1
55702,80,29070,80,allow,70,70,0,1,5,1,0
49183,53,29082,53,allow,451,91,360,4,36,2,2
64426,53,6048,53,allow,289,101,188,4,50,2,2
65413,53,65505,53,allow,266,110,156,2,30,1,1
65082,53,43263,53,allow,183,94,89,2,30,1,1
65098,53,11310,53,allow,260,94,166,2,30,1,1
56427,53,1277,53,allow,178,94,84,2,30,1,1
49708,53,16944,53,allow,178,94,84,2,30,1,1
48070,53,48070,53,allow,197,90,107,2,30,1,1
55487,53,11679,53,allow,195,102,93,2,30,1,1
59002,53,19057,53,allow,238,94,144,2,30,1,1
59045,53,10960,53,allow,231,110,121,2,30,1,1
55163,53,20116,53,allow,197,102,95,2,31,1,1
64958,53,42023,53,allow,197,102,95,2,31,1,1
65228,53,51061,53,allow,267,93,174,4,46,2,2
65218,53,49451,53,allow,193,102,91,2,30,1,1
55866,53,10182,53,allow,257,94,163,2,30,1,1
49932,53,14546,53,allow,195,102,93,2,30,1,1
49727,53,64244,53,allow,280,110,170,2,31,1,1
49942,53,37670,53,allow,196,94,102,2,31,1,1
49709,53,49112,53,allow,466,93,373,4,50,2,2
49256,53,11555,53,allow,179,94,85,2,30,1,1
55812,53,26314,53,allow,215,94,121,2,30,1,1
65493,53,48274,53,allow,266,110,156,2,30,1,1
65257,53,51798,53,allow,266,110,156,2,30,1,1
53107,445,0,0,drop,70,70,0,1,0,1,0
53106,445,0,0,drop,70,70,0,1,0,1,0
53104,445,0,0,drop,70,70,0,1,0,1,0
53102,445,0,0,drop,70,70,0,1,0,1,0
64887,445,0,0,drop,66,66,0,1,0,1,0
64725,445,0,0,drop,70,70,0,1,0,1,0
64723,445,0,0,drop,70,70,0,1,0,1,0
64873,445,0,0,drop,66,66,0,1,0,1,0
64879,445,0,0,drop,66,66,0,1,0,1,0
64876,445,0,0,drop,66,66,0,1,0,1,0
64882,445,0,0,drop,66,66,0,1,0,1,0
64878,445,0,0,drop,66,66,0,1,0,1,0
64874,445,0,0,drop,66,66,0,1,0,1,0
64881,445,0,0,drop,66,66,0,1,0,1,0
53090,445,0,0,drop,70,70,0,1,0,1,0
53086,445,0,0,drop,70,70,0,1,0,1,0
53085,445,0,0,drop,70,70,0,1,0,1,0
53083,445,0,0,drop,70,70,0,1,0,1,0
64719,445,0,0,drop,70,70,0,1,0,1,0
64717,445,0,0,drop,70,70,0,1,0,1,0
64713,445,0,0,drop,70,70,0,1,0,1,0
64712,445,0,0,drop,70,70,0,1,0,1,0
53077,445,0,0,drop,70,70,0,1,0,1,0
53078,445,0,0,drop,70,70,0,1,0,1,0
53076,445,0,0,drop,70,70,0,1,0,1,0
64863,445,0,0,drop,66,66,0,1,0,1,0
53074,445,0,0,drop,70,70,0,1,0,1,0
64862,445,0,0,drop,66,66,0,1,0,1,0
64858,445,0,0,drop,66,66,0,1,0,1,0
64860,445,0,0,drop,66,66,0,1,0,1,0
64856,445,0,0,drop,66,66,0,1,0,1,0
64707,445,0,0,drop,70,70,0,1,0,1,0
53068,445,0,0,drop,70,70,0,1,0,1,0
53061,445,0,0,drop,70,70,0,1,0,1,0
53060,445,0,0,drop,70,70,0,1,0,1,0
50077,443,55619,443,allow,1786,172,1614,7,0,3,4
64846,445,0,0,drop,66,66,0,1,0,1,0
64694,445,0,0,drop,70,70,0,1,0,1,0
64691,445,0,0,drop,70,70,0,1,0,1,0
64838,445,0,0,drop,66,66,0,1,0,1,0
53048,445,0,0,drop,70,70,0,1,0,1,0
64835,445,0,0,drop,66,66,0,1,0,1,0
64686,445,0,0,drop,70,70,0,1,0,1,0
64685,445,0,0,drop,70,70,0,1,0,1,0
64828,445,0,0,drop,66,66,0,1,0,1,0
64683,445,0,0,drop,70,70,0,1,0,1,0
64819,445,0,0,drop,66,66,0,1,0,1,0
61406,1,0,0,deny,78,78,0,1,0,1,0
53036,445,0,0,drop,70,70,0,1,0,1,0
64676,445,0,0,drop,70,70,0,1,0,1,0
53038,445,0,0,drop,70,70,0,1,0,1,0
53034,445,0,0,drop,70,70,0,1,0,1,0
64812,445,0,0,drop,66,66,0,1,0,1,0
64809,445,0,0,drop,66,66,0,1,0,1,0
64808,445,0,0,drop,66,66,0,1,0,1,0
64811,445,0,0,drop,66,66,0,1,0,1,0
64804,445,0,0,drop,66,66,0,1,0,1,0
64807,445,0,0,drop,66,66,0,1,0,1,0
64805,445,0,0,drop,66,66,0,1,0,1,0
64806,445,0,0,drop,66,66,0,1,0,1,0
64674,445,0,0,drop,70,70,0,1,0,1,0
64673,445,0,0,drop,70,70,0,1,0,1,0
64672,445,0,0,drop,70,70,0,1,0,1,0
64671,445,0,0,drop,70,70,0,1,0,1,0
57013,53,60365,53,allow,172,88,84,2,30,1,1
65176,53,35365,53,allow,182,93,89,2,30,1,1
56070,53,35943,53,allow,770,101,669,2,30,1,1
64788,53,47380,53,allow,168,86,82,2,30,1,1
56414,53,17231,53,allow,88,88,0,1,30,1,0
64622,53,5676,53,allow,738,86,652,2,30,1,1
61797,23,61797,23,allow,60,60,0,1,5,1,0
55985,53,19393,53,allow,738,86,652,2,30,1,1
56273,53,59580,53,allow,182,93,89,2,30,1,1
57395,53,14755,53,allow,262,88,174,4,59,2,2
56878,53,24786,53,allow,168,86,82,2,31,1,1
56018,53,52062,53,allow,762,97,665,2,30,1,1
49932,53,48698,53,allow,190,97,93,2,30,1,1
57887,53,44516,53,allow,174,81,93,2,30,1,1
57356,53,43032,53,allow,780,93,687,2,30,1,1
56415,53,6839,53,allow,198,101,97,2,30,1,1
57287,53,44650,53,allow,752,93,659,2,30,1,1
54652,53,54652,53,allow,216,98,118,2,30,1,1
50665,443,26812,443,allow,374,192,182,7,28,4,3
65218,53,51807,53,allow,186,95,91,2,30,1,1
58369,53,5499,53,allow,174,81,93,2,30,1,1
56289,53,51620,53,allow,749,89,660,2,30,1,1
55370,53,18357,53,allow,747,93,654,2,31,1,1
55970,53,19238,53,allow,760,97,663,2,31,1,1
56964,53,51072,53,allow,174,89,85,2,31,1,1
55492,53,58378,53,allow,760,96,664,2,31,1,1
56217,53,54817,53,allow,182,93,89,2,31,1,1
55163,53,35742,53,allow,194,99,95,2,31,1,1
49695,53,13184,53,allow,772,103,669,2,31,1,1
64958,53,26216,53,allow,194,99,95,2,31,1,1
65287,53,9876,53,allow,176,90,86,2,31,1,1
56562,53,48636,53,allow,182,93,89,2,31,1,1
57129,53,40985,53,allow,793,101,692,2,31,1,1
64665,445,0,0,drop,70,70,0,1,0,1,0
64666,445,0,0,drop,70,70,0,1,0,1,0
53032,445,0,0,drop,70,70,0,1,0,1,0
53028,445,0,0,drop,70,70,0,1,0,1,0
53026,445,0,0,drop,70,70,0,1,0,1,0
53021,445,0,0,drop,70,70,0,1,0,1,0
64653,445,0,0,drop,70,70,0,1,0,1,0
64652,445,0,0,drop,70,70,0,1,0,1,0
64650,445,0,0,drop,70,70,0,1,0,1,0
64792,445,0,0,drop,66,66,0,1,0,1,0
64790,445,0,0,drop,66,66,0,1,0,1,0
64789,445,0,0,drop,66,66,0,1,0,1,0
64642,445,0,0,drop,70,70,0,1,0,1,0
64643,445,0,0,drop,70,70,0,1,0,1,0
53015,445,0,0,drop,70,70,0,1,0,1,0
62580,23,0,0,deny,60,60,0,1,0,1,0
53010,445,0,0,drop,70,70,0,1,0,1,0
53007,445,0,0,drop,70,70,0,1,0,1,0
53004,445,0,0,drop,70,70,0,1,0,1,0
64631,445,0,0,drop,70,70,0,1,0,1,0
52996,445,0,0,drop,70,70,0,1,0,1,0
52994,445,0,0,drop,70,70,0,1,0,1,0
52990,445,0,0,drop,70,70,0,1,0,1,0
64627,445,0,0,drop,70,70,0,1,0,1,0
64778,445,0,0,drop,66,66,0,1,0,1,0
64617,445,0,0,drop,70,70,0,1,0,1,0
64618,445,0,0,drop,70,70,0,1,0,1,0
64615,445,0,0,drop,70,70,0,1,0,1,0
64613,445,0,0,drop,70,70,0,1,0,1,0
64611,445,0,0,drop,70,70,0,1,0,1,0
59807,53,15491,53,allow,263,94,169,2,30,1,1
49874,53,62950,53,allow,196,94,102,2,30,1,1
46751,53,46751,53,allow,220,90,130,2,30,1,1
64788,53,23511,53,allow,168,86,82,2,30,1,1
49256,53,36401,53,allow,179,94,85,2,29,1,1
49729,53,55522,53,allow,210,102,108,2,30,1,1
55790,53,39330,53,allow,177,94,83,2,30,1,1
64426,53,39298,53,allow,669,200,469,6,49,3,3
49934,53,18444,53,allow,478,107,371,4,39,2,2
56427,53,25251,53,allow,178,94,84,2,29,1,1
49532,53,58267,53,allow,334,92,242,4,49,2,2
56534,53,14913,53,allow,177,94,83,2,29,1,1
64886,53,49173,53,allow,199,102,97,2,29,1,1
56830,53,25316,53,allow,195,102,93,2,29,1,1
64886,53,44785,53,allow,199,102,97,2,29,1,1
56081,53,46764,53,allow,186,102,84,2,29,1,1
56712,53,4358,53,allow,177,94,83,2,30,1,1
65176,53,65083,53,allow,183,94,89,2,30,1,1
55991,53,30604,53,allow,183,94,89,2,30,1,1
51994,80,37899,80,allow,366,240,126,7,26,5,2
65488,53,3940,53,allow,266,110,156,2,30,1,1
57013,53,17393,53,allow,178,94,84,2,30,1,1
55700,53,12317,53,allow,337,110,227,2,30,1,1
55588,53,33689,53,allow,168,86,82,2,31,1,1
59019,53,48512,53,allow,179,86,93,2,30,1,1
64324,53,5232,53,allow,344,105,239,4,33,2,2
65460,53,23650,53,allow,184,94,90,2,30,1,1
56661,53,2934,53,allow,288,93,195,4,32,2,2
37629,443,33990,443,allow,172,172,0,2,5,2,0
65249,53,14438,53,allow,1579,94,1485,4,36,2,2
49980,53,10608,53,allow,503,103,400,4,47,2,2
64110,53,20636,53,allow,215,102,113,2,30,1,1
49776,53,49776,53,allow,256,114,142,2,30,1,1
56565,53,34463,53,allow,164,86,78,2,30,1,1
56830,53,56847,53,allow,195,102,93,2,30,1,1
50378,53,48801,53,allow,184,94,90,2,30,1,1
49422,53,49422,53,allow,247,98,149,2,32,1,1
56661,53,16607,53,allow,288,93,195,4,32,2,2
47042,80,50684,80,allow,1122,682,440,11,15,6,5
51973,80,57539,80,allow,426,240,186,8,26,5,3
56406,53,15140,53,allow,213,102,111,2,30,1,1
57183,53,32090,53,allow,178,94,84,2,30,1,1
56661,53,21967,53,allow,288,93,195,4,32,2,2
64865,53,49871,53,allow,305,97,208,4,53,2,2
57395,53,40276,53,allow,262,88,174,4,58,2,2
55524,53,55524,53,allow,197,90,107,2,29,1,1
58414,53,7367,53,allow,245,118,127,2,29,1,1
54961,53,50012,53,allow,211,102,109,2,29,1,1
53911,1025,4663,1025,allow,70,70,0,1,4,1,0
55690,443,36462,443,allow,914,444,470,14,29,7,7
56534,53,47047,53,allow,177,94,83,2,29,1,1
65092,53,28213,53,allow,197,102,95,2,29,1,1
65087,53,28763,53,allow,229,94,135,2,30,1,1
41283,53,41283,53,allow,247,98,149,2,31,1,1
55790,53,54535,53,allow,177,94,83,2,30,1,1
65482,53,62841,53,allow,374,91,283,4,33,2,2
57395,53,64683,53,allow,262,88,174,4,58,2,2
59748,53,55446,53,allow,230,110,120,2,29,1,1
56415,53,33684,53,allow,199,102,97,2,29,1,1
59582,53,61781,53,allow,256,102,154,2,29,1,1
55626,53,3780,53,allow,319,126,193,2,29,1,1
51971,80,56168,80,allow,426,240,186,8,26,5,3
53715,53,53715,53,allow,216,98,118,2,29,1,1
65266,53,53450,53,allow,233,102,131,2,29,1,1
56081,53,27644,53,allow,186,102,84,2,29,1,1
64058,53,58322,53,allow,280,110,170,2,30,1,1
56415,53,13196,53,allow,199,102,97,2,29,1,1
65176,53,64926,53,allow,183,94,89,2,29,1,1
64424,53,20113,53,allow,194,94,100,2,30,1,1
49165,53,42494,53,allow,257,126,131,2,30,1,1
50051,53,51528,53,allow,766,102,664,2,30,1,1
55991,53,7983,53,allow,183,94,89,2,30,1,1
64749,53,28339,53,allow,199,94,105,2,33,1,1
55230,53,65301,53,allow,467,96,371,4,44,2,2
64237,53,55167,53,allow,199,86,113,2,30,1,1
65161,53,65161,53,allow,256,114,142,2,30,1,1
56415,53,9528,53,allow,199,102,97,2,30,1,1
49218,53,31585,53,allow,179,86,93,2,30,1,1
55914,53,21562,53,allow,212,102,110,2,30,1,1
55163,53,9459,53,allow,197,102,95,2,30,1,1
46658,53,46658,53,allow,216,98,118,2,30,1,1
55792,53,55035,53,allow,199,102,97,2,30,1,1
49790,53,8407,53,allow,229,110,119,2,30,1,1
55790,53,27986,53,allow,177,94,83,2,30,1,1
64958,53,60361,53,allow,197,102,95,2,30,1,1
64407,53,28727,53,allow,291,94,197,2,30,1,1
49759,53,39321,53,allow,201,86,115,2,30,1,1
65184,53,30460,53,allow,225,102,123,2,30,1,1
56273,53,28560,53,allow,183,94,89,2,30,1,1
65287,53,16028,53,allow,180,94,86,2,30,1,1
56068,53,21388,53,allow,214,102,112,2,30,1,1
37924,80,11096,80,allow,214,140,74,4,15,3,1
51972,80,30646,80,allow,426,240,186,8,26,5,3
57395,53,28814,53,allow,262,88,174,4,59,2,2
64922,53,12906,53,allow,255,102,153,2,30,1,1
64530,53,5563,53,allow,264,110,154,2,30,1,1
56565,53,24401,53,allow,164,86,78,2,30,1,1
56911,53,22477,53,allow,211,78,133,2,30,1,1
57013,53,1233,53,allow,178,94,84,2,30,1,1
49256,53,62875,53,allow,179,94,85,2,30,1,1
49932,53,43257,53,allow,195,102,93,2,30,1,1
51463,53,6551,53,allow,417,86,331,2,31,1,1
56217,53,61344,53,allow,183,94,89,2,31,1,1
50109,53,52643,53,allow,198,110,88,2,31,1,1
49334,53,44213,53,allow,194,102,92,2,31,1,1
64467,53,16595,53,allow,184,94,90,2,31,1,1
57183,53,6659,53,allow,178,94,84,2,31,1,1
55163,53,4604,53,allow,197,102,95,2,31,1,1
56195,53,13348,53,allow,194,94,100,2,30,1,1
56648,53,16460,53,allow,199,102,97,2,31,1,1
64995,53,32873,53,allow,210,110,100,2,31,1,1
56622,53,41480,53,allow,179,94,85,2,31,1,1
56964,53,57920,53,allow,179,94,85,2,30,1,1
64467,53,4748,53,allow,184,94,90,2,30,1,1
55633,53,30545,53,allow,195,102,93,2,30,1,1
49993,53,3383,53,allow,211,102,109,2,30,1,1
39890,123,28941,123,allow,184,94,90,2,30,1,1
65059,53,30320,53,allow,168,86,82,2,31,1,1
56878,53,49284,53,allow,168,86,82,2,31,1,1
56225,53,55911,53,allow,183,94,89,2,31,1,1
56414,53,33736,53,allow,178,94,84,2,31,1,1
43261,53,43261,53,allow,247,98,149,2,34,1,1
57432,53,57432,53,allow,247,98,149,2,34,1,1
37628,443,18772,443,allow,70,70,0,2,5,2,0
59488,80,65175,80,allow,1114,534,580,12,16,7,5
52989,445,0,0,drop,70,70,0,1,0,1,0
52988,445,0,0,drop,70,70,0,1,0,1,0
64763,445,0,0,drop,66,66,0,1,0,1,0
64765,445,0,0,drop,66,66,0,1,0,1,0
64605,445,0,0,drop,70,70,0,1,0,1,0
52977,445,0,0,drop,70,70,0,1,0,1,0
52978,445,0,0,drop,70,70,0,1,0,1,0
52974,445,0,0,drop,70,70,0,1,0,1,0
52976,445,0,0,drop,70,70,0,1,0,1,0
64597,445,0,0,drop,70,70,0,1,0,1,0
64596,445,0,0,drop,70,70,0,1,0,1,0
64758,445,0,0,drop,66,66,0,1,0,1,0
64751,445,0,0,drop,66,66,0,1,0,1,0
64746,445,0,0,drop,66,66,0,1,0,1,0
64749,445,0,0,drop,66,66,0,1,0,1,0
64748,445,0,0,drop,66,66,0,1,0,1,0
64744,445,0,0,drop,66,66,0,1,0,1,0
64745,445,0,0,drop,66,66,0,1,0,1,0
64742,445,0,0,drop,66,66,0,1,0,1,0
64591,445,0,0,drop,70,70,0,1,0,1,0
52962,445,0,0,drop,70,70,0,1,0,1,0
64589,445,0,0,drop,70,70,0,1,0,1,0
52959,445,0,0,drop,70,70,0,1,0,1,0
52958,445,0,0,drop,70,70,0,1,0,1,0
52955,445,0,0,drop,70,70,0,1,0,1,0
64585,445,0,0,drop,70,70,0,1,0,1,0
64583,445,0,0,drop,70,70,0,1,0,1,0
52951,445,0,0,drop,70,70,0,1,0,1,0
52949,445,0,0,drop,70,70,0,1,0,1,0
52950,445,0,0,drop,70,70,0,1,0,1,0
64737,445,0,0,drop,66,66,0,1,0,1,0
52946,445,0,0,drop,70,70,0,1,0,1,0
64733,445,0,0,drop,66,66,0,1,0,1,0
64730,445,0,0,drop,66,66,0,1,0,1,0
64729,445,0,0,drop,66,66,0,1,0,1,0
64579,445,0,0,drop,70,70,0,1,0,1,0
64727,445,0,0,drop,66,66,0,1,0,1,0
52941,445,0,0,drop,70,70,0,1,0,1,0
52932,445,0,0,drop,70,70,0,1,0,1,0
52931,445,0,0,drop,70,70,0,1,0,1,0
64566,445,0,0,drop,70,70,0,1,0,1,0
64716,445,0,0,drop,66,66,0,1,0,1,0
64563,445,0,0,drop,70,70,0,1,0,1,0
64708,445,0,0,drop,66,66,0,1,0,1,0
52918,445,0,0,drop,70,70,0,1,0,1,0
64705,445,0,0,drop,66,66,0,1,0,1,0
64559,445,0,0,drop,70,70,0,1,0,1,0
64557,445,0,0,drop,70,70,0,1,0,1,0
64555,445,0,0,drop,70,70,0,1,0,1,0
64698,445,0,0,drop,66,66,0,1,0,1,0
64689,445,0,0,drop,66,66,0,1,0,1,0
56922,53,43765,53,allow,86,86,0,1,30,1,0
50367,443,43632,443,allow,1630,916,714,12,25,7,5
50366,443,19959,443,allow,1755,986,769,13,25,8,5
49627,53,55437,53,allow,760,97,663,2,30,1,1
36951,443,31916,443,allow,70,70,0,1,5,1,0
41895,443,48920,443,allow,282,60,222,5,14,2,3
51979,80,40174,80,allow,366,240,126,7,25,5,2
55991,53,53761,53,allow,182,93,89,2,30,1,1
64945,53,11913,53,allow,760,97,663,2,30,1,1
51980,80,2288,80,allow,366,240,126,7,25,5,2
57183,53,27398,53,allow,172,88,84,2,30,1,1
64432,53,46411,53,allow,168,86,82,2,30,1,1
56622,53,20942,53,allow,174,89,85,2,31,1,1
55594,53,44459,53,allow,752,93,659,2,31,1,1
50022,53,60834,53,allow,174,89,85,2,31,1,1
56258,53,50751,53,allow,772,103,669,2,30,1,1
64467,53,11977,53,allow,184,94,90,2,30,1,1
64702,53,11324,53,allow,760,97,663,2,31,1,1
64580,53,16498,53,allow,176,90,86,2,31,1,1
56125,53,8463,53,allow,168,86,82,2,31,1,1
56239,53,24103,53,allow,176,90,86,2,31,1,1
56648,53,6533,53,allow,198,101,97,2,31,1,1
57040,53,44476,53,allow,174,89,85,2,31,1,1
56153,53,6546,53,allow,742,88,654,2,31,1,1
64995,53,18804,53,allow,204,104,100,2,31,1,1
56198,53,15932,53,allow,789,110,679,2,31,1,1
64839,53,19060,53,allow,208,106,102,2,31,1,1
56143,53,31546,53,allow,748,106,642,2,31,1,1
60896,53,29321,53,allow,168,78,90,2,31,1,1
56820,53,32969,53,allow,186,95,91,2,31,1,1
55662,53,51499,53,allow,753,93,660,2,31,1,1
65412,53,28937,53,allow,782,105,677,2,31,1,1
56827,53,43714,53,allow,190,97,93,2,31,1,1
65409,53,26325,53,allow,753,93,660,2,31,1,1
65531,53,43079,53,allow,186,95,91,2,31,1,1
56792,53,2003,53,allow,782,105,677,2,31,1,1
56928,53,48986,53,allow,172,88,84,2,31,1,1
56468,53,40699,53,allow,1421,97,1324,4,55,2,2
57440,53,36326,53,allow,198,101,97,2,31,1,1
40458,53,17783,53,allow,168,78,90,2,31,1,1
64548,445,0,0,drop,70,70,0,1,0,1,0
64546,445,0,0,drop,70,70,0,1,0,1,0
52907,445,0,0,drop,70,70,0,1,0,1,0
52906,445,0,0,drop,70,70,0,1,0,1,0
64675,445,0,0,drop,66,66,0,1,0,1,0
64678,445,0,0,drop,66,66,0,1,0,1,0
64679,445,0,0,drop,66,66,0,1,0,1,0
64681,445,0,0,drop,66,66,0,1,0,1,0
64683,445,0,0,drop,66,66,0,1,0,1,0
64682,445,0,0,drop,66,66,0,1,0,1,0
64680,445,0,0,drop,66,66,0,1,0,1,0
64677,445,0,0,drop,66,66,0,1,0,1,0
64545,445,0,0,drop,70,70,0,1,0,1,0
64544,445,0,0,drop,70,70,0,1,0,1,0
64543,445,0,0,drop,70,70,0,1,0,1,0
64539,445,0,0,drop,70,70,0,1,0,1,0
64538,445,0,0,drop,70,70,0,1,0,1,0
64525,445,0,0,drop,70,70,0,1,0,1,0
64524,445,0,0,drop,70,70,0,1,0,1,0
64520,445,0,0,drop,70,70,0,1,0,1,0
52904,445,0,0,drop,70,70,0,1,0,1,0
52903,445,0,0,drop,70,70,0,1,0,1,0
52891,445,0,0,drop,70,70,0,1,0,1,0
52889,445,0,0,drop,70,70,0,1,0,1,0
64515,445,0,0,drop,70,70,0,1,0,1,0
64514,445,0,0,drop,70,70,0,1,0,1,0
64662,445,0,0,drop,66,66,0,1,0,1,0
64661,445,0,0,drop,66,66,0,1,0,1,0
64660,445,0,0,drop,66,66,0,1,0,1,0
50527,53,64659,53,allow,969,86,883,2,30,1,1
50202,53,17431,53,allow,166,86,80,2,30,1,1
55792,53,52460,53,allow,199,102,97,2,29,1,1
57183,53,22943,53,allow,178,94,84,2,29,1,1
56562,53,61427,53,allow,183,94,89,2,30,1,1
56562,53,42626,53,allow,183,94,89,2,30,1,1
41313,53,41313,53,allow,404,259,145,3,32,2,1
53904,1024,55644,1024,allow,70,70,0,1,4,1,0
55404,53,35517,53,allow,326,102,224,2,29,1,1
57419,53,24851,53,allow,326,110,216,2,29,1,1
55633,53,59677,53,allow,195,102,93,2,30,1,1
49826,53,41958,53,allow,279,95,184,4,59,2,2
57013,53,50114,53,allow,178,94,84,2,29,1,1
49808,53,25125,53,allow,268,102,166,2,29,1,1
51967,80,56439,80,allow,426,240,186,8,25,5,3
51975,80,44833,80,allow,426,240,186,8,25,5,3
57440,53,5992,53,allow,199,102,97,2,30,1,1
55900,53,13889,53,allow,194,102,92,2,30,1,1
56835,53,43767,53,allow,213,102,111,2,30,1,1
58392,53,58392,53,allow,404,259,145,3,33,2,1
51962,80,39391,80,allow,422,240,182,8,25,5,3
56225,53,43887,53,allow,183,94,89,2,30,1,1
49773,53,20298,53,allow,994,86,908,2,30,1,1
51968,80,1754,80,allow,366,240,126,7,25,5,2
56827,53,56181,53,allow,195,102,93,2,30,1,1
51976,80,64058,80,allow,366,240,126,7,25,5,2
55991,53,41227,53,allow,183,94,89,2,30,1,1
64904,53,1451,53,allow,211,102,109,2,30,1,1
50202,53,23143,53,allow,166,86,80,2,30,1,1
65059,53,35510,53,allow,168,86,82,2,30,1,1
48856,53,0,0,allow,86,86,0,1,30,1,0
40403,53,40667,53,allow,199,94,105,2,30,1,1
57002,53,39237,53,allow,211,94,117,2,30,1,1
50109,53,42164,53,allow,198,110,88,2,30,1,1
56125,53,57582,53,allow,168,86,82,2,30,1,1
64432,53,45713,53,allow,168,86,82,2,30,1,1
56356,53,61835,53,allow,184,102,82,2,30,1,1
50337,53,50337,53,allow,260,106,154,2,30,1,1
56683,443,65170,443,allow,268,120,148,5,11,3,2
51969,80,59733,80,allow,366,240,126,7,25,5,2
51974,80,51357,80,allow,426,240,186,8,25,5,3
51977,80,40997,80,allow,366,240,126,7,25,5,2
64030,53,64891,53,allow,222,78,144,2,30,1,1
56622,53,24570,53,allow,179,94,85,2,30,1,1
49296,53,40688,53,allow,322,98,224,4,32,2,2
42342,443,63705,443,allow,494,198,296,8,17,4,4
51970,80,32175,80,allow,366,240,126,7,25,5,2
51964,80,61928,80,allow,306,120,186,6,25,3,3
65109,53,18311,53,allow,753,94,659,2,30,1,1
48209,53,48209,53,allow,628,82,546,2,30,1,1
51985,80,32955,80,allow,1479,822,657,11,25,7,4
37627,443,10583,443,allow,70,70,0,2,5,2,0
50380,443,13367,443,allow,306,180,126,6,25,4,2
50336,80,50336,80,allow,2143,676,1467,12,25,7,5
51993,80,56681,80,allow,482,300,182,9,25,6,3
51991,80,57002,80,allow,482,300,182,9,25,6,3
64615,53,56632,53,allow,395,89,306,4,32,2,2
56562,53,4746,53,allow,183,94,89,2,29,1,1
56217,53,16338,53,allow,183,94,89,2,29,1,1
56004,443,46384,443,allow,130,70,60,3,4,2,1
55404,443,49426,443,allow,70,70,0,1,5,1,0
64432,53,49029,53,allow,168,86,82,2,30,1,1
65287,53,49493,53,allow,180,94,86,2,30,1,1
56217,53,53375,53,allow,183,94,89,2,30,1,1
50022,53,3051,53,allow,179,94,85,2,30,1,1
44846,53,44846,53,allow,86,86,0,1,30,1,0
49631,53,24676,53,allow,184,102,82,2,30,1,1
56333,53,59595,53,allow,209,110,99,2,31,1,1
49334,53,34104,53,allow,194,102,92,2,30,1,1
64958,53,14759,53,allow,197,102,95,2,30,1,1
56733,53,5625,53,allow,183,94,89,2,30,1,1
64995,53,14595,53,allow,210,110,100,2,30,1,1
65240,53,39958,53,allow,199,94,105,2,30,1,1
64580,53,3526,53,allow,180,94,86,2,30,1,1
57440,53,58703,53,allow,199,102,97,2,30,1,1
59833,53,25424,53,allow,195,94,101,2,30,1,1
56922,53,63628,53,allow,168,86,82,2,31,1,1
51963,80,35774,80,allow,422,240,182,8,25,5,3
56837,53,1718,53,allow,227,110,117,2,30,1,1
64340,53,7157,53,allow,266,110,156,2,30,1,1
65136,53,36348,53,allow,438,180,258,6,30,3,3
56648,53,49574,53,allow,199,102,97,2,30,1,1
56622,53,6660,53,allow,340,107,233,4,30,2,2
56572,53,50763,53,allow,438,180,258,6,30,3,3
61948,53,63047,53,allow,205,86,119,2,30,1,1
51965,80,11220,80,allow,306,120,186,6,25,3,3
55290,53,19726,53,allow,198,94,104,2,30,1,1
49818,53,62354,53,allow,751,94,657,2,30,1,1
55570,53,7060,53,allow,889,404,485,10,30,5,5
55995,53,56863,53,allow,182,94,88,2,30,1,1
49815,53,3379,53,allow,789,110,679,2,31,1,1
51966,80,49895,80,allow,366,240,126,7,25,5,2
64946,53,5511,53,allow,452,118,334,2,30,1,1
64580,53,18330,53,allow,180,94,86,2,30,1,1
49561,53,14887,53,allow,211,94,117,2,30,1,1
49381,53,1330,53,allow,209,110,99,2,30,1,1
49295,53,60068,53,allow,172,94,78,2,30,1,1
56356,53,24415,53,allow,184,102,82,2,30,1,1
57440,53,28373,53,allow,199,102,97,2,30,1,1
49257,53,41185,53,allow,166,86,80,2,30,1,1
49492,53,44432,53,allow,199,102,97,2,30,1,1
44846,53,44846,53,allow,653,349,304,5,30,3,2
65107,53,32581,53,allow,266,110,156,2,30,1,1
50250,53,63565,53,allow,178,94,84,2,31,1,1
57040,53,36140,53,allow,179,94,85,2,31,1,1
49532,53,28306,53,allow,730,102,628,2,31,1,1
49538,53,45151,53,allow,748,94,654,2,30,1,1
55900,53,53468,53,allow,194,102,92,2,30,1,1
49889,53,48150,53,allow,197,102,95,2,31,1,1
56239,53,30874,53,allow,180,94,86,2,31,1,1
50523,53,7142,53,allow,168,86,82,2,31,1,1
64422,53,12114,53,allow,180,94,86,2,31,1,1
60191,53,31189,53,allow,196,94,102,2,31,1,1
49492,53,34957,53,allow,199,102,97,2,31,1,1
57204,53,62909,53,allow,195,102,93,2,31,1,1
64116,53,6578,53,allow,267,94,173,4,59,2,2
49631,53,37899,53,allow,184,102,82,2,30,1,1
64229,53,36573,53,allow,266,110,156,2,31,1,1
55555,53,4576,53,allow,194,102,92,2,31,1,1
36628,80,65040,80,allow,78,78,0,1,5,1,0
64580,53,58707,53,allow,425,90,335,4,43,2,2
65280,53,19530,53,allow,166,86,80,2,31,1,1
52886,445,0,0,drop,70,70,0,1,0,1,0
52885,445,0,0,drop,70,70,0,1,0,1,0
52881,445,0,0,drop,70,70,0,1,0,1,0
52876,445,0,0,drop,70,70,0,1,0,1,0
64503,445,0,0,drop,70,70,0,1,0,1,0
64499,445,0,0,drop,70,70,0,1,0,1,0
52869,445,0,0,drop,70,70,0,1,0,1,0
52867,445,0,0,drop,70,70,0,1,0,1,0
52866,445,0,0,drop,70,70,0,1,0,1,0
64490,445,0,0,drop,70,70,0,1,0,1,0
64489,445,0,0,drop,70,70,0,1,0,1,0
64487,445,0,0,drop,70,70,0,1,0,1,0
64651,445,0,0,drop,66,66,0,1,0,1,0
64486,445,0,0,drop,70,70,0,1,0,1,0
64483,445,0,0,drop,70,70,0,1,0,1,0
52861,445,0,0,drop,70,70,0,1,0,1,0
52859,445,0,0,drop,70,70,0,1,0,1,0
64476,445,0,0,drop,70,70,0,1,0,1,0
64632,445,0,0,drop,66,66,0,1,0,1,0
64633,445,0,0,drop,66,66,0,1,0,1,0
64469,445,0,0,drop,70,70,0,1,0,1,0
52851,445,0,0,drop,70,70,0,1,0,1,0
52849,445,0,0,drop,70,70,0,1,0,1,0
52850,445,0,0,drop,70,70,0,1,0,1,0
52841,445,0,0,drop,70,70,0,1,0,1,0
64468,445,0,0,drop,70,70,0,1,0,1,0
64629,445,0,0,drop,66,66,0,1,0,1,0
64462,445,0,0,drop,70,70,0,1,0,1,0
64624,445,0,0,drop,66,66,0,1,0,1,0
64622,445,0,0,drop,66,66,0,1,0,1,0
64623,445,0,0,drop,66,66,0,1,0,1,0
64618,445,0,0,drop,66,66,0,1,0,1,0
64617,445,0,0,drop,66,66,0,1,0,1,0
64614,445,0,0,drop,66,66,0,1,0,1,0
64612,445,0,0,drop,66,66,0,1,0,1,0
64461,445,0,0,drop,70,70,0,1,0,1,0
52834,445,0,0,drop,70,70,0,1,0,1,0
52831,445,0,0,drop,70,70,0,1,0,1,0
52830,445,0,0,drop,70,70,0,1,0,1,0
52827,445,0,0,drop,70,70,0,1,0,1,0
64457,445,0,0,drop,70,70,0,1,0,1,0
64455,445,0,0,drop,70,70,0,1,0,1,0
52823,445,0,0,drop,70,70,0,1,0,1,0
52822,445,0,0,drop,70,70,0,1,0,1,0
52821,445,0,0,drop,70,70,0,1,0,1,0
64605,445,0,0,drop,66,66,0,1,0,1,0
52818,445,0,0,drop,70,70,0,1,0,1,0
64451,445,0,0,deny,70,70,0,1,0,1,0
64603,445,0,0,drop,66,66,0,1,0,1,0
64601,445,0,0,drop,66,66,0,1,0,1,0
64602,445,0,0,drop,66,66,0,1,0,1,0
64599,445,0,0,drop,66,66,0,1,0,1,0
40108,23,0,0,deny,60,60,0,1,0,1,0
52813,445,0,0,drop,70,70,0,1,0,1,0
52806,445,0,0,drop,70,70,0,1,0,1,0
52804,445,0,0,drop,70,70,0,1,0,1,0
49834,23,0,0,deny,60,60,0,1,0,1,0
64438,445,0,0,drop,70,70,0,1,0,1,0
64586,445,0,0,drop,66,66,0,1,0,1,0
64435,445,0,0,drop,70,70,0,1,0,1,0
64579,445,0,0,drop,66,66,0,1,0,1,0
56770,53,63283,53,allow,208,106,102,2,30,1,1
38468,53,0,0,allow,82,82,0,2,40,2,0
49889,53,17299,53,allow,194,99,95,2,30,1,1
55216,53,63091,53,allow,174,89,85,2,30,1,1
65280,53,4153,53,allow,164,84,80,2,31,1,1
49492,53,11177,53,allow,198,101,97,2,31,1,1
55955,53,2221,53,allow,814,110,704,2,30,1,1
58931,443,42670,443,allow,1413,876,537,12,28,6,6
58932,443,14070,443,allow,1413,876,537,12,28,6,6
41734,443,42617,443,allow,153,93,60,2,5,1,1
52141,1033,19443,1033,allow,316,136,180,6,7,3,3
36953,443,22801,443,allow,70,70,0,1,5,1,0
57422,53,50721,53,allow,747,90,657,2,30,1,1
51899,80,55362,80,allow,1758,989,769,13,76,8,5
56678,53,61385,53,allow,760,97,663,2,30,1,1
49815,53,0,0,allow,166,73,93,2,30,1,1
56064,53,20414,53,allow,710,89,621,2,30,1,1
56333,53,63639,53,allow,202,103,99,2,31,1,1
50116,22,50116,22,allow,184,120,64,4,10,3,1
49683,80,8217,80,allow,1548,847,701,10,15,5,5
49791,53,6212,53,allow,777,87,690,2,30,1,1
44925,443,50958,443,allow,153,93,60,2,5,1,1
49257,53,65016,53,allow,164,84,80,2,30,1,1
50250,53,19188,53,allow,172,88,84,2,30,1,1
56770,443,57005,443,allow,124,64,60,2,16,1,1
64422,53,42337,53,allow,176,90,86,2,30,1,1
55687,53,59046,53,allow,186,95,91,2,31,1,1
64937,53,42639,53,allow,204,104,100,2,31,1,1
55418,53,39604,53,allow,168,86,82,2,31,1,1
57204,53,25182,53,allow,190,97,93,2,30,1,1
64116,53,5820,53,allow,184,94,90,2,31,1,1
65466,53,3496,53,allow,733,86,647,2,31,1,1
50403,53,23748,53,allow,168,86,82,2,31,1,1
56955,53,57810,53,allow,182,93,89,2,31,1,1
65186,53,43195,53,allow,733,85,648,2,31,1,1
55352,53,6913,53,allow,216,110,106,2,31,1,1
55332,53,16316,53,allow,206,105,101,2,31,1,1
56314,53,18925,53,allow,733,86,647,2,31,1,1
49972,53,57217,53,allow,216,110,106,2,31,1,1
55555,53,39560,53,allow,188,96,92,2,31,1,1
49296,53,29013,53,allow,186,95,91,2,31,1,1
55022,53,10600,53,allow,190,97,93,2,31,1,1
57407,53,20489,53,allow,755,94,661,2,31,1,1
55707,53,37897,53,allow,170,87,83,2,31,1,1
56422,53,35743,53,allow,190,97,93,2,31,1,1
49546,53,57576,53,allow,208,106,102,2,31,1,1
64299,53,27762,53,allow,164,84,80,2,31,1,1
49210,53,34070,53,allow,182,93,89,2,31,1,1
64856,53,10911,53,allow,755,93,662,2,31,1,1
55007,53,10621,53,allow,164,84,80,2,31,1,1
56036,53,20624,53,allow,762,98,664,2,31,1,1
49982,53,52781,53,allow,206,105,101,2,31,1,1
64615,53,39093,53,allow,190,97,93,2,31,1,1
65065,53,49362,53,allow,754,94,660,2,31,1,1
56312,53,11008,53,allow,190,97,93,2,31,1,1
52790,445,0,0,drop,70,70,0,1,0,1,0
64430,445,0,0,drop,70,70,0,1,0,1,0
64429,445,0,0,drop,70,70,0,1,0,1,0
64576,445,0,0,drop,66,66,0,1,0,1,0
51046,53,51046,53,allow,244,106,138,2,30,1,1
59052,53,59052,53,allow,235,90,145,2,32,1,1
64878,53,35842,53,allow,511,92,419,4,45,2,2
49237,53,49518,53,allow,216,110,106,2,30,1,1
55808,53,53764,53,allow,730,102,628,2,30,1,1
60666,123,38509,123,allow,184,94,90,2,30,1,1
50356,80,58294,80,allow,1578,756,822,13,34,7,6
55995,53,15590,53,allow,182,94,88,2,29,1,1
64422,53,60156,53,allow,180,94,86,2,29,1,1
55187,53,45900,53,allow,172,94,78,2,29,1,1
58273,53,40385,53,allow,202,86,116,2,30,1,1
64741,53,9431,53,allow,715,94,621,2,29,1,1
49295,53,61148,53,allow,164,86,78,2,29,1,1
49257,53,51275,53,allow,166,86,80,2,29,1,1
57204,53,62842,53,allow,195,102,93,2,29,1,1
55187,53,40713,53,allow,172,94,78,2,30,1,1
50523,53,12561,53,allow,168,86,82,2,29,1,1
61422,80,46677,80,allow,214,140,74,4,41,3,1
64633,53,20577,53,allow,255,102,153,2,30,1,1
49417,53,32052,53,allow,211,110,101,2,30,1,1
57033,53,53118,53,allow,216,110,106,2,30,1,1
57129,53,59540,53,allow,265,94,171,2,30,1,1
56928,53,10586,53,allow,178,94,84,2,30,1,1
55332,53,34862,53,allow,211,110,101,2,30,1,1
50025,53,41046,53,allow,369,150,219,2,30,1,1
57312,53,15531,53,allow,212,110,102,2,30,1,1
61430,80,6930,80,allow,214,140,74,4,41,3,1
61423,80,2681,80,allow,214,140,74,4,41,3,1
52248,443,56929,443,allow,190,70,120,4,15,2,2
56950,53,63422,53,allow,211,102,109,2,30,1,1
57425,53,41826,53,allow,168,86,82,2,30,1,1
49237,53,48024,53,allow,216,110,106,2,30,1,1
44871,53,32671,53,allow,168,78,90,2,30,1,1
64228,53,55912,53,allow,266,110,156,2,30,1,1
49305,53,20734,53,allow,571,181,390,6,73,3,3
55216,53,56986,53,allow,179,94,85,2,30,1,1
49592,53,33191,53,allow,177,94,83,2,30,1,1
65171,53,41753,53,allow,752,110,642,2,30,1,1
49624,53,59918,53,allow,293,126,167,2,30,1,1
49261,53,20112,53,allow,453,186,267,6,30,3,3
56239,53,14198,53,allow,180,94,86,2,30,1,1
56955,53,15071,53,allow,183,94,89,2,30,1,1
57425,53,32563,53,allow,168,86,82,2,30,1,1
56929,53,55156,53,allow,784,94,690,2,30,1,1
55352,53,47404,53,allow,216,110,106,2,30,1,1
56333,53,40833,53,allow,209,110,99,2,30,1,1
57022,53,55045,53,allow,369,150,219,2,30,1,1
49615,53,23958,53,allow,199,102,97,2,30,1,1
39827,53,39827,53,allow,247,98,149,2,33,1,1
61427,80,27068,80,allow,214,140,74,4,41,3,1
61425,80,54723,80,allow,214,140,74,4,41,3,1
61424,80,26157,80,allow,214,140,74,4,41,3,1
50319,53,7677,53,allow,814,110,704,2,30,1,1
49408,53,3483,53,allow,252,102,150,2,30,1,1
49417,53,14090,53,allow,211,110,101,2,30,1,1
56770,53,41386,53,allow,212,110,102,2,30,1,1
56827,53,18397,53,allow,195,102,93,2,30,1,1
58394,53,41554,53,allow,274,94,180,2,30,1,1
64839,53,42360,53,allow,212,110,102,2,30,1,1
55216,53,52646,53,allow,179,94,85,2,30,1,1
55923,53,7980,53,allow,177,94,83,2,30,1,1
55923,53,53051,53,allow,177,94,83,2,30,1,1
64243,53,38194,53,allow,257,102,155,2,30,1,1
56125,53,3352,53,allow,168,86,82,2,30,1,1
64737,53,22713,53,allow,285,94,191,2,31,1,1
52105,1024,64532,1024,allow,70,70,0,1,4,1,0
56632,53,56632,53,allow,235,90,145,2,33,1,1
64467,53,41082,53,allow,548,194,354,6,63,3,3
64422,53,39408,53,allow,180,94,86,2,31,1,1
61426,80,34225,80,allow,214,140,74,4,41,3,1
61429,80,5078,80,allow,214,140,74,4,41,3,1
49969,53,54536,53,allow,356,105,251,4,49,2,2
56125,53,44434,53,allow,168,86,82,2,29,1,1
49889,53,36232,53,allow,197,102,95,2,29,1,1
52137,1026,43020,1026,allow,196,136,60,4,8,3,1
56827,53,30639,53,allow,195,102,93,2,29,1,1
58177,443,64098,443,allow,810,340,470,13,34,6,7
55057,53,53863,53,allow,211,110,101,2,30,1,1
59402,53,5852,53,allow,203,86,117,2,30,1,1
55372,53,41205,53,allow,271,93,178,4,43,2,2
64995,53,32224,53,allow,210,110,100,2,30,1,1
61428,80,48945,80,allow,214,140,74,4,41,3,1
64937,53,47101,53,allow,210,110,100,2,30,1,1
56360,53,26019,53,allow,184,102,82,2,30,1,1
50027,53,20964,53,allow,264,110,154,2,30,1,1
57033,53,22099,53,allow,216,110,106,2,30,1,1
37492,53,45298,53,allow,199,94,105,2,30,1,1
55739,53,43741,53,allow,215,102,113,2,30,1,1
55057,53,26203,53,allow,211,110,101,2,30,1,1
56648,53,44024,53,allow,199,102,97,2,30,1,1
49615,53,57263,53,allow,199,102,97,2,30,1,1
64324,53,8144,53,allow,179,94,85,2,30,1,1
56955,53,64522,53,allow,183,94,89,2,30,1,1
55352,53,35227,53,allow,216,110,106,2,30,1,1
55991,53,9133,53,allow,199,102,97,2,30,1,1
49176,53,17276,53,allow,264,110,154,2,30,1,1
55352,53,46162,53,allow,216,110,106,2,30,1,1
55216,53,32573,53,allow,179,94,85,2,30,1,1
55022,53,7516,53,allow,195,102,93,2,30,1,1
55837,53,32132,53,allow,195,102,93,2,30,1,1
55991,53,22499,53,allow,199,102,97,2,30,1,1
61421,80,3203,80,allow,214,140,74,4,41,3,1
49592,53,47137,53,allow,177,94,83,2,30,1,1
49333,53,61415,53,allow,392,102,290,2,30,1,1
64191,53,17402,53,allow,264,110,154,2,30,1,1
55687,53,38089,53,allow,193,102,91,2,30,1,1
49615,53,49539,53,allow,199,102,97,2,30,1,1
55555,53,24469,53,allow,194,102,92,2,30,1,1
64026,80,47805,80,allow,314,192,122,6,15,4,2
64942,53,56338,53,allow,803,390,413,9,71,5,4
61431,80,8546,80,allow,214,140,74,4,41,3,1
64116,53,45149,53,allow,267,94,173,4,59,2,2
65531,53,44923,53,allow,193,102,91,2,30,1,1
56820,53,40391,53,allow,193,102,91,2,30,1,1
56360,53,60818,53,allow,184,102,82,2,30,1,1
40290,53,7159,53,allow,168,78,90,2,30,1,1
64731,53,48863,53,allow,779,86,693,2,30,1,1
49739,53,37326,53,allow,757,102,655,2,30,1,1
56113,53,45666,53,allow,211,102,109,2,30,1,1
50007,53,39028,53,allow,216,110,106,2,30,1,1
56239,53,49542,53,allow,180,94,86,2,30,1,1
50007,53,43367,53,allow,216,110,106,2,30,1,1
64251,53,54906,53,allow,451,118,333,2,30,1,1
52661,53,0,0,allow,86,86,0,1,30,1,0
65416,53,16237,53,allow,213,102,111,2,30,1,1
50007,53,59429,53,allow,216,110,106,2,30,1,1
63638,53,10182,53,allow,286,78,208,2,30,1,1
56362,53,52775,53,allow,453,186,267,6,30,3,3
55332,53,52188,53,allow,211,110,101,2,30,1,1
56312,53,62526,53,allow,195,102,93,2,30,1,1
55610,53,39164,53,allow,199,102,97,2,30,1,1
56596,53,50700,53,allow,199,102,97,2,30,1,1
57204,53,65520,53,allow,195,102,93,2,30,1,1
55332,53,45716,53,allow,211,110,101,2,30,1,1
55638,53,1033,53,allow,78,78,0,1,30,1,0
49402,53,15984,53,allow,185,102,83,2,31,1,1
56312,53,52964,53,allow,195,102,93,2,31,1,1
49492,53,41002,53,allow,199,102,97,2,31,1,1
55707,53,31512,53,allow,177,94,83,2,30,1,1
65143,53,8081,53,allow,199,102,97,2,30,1,1
62524,53,62524,53,allow,212,90,122,2,30,1,1
49972,53,10685,53,allow,216,110,106,2,31,1,1
64116,53,50037,53,allow,184,94,90,2,31,1,1
55620,53,6956,53,allow,178,94,84,2,31,1,1
63993,53,47498,53,allow,338,110,228,2,31,1,1
49841,53,34208,53,allow,264,110,154,2,31,1,1
57312,53,30289,53,allow,212,110,102,2,31,1,1
56422,53,25062,53,allow,195,102,93,2,31,1,1
57132,53,52410,53,allow,216,110,106,2,31,1,1
64929,53,16910,53,allow,168,86,82,2,31,1,1
49296,53,53194,53,allow,193,102,91,2,31,1,1
64615,53,57777,53,allow,195,102,93,2,31,1,1
50684,80,2387,80,allow,132,132,0,2,8,2,0
49889,53,3966,53,allow,310,99,211,4,40,2,2
55372,53,7749,53,allow,271,93,178,4,43,2,2
56910,53,59135,53,allow,211,78,133,2,30,1,1
64427,445,0,0,drop,70,70,0,1,0,1,0
64568,445,0,0,drop,66,66,0,1,0,1,0
64567,445,0,0,drop,66,66,0,1,0,1,0
64418,445,0,0,drop,70,70,0,1,0,1,0
64416,445,0,0,drop,70,70,0,1,0,1,0
52782,445,0,0,drop,70,70,0,1,0,1,0
52778,445,0,0,drop,70,70,0,1,0,1,0
52779,445,0,0,drop,70,70,0,1,0,1,0
64415,445,0,0,drop,70,70,0,1,0,1,0
64553,445,0,0,drop,66,66,0,1,0,1,0
64552,445,0,0,drop,66,66,0,1,0,1,0
64548,445,0,0,drop,66,66,0,1,0,1,0
64554,445,0,0,drop,66,66,0,1,0,1,0
64551,445,0,0,drop,66,66,0,1,0,1,0
64549,445,0,0,drop,66,66,0,1,0,1,0
64547,445,0,0,drop,66,66,0,1,0,1,0
64550,445,0,0,drop,66,66,0,1,0,1,0
64414,445,0,0,drop,70,70,0,1,0,1,0
64413,445,0,0,drop,70,70,0,1,0,1,0
64407,445,0,0,drop,70,70,0,1,0,1,0
64410,445,0,0,drop,70,70,0,1,0,1,0
44886,23,0,0,deny,60,60,0,1,0,1,0
64395,445,0,0,drop,70,70,0,1,0,1,0
64394,445,0,0,drop,70,70,0,1,0,1,0
64389,445,0,0,drop,70,70,0,1,0,1,0
64385,445,0,0,drop,70,70,0,1,0,1,0
64384,445,0,0,drop,70,70,0,1,0,1,0
52772,445,0,0,drop,70,70,0,1,0,1,0
52770,445,0,0,drop,70,70,0,1,0,1,0
52768,445,0,0,drop,70,70,0,1,0,1,0
52762,445,0,0,drop,70,70,0,1,0,1,0
64531,445,0,0,drop,66,66,0,1,0,1,0
64532,445,0,0,drop,66,66,0,1,0,1,0
64534,445,0,0,drop,66,66,0,1,0,1,0
52759,445,0,0,drop,70,70,0,1,0,1,0
64373,445,0,0,drop,70,70,0,1,0,1,0
52750,445,0,0,drop,70,70,0,1,0,1,0
52749,445,0,0,drop,70,70,0,1,0,1,0
52748,445,0,0,drop,70,70,0,1,0,1,0
49630,22,49630,22,deny,295,126,169,4,1,2,2
64369,445,0,0,drop,70,70,0,1,0,1,0
64358,445,0,0,drop,70,70,0,1,0,1,0
64359,445,0,0,drop,70,70,0,1,0,1,0
52739,445,0,0,drop,70,70,0,1,0,1,0
64360,445,0,0,drop,70,70,0,1,0,1,0
52740,445,0,0,drop,70,70,0,1,0,1,0
52734,445,0,0,drop,70,70,0,1,0,1,0
64356,445,0,0,drop,70,70,0,1,0,1,0
64353,445,0,0,drop,70,70,0,1,0,1,0
64519,445,0,0,drop,66,66,0,1,0,1,0
52733,445,0,0,drop,70,70,0,1,0,1,0
52731,445,0,0,drop,70,70,0,1,0,1,0
64346,445,0,0,drop,70,70,0,1,0,1,0
64505,445,0,0,drop,66,66,0,1,0,1,0
64507,445,0,0,drop,66,66,0,1,0,1,0
64339,445,0,0,drop,70,70,0,1,0,1,0
64336,445,0,0,drop,70,70,0,1,0,1,0
52720,445,0,0,drop,70,70,0,1,0,1,0
52719,445,0,0,drop,70,70,0,1,0,1,0
52718,445,0,0,drop,70,70,0,1,0,1,0
52711,445,0,0,drop,70,70,0,1,0,1,0
64498,445,0,0,drop,66,66,0,1,0,1,0
64333,445,0,0,drop,70,70,0,1,0,1,0
64331,445,0,0,drop,70,70,0,1,0,1,0
64494,445,0,0,drop,66,66,0,1,0,1,0
64493,445,0,0,drop,66,66,0,1,0,1,0
64492,445,0,0,drop,66,66,0,1,0,1,0
64491,445,0,0,drop,66,66,0,1,0,1,0
64488,445,0,0,drop,66,66,0,1,0,1,0
64486,445,0,0,drop,66,66,0,1,0,1,0
64483,445,0,0,drop,66,66,0,1,0,1,0
52706,445,0,0,drop,70,70,0,1,0,1,0
64327,445,0,0,drop,70,70,0,1,0,1,0
52703,445,0,0,drop,70,70,0,1,0,1,0
52701,445,0,0,drop,70,70,0,1,0,1,0
52699,445,0,0,drop,70,70,0,1,0,1,0
64326,445,0,0,drop,70,70,0,1,0,1,0
64321,445,0,0,drop,70,70,0,1,0,1,0
52696,445,0,0,drop,70,70,0,1,0,1,0
52695,445,0,0,drop,70,70,0,1,0,1,0
52691,445,0,0,drop,70,70,0,1,0,1,0
64476,445,0,0,drop,66,66,0,1,0,1,0
52690,445,0,0,drop,70,70,0,1,0,1,0
64474,445,0,0,drop,66,66,0,1,0,1,0
64472,445,0,0,drop,66,66,0,1,0,1,0
64470,445,0,0,drop,66,66,0,1,0,1,0
43076,23,0,0,deny,60,60,0,1,0,1,0
64469,445,0,0,drop,66,66,0,1,0,1,0
36551,23,0,0,deny,60,60,0,1,0,1,0
56496,53,60823,53,allow,186,95,91,2,30,1,1
56596,53,26887,53,allow,198,101,97,2,30,1,1
57312,53,16678,53,allow,1385,85,1300,4,42,2,2
56062,53,16578,53,allow,744,89,655,2,31,1,1
55963,53,27489,53,allow,755,93,662,2,30,1,1
53915,1026,52746,1026,allow,70,70,0,2,8,2,0
65140,53,64543,53,allow,198,101,97,2,30,1,1
57794,53,57794,53,allow,825,99,726,2,30,1,1
46216,443,9972,443,allow,161,101,60,2,5,1,1
50421,53,19651,53,allow,762,98,664,2,30,1,1
64324,53,12173,53,allow,174,89,85,2,30,1,1
55563,53,57917,53,allow,763,101,662,2,30,1,1
57132,53,28118,53,allow,216,110,106,2,31,1,1
55841,53,55031,53,allow,265,86,179,4,59,2,2
54872,53,11458,53,allow,578,286,292,9,15,5,4
55372,53,64639,53,allow,271,93,178,4,43,2,2
57312,53,43620,53,allow,208,106,102,2,30,1,1
52775,123,25733,123,allow,184,94,90,2,30,1,1
65045,53,47072,53,allow,755,94,661,2,30,1,1
65481,53,28484,53,allow,168,86,82,2,31,1,1
55941,53,18127,53,allow,184,94,90,2,30,1,1
50293,53,25447,53,allow,740,93,647,2,31,1,1
56028,53,49252,53,allow,770,102,668,2,31,1,1
64929,53,46254,53,allow,168,86,82,2,31,1,1
56586,53,7577,53,allow,754,94,660,2,31,1,1
49953,53,38496,53,allow,757,98,659,2,31,1,1
56293,53,53120,53,allow,164,84,80,2,31,1,1
56697,53,7977,53,allow,711,87,624,2,31,1,1
56437,53,21787,53,allow,731,91,640,2,31,1,1
56199,53,15227,53,allow,256,93,163,2,31,1,1
56965,53,30276,53,allow,182,93,89,2,31,1,1
55376,53,64673,53,allow,198,101,97,2,31,1,1
64403,53,35591,53,allow,186,95,91,2,31,1,1
49611,53,60181,53,allow,170,87,83,2,31,1,1
57969,53,57969,53,allow,194,87,107,2,31,1,1
49699,53,23875,53,allow,202,103,99,2,31,1,1
43394,53,50886,53,allow,168,78,90,2,31,1,1
56696,53,25639,53,allow,757,98,659,2,31,1,1
57450,53,43406,53,allow,916,86,830,2,31,1,1
56207,53,7940,53,allow,761,100,661,2,31,1,1
64543,53,58923,53,allow,761,100,661,2,31,1,1
49764,53,33834,53,allow,198,101,97,2,31,1,1
55620,53,33396,53,allow,172,88,84,2,31,1,1
56054,53,43314,53,allow,740,93,647,2,31,1,1
50444,53,27303,53,allow,256,93,163,2,31,1,1
65447,53,45832,53,allow,756,95,661,2,31,1,1
56447,53,59083,53,allow,758,96,662,2,31,1,1
57007,53,30076,53,allow,182,93,89,2,31,1,1
64950,53,22680,53,allow,182,93,89,2,31,1,1
57352,53,8029,53,allow,192,98,94,2,31,1,1
64677,53,37767,53,allow,182,93,89,2,31,1,1
52685,445,0,0,drop,70,70,0,1,0,1,0
64308,445,0,0,drop,70,70,0,1,0,1,0
52680,445,0,0,drop,70,70,0,1,0,1,0
52679,445,0,0,drop,70,70,0,1,0,1,0
64305,445,0,0,drop,70,70,0,1,0,1,0
64457,445,0,0,drop,66,66,0,1,0,1,0
64450,445,0,0,drop,66,66,0,1,0,1,0
64300,445,0,0,drop,70,70,0,1,0,1,0
52662,445,0,0,drop,70,70,0,1,0,1,0
64299,445,0,0,drop,70,70,0,1,0,1,0
64297,445,0,0,drop,70,70,0,1,0,1,0
64448,445,0,0,drop,66,66,0,1,0,1,0
49546,53,5497,53,allow,212,110,102,2,30,1,1
56293,53,25636,53,allow,166,86,80,2,30,1,1
49738,53,39292,53,allow,228,86,142,2,29,1,1
50069,53,45809,53,allow,764,102,662,2,29,1,1
49611,53,44019,53,allow,177,94,83,2,30,1,1
65471,53,5865,53,allow,441,90,351,4,48,2,2
55372,53,13857,53,allow,271,93,178,4,42,2,2
53275,443,20326,443,allow,364,142,222,6,10,3,3
57396,443,32290,443,allow,152,78,74,2,4,1,1
63974,53,39548,53,allow,212,102,110,2,29,1,1
57312,53,15136,53,allow,212,110,102,2,29,1,1
65143,53,22648,53,allow,822,102,720,2,29,1,1
49972,53,25100,53,allow,328,110,218,4,57,2,2
55514,53,45295,53,allow,779,86,693,2,29,1,1
57235,53,60743,53,allow,757,102,655,2,29,1,1
65140,53,46396,53,allow,199,102,97,2,29,1,1
55007,53,23960,53,allow,166,86,80,2,29,1,1
55991,53,2664,53,allow,199,102,97,2,30,1,1
49982,53,16411,53,allow,211,110,101,2,30,1,1
55610,53,5256,53,allow,822,102,720,2,29,1,1
56909,53,4449,53,allow,260,86,174,2,30,1,1
56333,53,31573,53,allow,209,110,99,2,30,1,1
49210,53,10205,53,allow,183,94,89,2,30,1,1
55707,53,50329,53,allow,177,94,83,2,29,1,1
55469,53,31769,53,allow,193,102,91,2,30,1,1
64314,53,48605,53,allow,264,110,154,2,30,1,1
55941,53,54126,53,allow,184,94,90,2,30,1,1
49385,53,7961,53,allow,214,102,112,2,30,1,1
55599,53,58938,53,allow,258,118,140,2,30,1,1
50096,53,56974,53,allow,733,94,639,2,30,1,1
55555,53,26797,53,allow,194,102,92,2,30,1,1
55707,53,50594,53,allow,177,94,83,2,30,1,1
56550,123,27975,123,allow,184,94,90,2,30,1,1
64793,53,53457,53,allow,184,94,90,2,30,1,1
65009,53,23695,53,allow,152,78,74,2,30,1,1
55469,53,3156,53,allow,193,102,91,2,30,1,1
49982,53,19488,53,allow,211,110,101,2,30,1,1
64908,53,55022,53,allow,232,94,138,2,30,1,1
56551,53,16307,53,allow,458,188,270,6,30,3,3
49210,53,44765,53,allow,183,94,89,2,30,1,1
56757,53,22580,53,allow,322,118,204,2,30,1,1
49874,53,37266,53,allow,173,94,79,2,30,1,1
49699,53,53158,53,allow,209,110,99,2,30,1,1
55376,53,17349,53,allow,199,102,97,2,30,1,1
49767,53,45579,53,allow,341,102,239,4,37,2,2
50403,53,33399,53,allow,168,86,82,2,30,1,1
56422,53,30231,53,allow,195,102,93,2,30,1,1
59962,53,13839,53,allow,316,94,222,2,30,1,1
65498,53,49564,53,allow,749,94,655,2,30,1,1
55941,53,34210,53,allow,184,94,90,2,30,1,1
39345,80,26537,80,allow,918,461,457,9,16,6,3
49402,53,17640,53,allow,177,94,83,2,30,1,1
55620,53,62411,53,allow,178,94,84,2,30,1,1
56496,53,41605,53,allow,193,102,91,2,30,1,1
56955,53,35942,53,allow,183,94,89,2,30,1,1
56652,53,11062,53,allow,177,94,83,2,30,1,1
65277,53,40483,53,allow,167,86,81,2,30,1,1
65102,53,35796,53,allow,183,94,89,2,30,1,1
55841,53,44587,53,allow,265,86,179,4,58,2,2
49546,53,2512,53,allow,357,106,251,4,36,2,2
64049,1029,38472,1029,allow,66,66,0,2,7,2,0
64299,53,26079,53,allow,268,84,184,4,42,2,2
57511,123,47594,123,allow,184,94,90,2,29,1,1
55687,53,45230,53,allow,193,102,91,2,29,1,1
64441,445,0,0,drop,66,66,0,1,0,1,0
55553,53,13806,53,allow,199,94,105,2,29,1,1
65264,53,51558,53,allow,198,94,104,2,29,1,1
64937,53,29678,53,allow,210,110,100,2,29,1,1
58763,53,58763,53,allow,228,90,138,2,29,1,1
64299,53,64888,53,allow,166,86,80,2,29,1,1
64324,53,40799,53,allow,179,94,85,2,29,1,1
55837,53,36982,53,allow,195,102,93,2,29,1,1
55687,53,12551,53,allow,193,102,91,2,29,1,1
53754,53,53754,53,allow,257,114,143,2,30,1,1
55022,53,15240,53,allow,195,102,93,2,30,1,1
49296,53,40772,53,allow,193,102,91,2,30,1,1
65140,53,14372,53,allow,199,102,97,2,30,1,1
64299,53,64359,53,allow,166,86,80,2,30,1,1
64615,53,10268,53,allow,195,102,93,2,30,1,1
56422,53,39106,53,allow,195,102,93,2,30,1,1
55376,53,1208,53,allow,199,102,97,2,30,1,1
65481,53,17512,53,allow,168,86,82,2,30,1,1
64403,53,23409,53,allow,193,102,91,2,30,1,1
56574,53,9941,53,allow,275,94,181,2,30,1,1
56037,53,29985,53,allow,168,94,74,2,31,1,1
50122,53,55627,53,allow,811,94,717,2,31,1,1
64716,53,43003,53,allow,195,102,93,2,31,1,1
55841,53,22596,53,allow,265,86,179,4,59,2,2
59762,53,43399,53,allow,401,86,315,2,30,1,1
65277,53,55975,53,allow,167,86,81,2,30,1,1
56596,53,51860,53,allow,199,102,97,2,30,1,1
53900,53,54773,53,allow,270,168,102,3,30,2,1
56496,53,56369,53,allow,193,102,91,2,30,1,1
65102,53,65408,53,allow,183,94,89,2,30,1,1
49210,53,33969,53,allow,410,93,317,4,30,2,2
64198,53,39637,53,allow,321,102,219,2,30,1,1
55254,53,52828,53,allow,287,102,185,2,30,1,1
49410,53,14771,53,allow,167,86,81,2,30,1,1
57352,53,35179,53,allow,196,102,94,2,30,1,1
49410,53,35309,53,allow,167,86,81,2,31,1,1
65481,53,51485,53,allow,168,86,82,2,31,1,1
49972,53,55153,53,allow,216,110,106,2,30,1,1
65124,53,53068,53,allow,243,102,141,2,30,1,1
55418,53,32806,53,allow,168,86,82,2,30,1,1
50191,53,9113,53,allow,734,94,640,2,30,1,1
55941,53,27410,53,allow,184,94,90,2,30,1,1
49699,53,49094,53,allow,209,110,99,2,30,1,1
62578,53,27363,53,allow,343,168,175,3,30,2,1
65440,53,2075,53,allow,189,102,87,2,30,1,1
61811,443,37922,443,allow,214,140,74,4,15,3,1
50470,53,11331,53,allow,770,102,668,2,30,1,1
56149,53,56149,53,allow,832,106,726,2,30,1,1
65085,53,45076,53,allow,258,102,156,2,30,1,1
49764,53,36622,53,allow,199,102,97,2,31,1,1
65140,53,62512,53,allow,199,102,97,2,31,1,1
55841,53,32658,53,allow,265,86,179,4,58,2,2
49546,53,28213,53,allow,212,110,102,2,30,1,1
64937,53,12503,53,allow,210,110,100,2,30,1,1
57132,53,39108,53,allow,216,110,106,2,30,1,1
55467,53,65023,53,allow,198,94,104,2,30,1,1
64929,53,59059,53,allow,168,86,82,2,30,1,1
56652,53,9807,53,allow,177,94,83,2,30,1,1
65009,53,11589,53,allow,152,78,74,2,30,1,1
64959,53,50159,53,allow,173,94,79,2,30,1,1
56995,53,4474,53,allow,167,86,81,2,30,1,1
56293,53,1963,53,allow,166,86,80,2,30,1,1
57431,53,4214,53,allow,733,94,639,2,30,1,1
65440,53,49659,53,allow,181,94,87,2,30,1,1
64959,53,35711,53,allow,173,94,79,2,30,1,1
56731,53,12750,53,allow,165,86,79,2,30,1,1
45473,53,13745,53,allow,168,78,90,2,31,1,1
56496,53,28777,53,allow,193,102,91,2,30,1,1
43570,53,0,0,allow,86,86,0,1,30,1,0
56965,53,26904,53,allow,183,94,89,2,30,1,1
56364,53,33489,53,allow,308,94,214,2,30,1,1
64677,53,58771,53,allow,183,94,89,2,30,1,1
56995,53,60804,53,allow,167,86,81,2,30,1,1
56396,53,48729,53,allow,338,110,228,2,30,1,1
56026,53,14279,53,allow,189,102,87,2,30,1,1
56472,53,36068,53,allow,167,86,81,2,31,1,1
49978,53,17082,53,allow,195,102,93,2,31,1,1
49978,53,55753,53,allow,195,102,93,2,30,1,1
56026,53,37730,53,allow,181,94,87,2,31,1,1
64636,53,17069,53,allow,166,86,80,2,31,1,1
49487,53,26714,53,allow,183,94,89,2,31,1,1
55227,53,15557,53,allow,183,102,81,2,31,1,1
53553,53,53553,53,allow,229,98,131,2,30,1,1
49646,53,51164,53,allow,353,118,235,2,30,1,1
41073,53,41073,53,allow,197,90,107,2,30,1,1
39267,123,6756,123,allow,184,94,90,2,30,1,1
55620,53,36114,53,allow,178,94,84,2,31,1,1
64677,53,61310,53,allow,183,94,89,2,31,1,1
56491,53,20777,53,allow,165,86,79,2,31,1,1
65168,53,7392,53,allow,185,102,83,2,31,1,1
56731,53,43957,53,allow,173,94,79,2,31,1,1
55376,53,7206,53,allow,199,102,97,2,31,1,1
49348,53,24608,53,allow,194,102,92,2,31,1,1
64929,53,8681,53,allow,168,86,82,2,31,1,1
57352,53,29825,53,allow,196,102,94,2,31,1,1
57132,53,11896,53,allow,216,110,106,2,31,1,1
49699,53,28371,53,allow,209,110,99,2,31,1,1
49487,53,10311,53,allow,183,94,89,2,31,1,1
65375,53,14200,53,allow,196,94,102,2,31,1,1
53910,1024,52372,1024,allow,70,70,0,2,8,2,0
42263,443,45775,443,allow,224,164,60,3,5,2,1
55022,53,45433,53,allow,195,102,93,2,30,1,1
56472,53,13780,53,allow,167,86,81,2,31,1,1
57075,53,41557,53,allow,443,182,261,6,31,3,3
55556,53,8408,53,allow,183,94,89,2,30,1,1
50288,53,30921,53,allow,764,102,662,2,30,1,1
65286,53,2453,53,allow,369,102,267,2,30,1,1
49611,53,24146,53,allow,177,94,83,2,30,1,1
64693,53,60951,53,allow,766,102,664,2,30,1,1
43390,53,0,0,allow,184,86,98,2,30,1,1
56965,53,44831,53,allow,183,94,89,2,30,1,1
64437,445,0,0,drop,66,66,0,1,0,1,0
64290,445,0,0,drop,70,70,0,1,0,1,0
64288,445,0,0,drop,70,70,0,1,0,1,0
64287,445,0,0,drop,70,70,0,1,0,1,0
64286,445,0,0,drop,70,70,0,1,0,1,0
64285,445,0,0,drop,70,70,0,1,0,1,0
64280,445,0,0,drop,70,70,0,1,0,1,0
64279,445,0,0,drop,70,70,0,1,0,1,0
52655,445,0,0,drop,70,70,0,1,0,1,0
52650,445,0,0,drop,70,70,0,1,0,1,0
52651,445,0,0,drop,70,70,0,1,0,1,0
64422,445,0,0,drop,66,66,0,1,0,1,0
64420,445,0,0,drop,66,66,0,1,0,1,0
64423,445,0,0,drop,66,66,0,1,0,1,0
64424,445,0,0,drop,66,66,0,1,0,1,0
64421,445,0,0,drop,66,66,0,1,0,1,0
64419,445,0,0,drop,66,66,0,1,0,1,0
64418,445,0,0,drop,66,66,0,1,0,1,0
64417,445,0,0,drop,66,66,0,1,0,1,0
64267,445,0,0,drop,70,70,0,1,0,1,0
64266,445,0,0,drop,70,70,0,1,0,1,0
64264,445,0,0,drop,70,70,0,1,0,1,0
64256,445,0,0,drop,70,70,0,1,0,1,0
64257,445,0,0,drop,70,70,0,1,0,1,0
52647,445,0,0,drop,70,70,0,1,0,1,0
52641,445,0,0,drop,70,70,0,1,0,1,0
52637,445,0,0,drop,70,70,0,1,0,1,0
52636,445,0,0,drop,70,70,0,1,0,1,0
64404,445,0,0,drop,66,66,0,1,0,1,0
64403,445,0,0,drop,66,66,0,1,0,1,0
64402,445,0,0,drop,66,66,0,1,0,1,0
64245,445,0,0,drop,70,70,0,1,0,1,0
52630,445,0,0,drop,70,70,0,1,0,1,0
52625,445,0,0,drop,70,70,0,1,0,1,0
52626,445,0,0,drop,70,70,0,1,0,1,0
52622,445,0,0,drop,70,70,0,1,0,1,0
64241,445,0,0,drop,70,70,0,1,0,1,0
64230,445,0,0,drop,70,70,0,1,0,1,0
64231,445,0,0,drop,70,70,0,1,0,1,0
64229,445,0,0,drop,70,70,0,1,0,1,0
55600,22,0,0,deny,60,60,0,1,0,1,0
64228,445,0,0,drop,70,70,0,1,0,1,0
64225,445,0,0,drop,70,70,0,1,0,1,0
52613,445,0,0,drop,70,70,0,1,0,1,0
52612,445,0,0,drop,70,70,0,1,0,1,0
52607,445,0,0,drop,70,70,0,1,0,1,0
64393,445,0,0,drop,66,66,0,1,0,1,0
64219,445,0,0,drop,70,70,0,1,0,1,0
52605,445,0,0,drop,70,70,0,1,0,1,0
52603,445,0,0,drop,70,70,0,1,0,1,0
64211,445,0,0,drop,70,70,0,1,0,1,0
64376,445,0,0,drop,66,66,0,1,0,1,0
64375,445,0,0,drop,66,66,0,1,0,1,0
64210,445,0,0,drop,70,70,0,1,0,1,0
52593,445,0,0,drop,70,70,0,1,0,1,0
52594,445,0,0,drop,70,70,0,1,0,1,0
52590,445,0,0,drop,70,70,0,1,0,1,0
52584,445,0,0,drop,70,70,0,1,0,1,0
64205,445,0,0,drop,70,70,0,1,0,1,0
64203,445,0,0,drop,70,70,0,1,0,1,0
64369,445,0,0,drop,66,66,0,1,0,1,0
64366,445,0,0,drop,66,66,0,1,0,1,0
64364,445,0,0,drop,66,66,0,1,0,1,0
64357,445,0,0,drop,66,66,0,1,0,1,0
64361,445,0,0,drop,66,66,0,1,0,1,0
64355,445,0,0,drop,66,66,0,1,0,1,0
64356,445,0,0,drop,66,66,0,1,0,1,0
64353,445,0,0,drop,66,66,0,1,0,1,0
64199,445,0,0,drop,70,70,0,1,0,1,0
52578,445,0,0,drop,70,70,0,1,0,1,0
52575,445,0,0,drop,70,70,0,1,0,1,0
52572,445,0,0,drop,70,70,0,1,0,1,0
52573,445,0,0,drop,70,70,0,1,0,1,0
64198,445,0,0,drop,70,70,0,1,0,1,0
51232,23,0,0,deny,60,60,0,1,0,1,0
49653,80,62428,80,allow,372,192,180,7,42,4,3
49659,80,54132,80,allow,1937,885,1052,13,42,7,6
49635,80,43715,80,allow,318,192,126,6,42,4,2
49618,80,5688,80,allow,314,192,122,6,42,4,2
49655,80,40166,80,allow,499,192,307,6,42,4,2
49646,80,33279,80,allow,318,192,126,6,42,4,2
56472,53,9100,53,allow,166,85,81,2,31,1,1
49978,53,13448,53,allow,190,97,93,2,30,1,1
49619,80,12609,80,allow,318,192,126,6,42,4,2
49487,53,6709,53,allow,182,93,89,2,30,1,1
55538,53,15605,53,allow,168,86,82,2,30,1,1
64716,53,37975,53,allow,190,97,93,2,31,1,1
49616,80,21429,80,allow,314,192,122,6,42,4,2
49622,80,33304,80,allow,454,262,192,8,42,5,3
49634,80,5183,80,allow,318,192,126,6,42,4,2
49617,80,31416,80,allow,314,192,122,6,42,4,2
49891,53,30480,53,allow,788,108,680,2,31,1,1
49348,53,25745,53,allow,188,96,92,2,31,1,1
65516,53,4200,53,allow,290,94,196,4,41,2,2
46215,443,1828,443,allow,161,101,60,2,5,1,1
49569,80,41314,80,allow,454,262,192,8,44,5,3
49621,80,15641,80,allow,318,192,126,6,42,4,2
49563,80,12092,80,allow,318,192,126,6,45,4,2
49620,80,21542,80,allow,318,192,126,6,42,4,2
49652,80,63583,80,allow,372,192,180,7,42,4,3
49647,80,48193,80,allow,318,192,126,6,42,4,2
49623,80,12161,80,allow,454,262,192,8,42,5,3
49671,80,23759,80,allow,2122,1018,1104,13,41,7,6
56543,53,18371,53,allow,756,95,661,2,30,1,1
62030,53,0,0,allow,229,85,144,2,31,1,1
56314,53,2805,53,allow,182,93,89,2,30,1,1
65239,53,46235,53,allow,198,101,97,2,31,1,1
56575,53,50705,53,allow,732,89,643,2,31,1,1
56925,53,7944,53,allow,192,98,94,2,30,1,1
55106,53,52896,53,allow,184,94,90,2,31,1,1
56612,53,25509,53,allow,274,87,187,4,31,2,2
56592,53,10104,53,allow,200,102,98,2,31,1,1
64306,53,29347,53,allow,216,110,106,2,31,1,1
64193,445,0,0,drop,70,70,0,1,0,1,0
52569,445,0,0,drop,70,70,0,1,0,1,0
52565,445,0,0,drop,70,70,0,1,0,1,0
52564,445,0,0,drop,70,70,0,1,0,1,0
64347,445,0,0,drop,66,66,0,1,0,1,0
52562,445,0,0,drop,70,70,0,1,0,1,0
64344,445,0,0,drop,66,66,0,1,0,1,0
49600,80,7933,80,allow,312,192,120,6,41,4,2
49569,53,19473,53,allow,198,102,96,2,30,1,1
57232,53,10597,53,allow,821,102,719,2,30,1,1
64341,445,0,0,drop,66,66,0,1,0,1,0
64342,445,0,0,drop,66,66,0,1,0,1,0
64340,445,0,0,drop,66,66,0,1,0,1,0
64180,445,0,0,drop,70,70,0,1,0,1,0
52558,445,0,0,drop,70,70,0,1,0,1,0
52553,445,0,0,drop,70,70,0,1,0,1,0
52549,445,0,0,drop,70,70,0,1,0,1,0
64177,445,0,0,drop,70,70,0,1,0,1,0
64329,445,0,0,drop,66,66,0,1,0,1,0
55106,53,41822,53,allow,177,94,83,2,30,1,1
64306,53,23219,53,allow,216,110,106,2,30,1,1
65516,53,26663,53,allow,290,94,196,4,40,2,2
56782,53,44895,53,allow,197,102,95,2,30,1,1
39378,443,56513,443,allow,494,342,152,4,5,2,2
49644,80,40102,80,allow,318,192,126,6,41,4,2
49874,53,61806,53,allow,165,86,79,2,29,1,1
65041,53,3296,53,allow,200,94,106,2,29,1,1
65501,53,16521,53,allow,443,182,261,6,29,3,3
55556,53,62239,53,allow,183,94,89,2,29,1,1
56037,53,56792,53,allow,168,94,74,2,29,1,1
54979,53,30018,53,allow,207,97,110,3,64,2,1
55106,53,22662,53,allow,184,94,90,2,30,1,1
49633,80,21073,80,allow,318,192,126,6,41,4,2
49564,80,48576,80,allow,318,192,126,6,45,4,2
50376,53,42212,53,allow,819,102,717,2,30,1,1
56925,53,48692,53,allow,196,102,94,2,30,1,1
57007,53,5847,53,allow,183,94,89,2,30,1,1
49764,53,54622,53,allow,199,102,97,2,30,1,1
55538,53,6885,53,allow,168,86,82,2,30,1,1
55707,53,54526,53,allow,811,94,717,2,30,1,1
65351,53,49727,53,allow,228,110,118,2,30,1,1
49606,80,25049,80,allow,454,262,192,8,41,5,3
36404,80,8914,80,allow,534,460,74,6,15,5,1
49668,80,43673,80,allow,318,192,126,6,41,4,2
65516,53,20089,53,allow,506,204,302,6,57,3,3
54625,53,52244,53,allow,168,78,90,2,30,1,1
49575,80,43723,80,allow,318,192,126,6,43,4,2
49584,80,44285,80,allow,318,192,126,6,42,4,2
65481,53,60374,53,allow,168,86,82,2,30,1,1
56965,53,39310,53,allow,183,94,89,2,30,1,1
56491,53,2856,53,allow,165,86,79,2,30,1,1
64403,53,33316,53,allow,193,102,91,2,30,1,1
49487,53,55528,53,allow,183,94,89,2,30,1,1
64950,53,55366,53,allow,183,94,89,2,30,1,1
56314,53,10977,53,allow,183,94,89,2,30,1,1
49764,53,50844,53,allow,199,102,97,2,30,1,1
55947,53,4712,53,allow,94,94,0,1,30,1,0
57007,53,38539,53,allow,183,94,89,2,30,1,1
56592,53,38145,53,allow,200,102,98,2,30,1,1
64636,53,38894,53,allow,182,102,80,2,30,1,1
57232,53,8301,53,allow,198,102,96,2,30,1,1
65239,53,27517,53,allow,199,102,97,2,30,1,1
56925,53,20388,53,allow,196,102,94,2,30,1,1
49604,80,21319,80,allow,454,262,192,8,41,5,3
49607,80,52438,80,allow,378,192,186,7,41,4,3
49643,80,57400,80,allow,312,192,120,6,41,4,2
49649,80,26716,80,allow,378,192,186,7,41,4,3
61594,53,61594,53,allow,235,90,145,2,33,1,1
49673,80,41313,80,allow,318,192,126,6,41,4,2
56791,53,55367,53,allow,250,87,163,4,58,2,2
60824,53,60824,53,allow,220,90,130,2,30,1,1
49569,53,26958,53,allow,821,102,719,2,30,1,1
51263,443,57364,443,allow,162,102,60,2,5,1,1
55639,53,59060,53,allow,196,102,94,2,30,1,1
64893,53,6270,53,allow,326,134,192,2,30,1,1
55452,53,61292,53,allow,184,94,90,2,30,1,1
58736,53,58736,53,allow,235,90,145,2,32,1,1
65427,53,25865,53,allow,677,188,489,6,57,3,3
65516,53,41111,53,allow,290,94,196,4,40,2,2
56782,53,33216,53,allow,197,102,95,2,33,1,1
40288,80,46706,80,allow,1195,763,432,10,32,6,4
59533,443,28553,443,allow,448,78,370,6,24,1,5
49645,80,12574,80,allow,318,192,126,6,41,4,2
49614,80,63774,80,allow,374,192,182,7,41,4,3
49599,80,35878,80,allow,312,192,120,6,41,4,2
49651,80,24642,80,allow,318,192,126,6,41,4,2
49642,80,32526,80,allow,312,192,120,6,41,4,2
49609,80,50781,80,allow,318,192,126,6,41,4,2
51829,80,1041,80,allow,1484,928,556,13,76,8,5
49608,80,48854,80,allow,318,192,126,6,41,4,2
49560,80,60008,80,allow,318,192,126,6,45,4,2
56596,53,55954,53,allow,199,102,97,2,29,1,1
64403,53,2916,53,allow,193,102,91,2,29,1,1
56312,53,29568,53,allow,195,102,93,2,29,1,1
49603,80,3315,80,allow,378,192,186,7,41,4,3
49548,53,2066,53,allow,263,102,161,2,29,1,1
56314,53,50014,53,allow,183,94,89,2,30,1,1
55538,53,33092,53,allow,250,86,164,4,30,2,2
58346,53,2203,53,allow,209,102,107,2,30,1,1
60187,53,13355,53,allow,168,78,90,2,30,1,1
64581,53,40086,53,allow,214,110,104,2,30,1,1
56791,53,43251,53,allow,250,87,163,4,58,2,2
49348,53,2617,53,allow,194,102,92,2,30,1,1
64076,53,25451,53,allow,255,102,153,2,30,1,1
49477,53,4842,53,allow,178,94,84,2,31,1,1
49466,53,63344,53,allow,807,94,713,2,30,1,1
42155,443,26461,443,allow,70,70,0,1,5,1,0
49648,80,25450,80,allow,318,192,126,6,41,4,2
49576,80,3769,80,allow,318,192,126,6,43,4,2
49605,80,22223,80,allow,454,262,192,8,41,5,3
49611,80,38044,80,allow,378,192,186,7,41,4,3
49610,80,55235,80,allow,378,192,186,7,41,4,3
49601,80,15488,80,allow,378,192,186,7,41,4,3
50376,53,40722,53,allow,196,102,94,2,30,1,1
55639,53,11030,53,allow,819,102,717,2,30,1,1
49611,53,5356,53,allow,177,94,83,2,30,1,1
55692,53,51127,53,allow,198,102,96,2,30,1,1
49580,443,38727,443,allow,442,262,180,8,42,5,3
49596,80,27800,80,allow,312,192,120,6,41,4,2
49598,80,32079,80,allow,372,192,180,7,41,4,3
49597,80,58897,80,allow,372,192,180,7,41,4,3
49650,80,5839,80,allow,318,192,126,6,41,4,2
49602,80,16412,80,allow,378,192,186,7,41,4,3
64950,53,1692,53,allow,183,94,89,2,30,1,1
65168,53,17811,53,allow,185,102,83,2,30,1,1
57007,53,22368,53,allow,183,94,89,2,30,1,1
55106,53,58487,53,allow,177,94,83,2,30,1,1
55538,53,2707,53,allow,168,86,82,2,30,1,1
57231,53,57692,53,allow,168,86,82,2,32,1,1
49613,80,63557,80,allow,374,192,182,7,41,4,3
49615,80,42615,80,allow,374,192,182,7,41,4,3
49562,80,14517,80,allow,318,192,126,6,45,4,2
49612,80,44677,80,allow,378,192,186,7,41,4,3
56314,53,22045,53,allow,183,94,89,2,30,1,1
55227,53,7352,53,allow,183,102,81,2,30,1,1
56293,53,53658,53,allow,166,86,80,2,30,1,1
49477,53,20665,53,allow,178,94,84,2,30,1,1
64716,53,1067,53,allow,195,102,93,2,30,1,1
49635,53,16265,53,allow,458,188,270,6,30,3,3
55692,53,9187,53,allow,198,102,96,2,31,1,1
64306,53,34963,53,allow,216,110,106,2,31,1,1
65212,53,6232,53,allow,196,102,94,2,31,1,1
64716,53,18562,53,allow,195,102,93,2,31,1,1
55032,53,18500,53,allow,458,188,270,6,31,3,3
56612,53,30112,53,allow,274,87,187,4,31,2,2
49591,53,7823,53,allow,402,118,284,2,30,1,1
56226,53,8376,53,allow,284,96,188,4,31,2,2
64987,53,57288,53,allow,196,102,94,2,31,1,1
56612,53,25011,53,allow,274,87,187,4,31,2,2
55697,53,64657,53,allow,193,102,91,2,31,1,1
49782,443,62911,443,allow,70,70,0,1,5,1,0
46412,53,4555,53,allow,164,78,86,2,31,1,1
51535,443,59853,443,allow,122,62,60,2,16,1,1
50023,53,26218,53,allow,166,86,80,2,31,1,1
55661,53,42015,53,allow,213,102,111,2,30,1,1
56925,53,23020,53,allow,196,102,94,2,30,1,1
56082,53,20820,53,allow,184,94,90,2,30,1,1
64632,53,26914,53,allow,224,94,130,2,30,1,1
57300,53,58923,53,allow,184,94,90,2,31,1,1
36258,23,0,0,deny,60,60,0,1,0,1,0
64172,445,0,0,drop,70,70,0,1,0,1,0
64171,445,0,0,drop,70,70,0,1,0,1,0
64321,445,0,0,drop,66,66,0,1,0,1,0
52534,445,0,0,drop,70,70,0,1,0,1,0
64169,445,0,0,drop,70,70,0,1,0,1,0
64318,445,0,0,drop,66,66,0,1,0,1,0
64312,445,0,0,drop,66,66,0,1,0,1,0
64162,445,0,0,drop,70,70,0,1,0,1,0
64303,445,0,0,drop,66,66,0,1,0,1,0
64160,445,0,0,drop,70,70,0,1,0,1,0
64159,445,0,0,drop,70,70,0,1,0,1,0
64158,445,0,0,drop,70,70,0,1,0,1,0
64157,445,0,0,drop,70,70,0,1,0,1,0
64151,445,0,0,drop,70,70,0,1,0,1,0
64152,445,0,0,drop,70,70,0,1,0,1,0
52526,445,0,0,drop,70,70,0,1,0,1,0
52523,445,0,0,drop,70,70,0,1,0,1,0
52522,445,0,0,drop,70,70,0,1,0,1,0
64291,445,0,0,drop,66,66,0,1,0,1,0
64295,445,0,0,drop,66,66,0,1,0,1,0
64296,445,0,0,drop,66,66,0,1,0,1,0
64294,445,0,0,drop,66,66,0,1,0,1,0
64289,445,0,0,drop,66,66,0,1,0,1,0
64290,445,0,0,drop,66,66,0,1,0,1,0
64292,445,0,0,drop,66,66,0,1,0,1,0
64288,445,0,0,drop,66,66,0,1,0,1,0
64139,445,0,0,drop,70,70,0,1,0,1,0
64138,445,0,0,deny,70,70,0,1,0,1,0
64135,445,0,0,drop,70,70,0,1,0,1,0
64129,445,0,0,drop,70,70,0,1,0,1,0
64128,445,0,0,drop,70,70,0,1,0,1,0
52518,445,0,0,drop,70,70,0,1,0,1,0
52515,445,0,0,drop,70,70,0,1,0,1,0
52509,445,0,0,drop,70,70,0,1,0,1,0
52506,445,0,0,drop,70,70,0,1,0,1,0
64276,445,0,0,drop,66,66,0,1,0,1,0
64273,445,0,0,drop,66,66,0,1,0,1,0
64274,445,0,0,drop,66,66,0,1,0,1,0
64117,445,0,0,drop,70,70,0,1,0,1,0
52502,445,0,0,drop,70,70,0,1,0,1,0
52498,445,0,0,drop,70,70,0,1,0,1,0
52497,445,0,0,drop,70,70,0,1,0,1,0
52496,445,0,0,drop,70,70,0,1,0,1,0
64113,445,0,0,drop,70,70,0,1,0,1,0
64102,445,0,0,drop,70,70,0,1,0,1,0
64101,445,0,0,drop,70,70,0,1,0,1,0
64104,445,0,0,drop,70,70,0,1,0,1,0
64100,445,0,0,drop,70,70,0,1,0,1,0
64097,445,0,0,drop,70,70,0,1,0,1,0
52485,445,0,0,drop,70,70,0,1,0,1,0
52482,445,0,0,drop,70,70,0,1,0,1,0
52480,445,0,0,drop,70,70,0,1,0,1,0
64263,445,0,0,drop,66,66,0,1,0,1,0
64090,445,0,0,drop,70,70,0,1,0,1,0
52477,445,0,0,drop,70,70,0,1,0,1,0
52474,445,0,0,drop,70,70,0,1,0,1,0
64083,445,0,0,drop,70,70,0,1,0,1,0
64080,445,0,0,drop,70,70,0,1,0,1,0
64246,445,0,0,drop,66,66,0,1,0,1,0
64248,445,0,0,drop,66,66,0,1,0,1,0
64077,445,0,0,drop,70,70,0,1,0,1,0
64075,445,0,0,drop,70,70,0,1,0,1,0
52460,445,0,0,drop,70,70,0,1,0,1,0
52462,445,0,0,drop,70,70,0,1,0,1,0
52461,445,0,0,drop,70,70,0,1,0,1,0
52454,445,0,0,drop,70,70,0,1,0,1,0
64239,445,0,0,drop,66,66,0,1,0,1,0
57300,53,43157,53,allow,184,94,90,2,30,1,1
56226,53,12248,53,allow,284,96,188,4,33,2,2
64987,53,14036,53,allow,192,98,94,2,30,1,1
40422,53,0,0,allow,82,82,0,1,30,1,0
55348,53,40546,53,allow,184,80,104,2,30,1,1
64835,53,7153,53,allow,174,89,85,2,30,1,1
46830,80,6947,80,allow,1764,751,1013,10,16,6,4
55551,53,54639,53,allow,788,108,680,2,30,1,1
50023,53,38403,53,allow,164,84,80,2,31,1,1
46963,443,17005,443,allow,70,70,0,1,5,1,0
51574,443,46080,443,allow,400,70,330,6,25,1,5
65212,53,35167,53,allow,192,98,94,2,31,1,1
45482,80,16084,80,allow,1130,624,506,11,15,5,6
56337,53,29643,53,allow,268,89,179,4,45,2,2
56202,53,48899,53,allow,749,94,655,2,30,1,1
55452,53,54913,53,allow,184,94,90,2,30,1,1
51576,443,46569,443,allow,400,70,330,6,25,1,5
55697,53,39982,53,allow,186,95,91,2,31,1,1
55692,53,35310,53,allow,196,100,96,2,30,1,1
55222,53,19882,53,allow,178,91,87,2,30,1,1
55927,53,11810,53,allow,711,87,624,2,30,1,1
40544,53,0,0,allow,82,82,0,1,30,1,0
64974,53,44237,53,allow,212,108,104,2,31,1,1
57301,53,33321,53,allow,170,87,83,2,31,1,1
49234,53,17547,53,allow,166,85,81,2,31,1,1
49477,53,35970,53,allow,172,88,84,2,30,1,1
50095,53,54067,53,allow,146,75,71,2,31,1,1
64071,445,0,0,drop,70,70,0,1,0,1,0
64236,445,0,0,drop,66,66,0,1,0,1,0
64229,445,0,0,drop,66,66,0,1,0,1,0
64235,445,0,0,drop,66,66,0,1,0,1,0
64232,445,0,0,drop,66,66,0,1,0,1,0
64233,445,0,0,drop,66,66,0,1,0,1,0
64227,445,0,0,drop,66,66,0,1,0,1,0
64226,445,0,0,drop,66,66,0,1,0,1,0
64070,445,0,0,drop,70,70,0,1,0,1,0
52450,445,0,0,drop,70,70,0,1,0,1,0
52447,445,0,0,drop,70,70,0,1,0,1,0
52445,445,0,0,drop,70,70,0,1,0,1,0
52443,445,0,0,drop,70,70,0,1,0,1,0
51398,53,51398,53,allow,197,90,107,2,30,1,1
64835,53,59630,53,allow,179,94,85,2,30,1,1
64065,445,0,0,drop,70,70,0,1,0,1,0
52437,445,0,0,drop,70,70,0,1,0,1,0
52438,445,0,0,drop,70,70,0,1,0,1,0
52435,445,0,0,drop,70,70,0,1,0,1,0
64220,445,0,0,drop,66,66,0,1,0,1,0
52434,445,0,0,drop,70,70,0,1,0,1,0
64216,445,0,0,drop,66,66,0,1,0,1,0
56592,53,12698,53,allow,200,102,98,2,29,1,1
49367,53,30708,53,allow,389,94,295,4,55,2,2
64483,53,37576,53,allow,300,90,210,4,30,2,2
55452,53,8362,53,allow,184,94,90,2,29,1,1
65239,53,58774,53,allow,199,102,97,2,29,1,1
55692,53,4863,53,allow,198,102,96,2,29,1,1
56354,53,44261,53,allow,182,102,80,2,29,1,1
64452,53,37833,53,allow,322,102,220,2,29,1,1
55106,53,60018,53,allow,184,94,90,2,29,1,1
49978,53,38632,53,allow,195,102,93,2,29,1,1
64462,53,49415,53,allow,179,94,85,2,30,1,1
55697,53,51781,53,allow,193,102,91,2,30,1,1
49397,53,53029,53,allow,373,98,275,4,43,2,2
56337,53,25650,53,allow,268,89,179,4,45,2,2
52867,53,61685,53,allow,184,86,98,2,30,1,1
56878,53,29099,53,allow,94,94,0,1,30,1,0
49234,53,44202,53,allow,167,86,81,2,30,1,1
55828,53,56117,53,allow,177,94,83,2,30,1,1
49556,53,62658,53,allow,300,100,200,4,44,2,2
55702,80,56730,80,allow,70,70,0,2,8,2,0
56612,53,15256,53,allow,274,87,187,4,30,2,2
59821,80,19887,80,allow,1052,612,440,10,15,5,5
56337,53,46173,53,allow,268,89,179,4,45,2,2
57300,53,21469,53,allow,184,94,90,2,30,1,1
65470,53,21136,53,allow,226,94,132,2,30,1,1
55222,53,4063,53,allow,181,94,87,2,30,1,1
64671,53,7191,53,allow,294,102,192,2,30,1,1
56873,53,25069,53,allow,184,94,90,2,30,1,1
37319,443,50657,443,allow,70,70,0,1,5,1,0
55452,53,7661,53,allow,184,94,90,2,30,1,1
40249,443,14843,443,allow,70,70,0,1,5,1,0
56029,53,2806,53,allow,346,94,252,2,30,1,1
64987,53,4145,53,allow,196,102,94,2,30,1,1
37321,443,3162,443,allow,70,70,0,1,5,1,0
56675,80,35224,80,allow,156,156,0,3,8,3,0
52100,443,58970,443,allow,190,70,120,4,15,2,2
64356,53,40978,53,allow,243,94,149,2,30,1,1
50030,53,18076,53,allow,209,110,99,2,30,1,1
37675,53,37675,53,allow,197,90,107,2,30,1,1
64420,53,21949,53,allow,362,94,268,2,30,1,1
56592,53,24895,53,allow,200,102,98,2,30,1,1
52780,443,29664,443,allow,122,62,60,2,15,1,1
49348,53,28507,53,allow,312,96,216,4,35,2,2
57906,80,15891,80,allow,318,192,126,6,26,4,2
65425,53,21278,53,allow,473,94,379,4,36,2,2
37320,443,60186,443,allow,70,70,0,1,5,1,0
56226,53,44944,53,allow,284,96,188,4,33,2,2
64677,53,11788,53,allow,334,93,241,4,50,2,2
50023,53,49657,53,allow,166,86,80,2,29,1,1
55222,53,13241,53,allow,181,94,87,2,29,1,1
55222,53,63142,53,allow,181,94,87,2,29,1,1
64581,53,16875,53,allow,214,110,104,2,29,1,1
56497,53,23071,53,allow,214,110,104,2,30,1,1
50473,123,38470,123,allow,184,94,90,2,30,1,1
57352,53,7772,53,allow,196,102,94,2,29,1,1
55966,53,61391,53,allow,86,86,0,1,29,1,0
56082,53,33966,53,allow,807,94,713,2,29,1,1
56497,53,5207,53,allow,214,110,104,2,30,1,1
49466,53,52804,53,allow,184,94,90,2,29,1,1
56472,53,54930,53,allow,167,86,81,2,30,1,1
65444,53,41449,53,allow,227,110,117,2,29,1,1
49202,53,57613,53,allow,226,86,140,2,30,1,1
57065,53,13982,53,allow,182,102,80,2,29,1,1
64835,53,38888,53,allow,179,94,85,2,30,1,1
63943,53,31455,53,allow,254,110,144,2,30,1,1
59638,53,40619,53,allow,714,454,260,2,30,1,1
49886,53,51424,53,allow,311,102,209,2,30,1,1
64974,53,31114,53,allow,214,110,104,2,30,1,1
65031,53,34987,53,allow,184,94,90,2,30,1,1
49267,53,44367,53,allow,184,94,90,2,31,1,1
64974,53,53114,53,allow,214,110,104,2,30,1,1
50023,53,60476,53,allow,166,86,80,2,31,1,1
64602,53,49677,53,allow,184,94,90,2,30,1,1
64181,53,18587,53,allow,194,102,92,2,31,1,1
55106,53,36714,53,allow,314,94,220,4,33,2,2
55884,53,55884,53,allow,197,90,107,2,30,1,1
64835,53,41380,53,allow,179,94,85,2,30,1,1
39622,53,25768,53,allow,168,78,90,2,30,1,1
55828,53,14283,53,allow,177,94,83,2,30,1,1
64433,53,21792,53,allow,257,94,163,2,30,1,1
60684,80,43634,80,allow,1737,796,941,12,16,7,5
56676,80,29076,80,allow,78,78,0,2,6,2,0
49477,53,9524,53,allow,271,88,183,4,59,2,2
55369,53,62193,53,allow,376,94,282,2,30,1,1
64225,53,35755,53,allow,322,118,204,2,30,1,1
56937,53,62951,53,allow,181,94,87,2,30,1,1
56937,53,52000,53,allow,181,94,87,2,33,1,1
56337,53,7280,53,allow,268,89,179,4,44,2,2
65212,53,45804,53,allow,196,102,94,2,30,1,1
54962,53,47568,53,allow,241,102,139,2,31,1,1
49849,53,37502,53,allow,196,102,94,2,31,1,1
55697,53,14156,53,allow,193,102,91,2,31,1,1
65031,53,49062,53,allow,184,94,90,2,31,1,1
64462,53,60220,53,allow,329,94,235,4,31,2,2
49772,53,54364,53,allow,181,94,87,2,31,1,1
50364,443,37739,443,allow,1727,926,801,15,30,7,8
49706,53,17646,53,allow,296,102,194,4,42,2,2
53911,1025,45349,1025,allow,130,70,60,3,6,2,1
64306,53,2693,53,allow,216,110,106,2,30,1,1
64214,445,0,0,drop,66,66,0,1,0,1,0
64212,445,0,0,drop,66,66,0,1,0,1,0
64211,445,0,0,drop,66,66,0,1,0,1,0
64052,445,0,0,drop,70,70,0,1,0,1,0
52430,445,0,0,drop,70,70,0,1,0,1,0
64049,445,0,0,drop,70,70,0,1,0,1,0
52420,445,0,0,drop,70,70,0,1,0,1,0
52415,445,0,0,drop,70,70,0,1,0,1,0
64200,445,0,0,drop,66,66,0,1,0,1,0
64045,445,0,0,drop,70,70,0,1,0,1,0
64043,445,0,0,drop,70,70,0,1,0,1,0
64041,445,0,0,drop,70,70,0,1,0,1,0
64192,445,0,0,drop,66,66,0,1,0,1,0
52406,445,0,0,drop,70,70,0,1,0,1,0
64190,445,0,0,drop,66,66,0,1,0,1,0
64034,445,0,0,drop,70,70,0,1,0,1,0
64183,445,0,0,drop,66,66,0,1,0,1,0
64032,445,0,0,drop,70,70,0,1,0,1,0
64172,445,0,0,drop,66,66,0,1,0,1,0
64031,445,0,0,drop,70,70,0,1,0,1,0
64030,445,0,0,drop,70,70,0,1,0,1,0
64029,445,0,0,drop,70,70,0,1,0,1,0
64023,445,0,0,drop,70,70,0,1,0,1,0
64024,445,0,0,drop,70,70,0,1,0,1,0
52398,445,0,0,drop,70,70,0,1,0,1,0
52397,445,0,0,drop,70,70,0,1,0,1,0
52395,445,0,0,drop,70,70,0,1,0,1,0
64011,445,0,0,drop,70,70,0,1,0,1,0
64010,445,0,0,drop,70,70,0,1,0,1,0
64160,445,0,0,drop,66,66,0,1,0,1,0
64164,445,0,0,drop,66,66,0,1,0,1,0
64163,445,0,0,drop,66,66,0,1,0,1,0
64166,445,0,0,drop,66,66,0,1,0,1,0
64167,445,0,0,drop,66,66,0,1,0,1,0
64165,445,0,0,drop,66,66,0,1,0,1,0
64161,445,0,0,drop,66,66,0,1,0,1,0
64159,445,0,0,drop,66,66,0,1,0,1,0
64007,445,0,0,drop,70,70,0,1,0,1,0
64001,445,0,0,drop,70,70,0,1,0,1,0
64000,445,0,0,drop,70,70,0,1,0,1,0
52389,445,0,0,drop,70,70,0,1,0,1,0
52387,445,0,0,drop,70,70,0,1,0,1,0
52386,445,0,0,drop,70,70,0,1,0,1,0
52378,445,0,0,drop,70,70,0,1,0,1,0
63989,445,0,0,drop,70,70,0,1,0,1,0
64144,445,0,0,drop,66,66,0,1,0,1,0
64145,445,0,0,drop,66,66,0,1,0,1,0
64146,445,0,0,drop,66,66,0,1,0,1,0
52374,445,0,0,drop,70,70,0,1,0,1,0
63985,445,0,0,drop,70,70,0,1,0,1,0
52373,445,0,0,drop,70,70,0,1,0,1,0
52371,445,0,0,drop,70,70,0,1,0,1,0
52369,445,0,0,drop,70,70,0,1,0,1,0
39661,23,0,0,deny,60,60,0,1,0,1,0
63975,445,0,0,drop,70,70,0,1,0,1,0
63973,445,0,0,drop,70,70,0,1,0,1,0
63974,445,0,0,drop,70,70,0,1,0,1,0
63972,445,0,0,drop,70,70,0,1,0,1,0
63969,445,0,0,drop,70,70,0,1,0,1,0
52357,445,0,0,drop,70,70,0,1,0,1,0
52354,445,0,0,drop,70,70,0,1,0,1,0
52352,445,0,0,drop,70,70,0,1,0,1,0
51413,1,0,0,deny,72,72,0,1,0,1,0
64132,445,0,0,drop,66,66,0,1,0,1,0
63963,445,0,0,drop,70,70,0,1,0,1,0
52349,445,0,0,drop,70,70,0,1,0,1,0
63955,445,0,0,drop,70,70,0,1,0,1,0
52348,445,0,0,drop,70,70,0,1,0,1,0
63953,445,0,0,drop,70,70,0,1,0,1,0
49250,53,20588,53,allow,731,85,646,2,30,1,1
64602,53,34002,53,allow,184,94,90,2,30,1,1
56491,53,1431,53,allow,711,87,624,2,30,1,1
65031,53,50837,53,allow,184,94,90,2,30,1,1
56485,80,20851,80,allow,569,365,204,6,16,3,3
64462,53,6951,53,allow,174,89,85,2,30,1,1
49556,53,40428,53,allow,300,100,200,4,44,2,2
55687,53,17643,53,allow,731,85,646,2,31,1,1
49267,53,65415,53,allow,184,94,90,2,30,1,1
53260,443,37700,443,allow,572,292,280,9,33,5,4
65318,53,17829,53,allow,184,94,90,2,31,1,1
51656,53,51656,53,allow,198,89,109,2,30,1,1
56248,53,47475,53,allow,767,102,665,2,30,1,1
56873,53,29966,53,allow,184,94,90,2,30,1,1
55503,53,13265,53,allow,200,102,98,2,30,1,1
57237,53,56776,53,allow,701,88,613,2,30,1,1
49706,53,30583,53,allow,296,102,194,4,41,2,2
64181,53,25731,53,allow,188,96,92,2,31,1,1
49772,53,60667,53,allow,178,91,87,2,30,1,1
49849,53,14013,53,allow,192,98,94,2,31,1,1
56519,53,63557,53,allow,166,85,81,2,31,1,1
49564,53,46836,53,allow,186,95,91,2,31,1,1
64118,445,0,0,drop,66,66,0,1,0,1,0
64116,445,0,0,drop,66,66,0,1,0,1,0
63948,445,0,0,drop,70,70,0,1,0,1,0
63947,445,0,0,drop,70,70,0,1,0,1,0
52339,445,0,0,drop,70,70,0,1,0,1,0
65318,53,18281,53,allow,184,94,90,2,30,1,1
52334,445,0,0,drop,70,70,0,1,0,1,0
52332,445,0,0,drop,70,70,0,1,0,1,0
52327,445,0,0,drop,70,70,0,1,0,1,0
63943,445,0,0,drop,70,70,0,1,0,1,0
64114,445,0,0,drop,66,66,0,1,0,1,0
36151,22,0,0,deny,60,60,0,1,0,1,0
63941,445,0,0,drop,70,70,0,1,0,1,0
64100,445,0,0,drop,66,66,0,1,0,1,0
64102,445,0,0,drop,66,66,0,1,0,1,0
64101,445,0,0,drop,66,66,0,1,0,1,0
64106,445,0,0,drop,66,66,0,1,0,1,0
64103,445,0,0,drop,66,66,0,1,0,1,0
64105,445,0,0,drop,66,66,0,1,0,1,0
64097,445,0,0,drop,66,66,0,1,0,1,0
52323,445,0,0,drop,70,70,0,1,0,1,0
48266,80,46749,80,allow,130,70,60,2,15,1,1
46438,53,32231,53,allow,222,78,144,2,30,1,1
37368,80,60512,80,allow,554,258,296,9,13,5,4
49556,53,1572,53,allow,300,100,200,4,43,2,2
64862,53,23535,53,allow,223,94,129,2,29,1,1
64462,53,14604,53,allow,179,94,85,2,29,1,1
57301,53,42748,53,allow,177,94,83,2,29,1,1
57300,53,9339,53,allow,184,94,90,2,29,1,1
49234,53,62807,53,allow,167,86,81,2,29,1,1
57301,53,40888,53,allow,177,94,83,2,29,1,1
55503,53,12220,53,allow,200,102,98,2,30,1,1
65148,53,60062,53,allow,498,204,294,6,29,3,3
65078,53,48280,53,allow,339,110,229,2,29,1,1
49772,53,62355,53,allow,181,94,87,2,29,1,1
56873,53,37492,53,allow,184,94,90,2,30,1,1
64037,53,2722,53,allow,215,94,121,2,29,1,1
64602,53,19507,53,allow,184,94,90,2,30,1,1
38279,80,49834,80,allow,122,62,60,2,15,1,1
37671,53,37671,53,allow,180,82,98,2,30,1,1
49518,53,40851,53,allow,167,86,81,2,30,1,1
49849,53,11014,53,allow,196,102,94,2,30,1,1
49518,53,65191,53,allow,167,86,81,2,30,1,1
49693,53,17140,53,allow,196,94,102,2,30,1,1
64942,53,4876,53,allow,284,102,182,4,37,2,2
55503,53,55222,53,allow,200,102,98,2,30,1,1
64738,53,34025,53,allow,402,118,284,2,30,1,1
56843,53,63293,53,allow,177,94,83,2,30,1,1
50095,53,10662,53,allow,168,86,82,2,30,1,1
57301,53,28379,53,allow,177,94,83,2,30,1,1
49267,53,55947,53,allow,184,94,90,2,30,1,1
50095,53,20934,53,allow,168,86,82,2,30,1,1
64181,53,43777,53,allow,194,102,92,2,30,1,1
49267,53,29003,53,allow,184,94,90,2,30,1,1
64388,53,41426,53,allow,258,110,148,2,30,1,1
56843,53,57824,53,allow,177,94,83,2,30,1,1
47725,443,52489,443,allow,502,250,252,9,32,5,4
49556,53,59272,53,allow,300,100,200,4,44,2,2
64974,53,23445,53,allow,506,108,398,4,36,2,2
50365,80,49822,80,allow,300,180,120,6,29,4,2
55454,53,51580,53,allow,168,86,82,2,33,1,1
50294,80,24616,80,allow,1515,481,1034,11,15,6,5
53964,443,36020,443,allow,374,254,120,4,5,2,2
57341,53,40485,53,allow,296,97,199,4,41,2,2
49706,53,34052,53,allow,296,102,194,4,41,2,2
56672,80,18882,80,allow,234,234,0,4,11,4,0
50283,53,31898,53,allow,767,102,665,2,29,1,1
48437,443,48848,443,allow,934,420,514,15,30,7,8
50095,53,59595,53,allow,250,86,164,4,30,2,2
65212,53,30386,53,allow,196,102,94,2,30,1,1
50629,443,10461,443,allow,1048,1048,0,9,17,9,0
49594,53,49594,53,allow,199,90,109,2,30,1,1
56873,53,11452,53,allow,184,94,90,2,29,1,1
57321,53,25115,53,allow,498,204,294,6,29,3,3
49179,53,18943,53,allow,309,118,191,2,30,1,1
55503,53,54842,53,allow,200,102,98,2,30,1,1
53950,123,31431,123,allow,184,94,90,2,30,1,1
49564,53,39263,53,allow,193,102,91,2,30,1,1
65318,53,11252,53,allow,184,94,90,2,30,1,1
49234,53,17767,53,allow,167,86,81,2,30,1,1
58124,123,43315,123,allow,184,94,90,2,30,1,1
49577,53,36536,53,allow,242,94,148,2,30,1,1
59637,53,37515,53,allow,273,94,179,2,30,1,1
49665,53,16462,53,allow,168,86,82,2,32,1,1
60059,53,45306,53,allow,168,78,90,2,30,1,1
65033,53,12694,53,allow,214,94,120,2,30,1,1
49849,53,61078,53,allow,196,102,94,2,31,1,1
53904,1024,57585,1024,allow,70,70,0,2,8,2,0
38101,443,19198,443,allow,350,210,140,6,15,4,2
53932,80,32355,80,allow,1134,465,669,9,18,6,3
56581,80,13177,80,allow,1630,918,712,12,17,7,5
40842,80,63836,80,allow,1712,786,926,12,17,7,5
49706,53,42213,53,allow,296,102,194,4,41,2,2
64942,53,36365,53,allow,284,102,182,4,38,2,2
65031,53,9401,53,allow,184,94,90,2,30,1,1
49881,53,28896,53,allow,213,102,111,2,30,1,1
64602,53,4497,53,allow,184,94,90,2,30,1,1
65314,53,60905,53,allow,402,118,284,2,30,1,1
64181,53,17159,53,allow,194,102,92,2,31,1,1
52319,445,0,0,drop,70,70,0,1,0,1,0
52317,445,0,0,drop,70,70,0,1,0,1,0
52315,445,0,0,drop,70,70,0,1,0,1,0
63937,445,0,0,drop,70,70,0,1,0,1,0
52313,445,0,0,drop,70,70,0,1,0,1,0
52311,445,0,0,drop,70,70,0,1,0,1,0
52307,445,0,0,drop,70,70,0,1,0,1,0
64092,445,0,0,drop,66,66,0,1,0,1,0
52306,445,0,0,drop,70,70,0,1,0,1,0
64088,445,0,0,drop,66,66,0,1,0,1,0
64085,445,0,0,drop,66,66,0,1,0,1,0
64084,445,0,0,drop,66,66,0,1,0,1,0
63924,445,0,0,drop,70,70,0,1,0,1,0
64082,445,0,0,drop,66,66,0,1,0,1,0
63921,445,0,0,drop,70,70,0,1,0,1,0
52305,445,0,0,drop,70,70,0,1,0,1,0
52292,445,0,0,drop,70,70,0,1,0,1,0
52291,445,0,0,drop,70,70,0,1,0,1,0
63916,445,0,0,drop,70,70,0,1,0,1,0
64072,445,0,0,drop,66,66,0,1,0,1,0
63915,445,0,0,drop,70,70,0,1,0,1,0
63913,445,0,0,drop,70,70,0,1,0,1,0
53904,443,54254,443,allow,495,421,74,4,0,3,1
64064,445,0,0,drop,66,66,0,1,0,1,0
52278,445,0,0,drop,70,70,0,1,0,1,0
56949,22,0,0,deny,60,60,0,1,0,1,0
64062,445,0,0,drop,66,66,0,1,0,1,0
63906,445,0,0,drop,70,70,0,1,0,1,0
63904,445,0,0,drop,70,70,0,1,0,1,0
58022,88,0,0,deny,60,60,0,1,0,1,0
64055,445,0,0,drop,66,66,0,1,0,1,0
63903,445,0,0,drop,70,70,0,1,0,1,0
64052,445,0,0,drop,66,66,0,1,0,1,0
63902,445,0,0,drop,70,70,0,1,0,1,0
63901,445,0,0,drop,70,70,0,1,0,1,0
63899,445,0,0,drop,70,70,0,1,0,1,0
63895,445,0,0,drop,70,70,0,1,0,1,0
63883,445,0,0,drop,70,70,0,1,0,1,0
63882,445,0,0,drop,70,70,0,1,0,1,0
63877,445,0,0,drop,70,70,0,1,0,1,0
63873,445,0,0,drop,70,70,0,1,0,1,0
63872,445,0,0,drop,70,70,0,1,0,1,0
52270,445,0,0,drop,70,70,0,1,0,1,0
52269,445,0,0,drop,70,70,0,1,0,1,0
52266,445,0,0,drop,70,70,0,1,0,1,0
64035,445,0,0,drop,66,66,0,1,0,1,0
64038,445,0,0,drop,66,66,0,1,0,1,0
64037,445,0,0,drop,66,66,0,1,0,1,0
64034,445,0,0,drop,66,66,0,1,0,1,0
64039,445,0,0,drop,66,66,0,1,0,1,0
64036,445,0,0,drop,66,66,0,1,0,1,0
64033,445,0,0,drop,66,66,0,1,0,1,0
63861,445,0,0,drop,70,70,0,1,0,1,0
52264,445,0,0,drop,70,70,0,1,0,1,0
52263,445,0,0,drop,70,70,0,1,0,1,0
52254,445,0,0,drop,70,70,0,1,0,1,0
52253,445,0,0,drop,70,70,0,1,0,1,0
64017,445,0,0,drop,66,66,0,1,0,1,0
64019,445,0,0,drop,66,66,0,1,0,1,0
64016,445,0,0,drop,66,66,0,1,0,1,0
43025,23,0,0,deny,60,60,0,1,0,1,0
63857,445,0,0,drop,70,70,0,1,0,1,0
52247,445,0,0,drop,70,70,0,1,0,1,0
52240,445,0,0,drop,70,70,0,1,0,1,0
52236,445,0,0,drop,70,70,0,1,0,1,0
52238,445,0,0,drop,70,70,0,1,0,1,0
63846,445,0,0,drop,70,70,0,1,0,1,0
63848,445,0,0,drop,70,70,0,1,0,1,0
63847,445,0,0,drop,70,70,0,1,0,1,0
63843,445,0,0,drop,70,70,0,1,0,1,0
63841,445,0,0,drop,70,70,0,1,0,1,0
52228,445,0,0,drop,70,70,0,1,0,1,0
52226,445,0,0,drop,70,70,0,1,0,1,0
47178,53,0,0,allow,82,82,0,2,40,2,0
40517,53,18726,53,allow,284,79,205,2,30,1,1
64850,53,13429,53,allow,166,85,81,2,31,1,1
38728,443,11034,443,allow,560,280,280,9,27,5,4
47613,53,0,0,allow,82,82,0,1,30,1,0
60518,80,21543,80,allow,1915,797,1118,8,16,5,3
52079,1024,39803,1024,allow,66,66,0,1,5,1,0
54104,80,15819,80,allow,214,140,74,4,15,3,1
50401,443,63156,443,allow,256,136,120,5,9,3,2
54314,53,25378,53,allow,284,79,205,2,30,1,1
56782,53,53429,53,allow,194,99,95,2,30,1,1
64942,53,24439,53,allow,522,190,332,5,48,3,2
63834,445,0,0,drop,70,70,0,1,0,1,0
64005,445,0,0,drop,66,66,0,1,0,1,0
57599,80,57241,80,allow,1526,972,554,10,75,6,4
64017,80,54075,80,allow,314,192,122,6,15,4,2
63827,445,0,0,drop,70,70,0,1,0,1,0
63824,445,0,0,drop,70,70,0,1,0,1,0
52221,445,0,0,drop,70,70,0,1,0,1,0
52220,445,0,0,drop,70,70,0,1,0,1,0
63819,445,0,0,drop,70,70,0,1,0,1,0
63817,445,0,0,drop,70,70,0,1,0,1,0
63988,445,0,0,drop,66,66,0,1,0,1,0
63989,445,0,0,drop,66,66,0,1,0,1,0
63813,445,0,0,drop,70,70,0,1,0,1,0
52210,445,0,0,drop,70,70,0,1,0,1,0
52206,445,0,0,drop,70,70,0,1,0,1,0
52204,445,0,0,drop,70,70,0,1,0,1,0
52198,445,0,0,drop,70,70,0,1,0,1,0
63812,445,0,0,drop,70,70,0,1,0,1,0
63984,445,0,0,drop,66,66,0,1,0,1,0
63979,445,0,0,drop,66,66,0,1,0,1,0
63976,445,0,0,drop,66,66,0,1,0,1,0
63967,445,0,0,drop,66,66,0,1,0,1,0
63972,445,0,0,drop,66,66,0,1,0,1,0
63971,445,0,0,drop,66,66,0,1,0,1,0
63968,445,0,0,drop,66,66,0,1,0,1,0
63969,445,0,0,drop,66,66,0,1,0,1,0
52196,445,0,0,drop,70,70,0,1,0,1,0
52191,445,0,0,drop,70,70,0,1,0,1,0
52187,445,0,0,drop,70,70,0,1,0,1,0
52189,445,0,0,drop,70,70,0,1,0,1,0
63807,445,0,0,drop,70,70,0,1,0,1,0
55931,53,3407,53,allow,168,78,90,2,30,1,1
64588,53,5541,53,allow,264,102,162,2,30,1,1
65318,53,63246,53,allow,294,94,200,4,51,2,2
56289,53,22157,53,allow,351,110,241,2,29,1,1
56674,80,12315,80,allow,156,156,0,3,8,3,0
49564,53,13171,53,allow,193,102,91,2,29,1,1
56853,53,24934,53,allow,167,86,81,2,29,1,1
55958,53,30538,53,allow,275,86,189,2,29,1,1
56519,53,20744,53,allow,167,86,81,2,29,1,1
56853,53,30375,53,allow,167,86,81,2,29,1,1
60708,53,53667,53,allow,291,86,205,2,29,1,1
58885,443,39873,443,allow,354,294,60,2,15,1,1
55346,53,15239,53,allow,199,94,105,2,30,1,1
65400,53,61482,53,allow,211,102,109,2,30,1,1
51243,80,3228,80,allow,1451,949,502,12,46,7,5
60607,53,60607,53,allow,832,106,726,2,30,1,1
64810,53,30848,53,allow,257,126,131,2,30,1,1
55360,80,13495,80,allow,130,70,60,2,15,1,1
37306,53,55019,53,allow,168,78,90,2,30,1,1
54071,53,10458,53,allow,207,86,121,2,30,1,1
49658,53,43401,53,allow,211,102,109,2,30,1,1
48778,80,16126,80,allow,130,70,60,2,15,1,1
36829,443,57108,443,allow,560,280,280,9,27,5,4
38606,53,21514,53,allow,168,78,90,2,30,1,1
49836,53,59050,53,allow,327,102,225,2,30,1,1
65168,53,46023,53,allow,239,94,145,2,30,1,1
48992,80,47525,80,allow,1114,534,580,12,16,7,5
55103,53,23177,53,allow,392,92,300,4,55,2,2
56782,53,51814,53,allow,197,102,95,2,33,1,1
49279,80,12266,80,allow,254,128,126,5,15,3,2
56519,53,14326,53,allow,167,86,81,2,29,1,1
57231,53,46027,53,allow,168,86,82,2,30,1,1
57202,443,8164,443,allow,1728,1153,575,12,28,7,5
56519,53,28431,53,allow,167,86,81,2,30,1,1
56672,53,64193,53,allow,177,94,83,2,30,1,1
49564,53,61434,53,allow,193,102,91,2,30,1,1
64850,53,27196,53,allow,167,86,81,2,30,1,1
49661,53,62903,53,allow,344,102,242,2,30,1,1
55363,53,15445,53,allow,228,110,118,2,30,1,1
50040,53,62872,53,allow,322,102,220,2,30,1,1
64850,53,29250,53,allow,167,86,81,2,30,1,1
64962,53,48454,53,allow,226,94,132,2,30,1,1
56672,53,51134,53,allow,177,94,83,2,30,1,1
36628,80,54402,80,allow,78,78,0,2,8,2,0
64593,53,46361,53,allow,258,102,156,2,30,1,1
52042,80,17014,80,allow,70,70,0,2,8,2,0
56044,80,25395,80,allow,1515,481,1034,11,16,6,5
64850,53,55584,53,allow,167,86,81,2,30,1,1
52184,445,0,0,drop,70,70,0,1,0,1,0
52183,445,0,0,drop,70,70,0,1,0,1,0
52179,445,0,0,drop,70,70,0,1,0,1,0
63962,445,0,0,drop,66,66,0,1,0,1,0
52178,445,0,0,drop,70,70,0,1,0,1,0
63959,445,0,0,drop,66,66,0,1,0,1,0
63794,445,0,0,drop,70,70,0,1,0,1,0
63957,445,0,0,drop,66,66,0,1,0,1,0
63955,445,0,0,drop,66,66,0,1,0,1,0
54173,23,0,0,deny,60,60,0,1,0,1,0
63953,445,0,0,drop,66,66,0,1,0,1,0
63791,445,0,0,drop,70,70,0,1,0,1,0
53902,443,2298,443,allow,499,425,74,4,0,3,1
52176,445,0,0,drop,70,70,0,1,0,1,0
52165,445,0,0,drop,70,70,0,1,0,1,0
52164,445,0,0,drop,70,70,0,1,0,1,0
63787,445,0,0,drop,70,70,0,1,0,1,0
65331,53,50741,53,allow,732,89,643,2,0,1,1
63785,445,0,0,drop,70,70,0,1,0,1,0
63943,445,0,0,drop,66,66,0,1,0,1,0
63783,445,0,0,drop,70,70,0,1,0,1,0
53901,443,43794,443,allow,499,425,74,4,0,3,1
53903,443,40208,443,allow,499,425,74,4,0,3,1
53900,443,15989,443,allow,499,425,74,4,0,3,1
53897,443,53988,443,allow,499,425,74,4,0,3,1
53898,443,56204,443,allow,499,425,74,4,0,3,1
53899,443,57181,443,allow,499,425,74,4,0,3,1
53890,443,45559,443,allow,499,425,74,4,0,3,1
53895,443,53348,443,allow,499,425,74,4,0,3,1
53896,443,17824,443,allow,499,425,74,4,0,3,1
53894,443,56603,443,allow,499,425,74,4,0,3,1
53893,443,15377,443,allow,499,425,74,4,0,3,1
53885,443,38826,443,allow,499,425,74,4,0,3,1
53891,443,8709,443,allow,499,425,74,4,0,3,1
53892,443,6388,443,allow,499,425,74,4,0,3,1
53886,443,40309,443,allow,499,425,74,4,0,3,1
53887,443,39424,443,allow,499,425,74,4,0,3,1
53888,443,38577,443,allow,499,425,74,4,0,3,1
53889,443,11378,443,allow,499,425,74,4,0,3,1
63935,445,0,0,drop,66,66,0,1,0,1,0
52155,445,0,0,drop,70,70,0,1,0,1,0
63776,445,0,0,drop,70,70,0,1,0,1,0
63932,445,0,0,drop,66,66,0,1,0,1,0
63774,445,0,0,drop,70,70,0,1,0,1,0
63773,445,0,0,drop,70,70,0,1,0,1,0
63772,445,0,0,drop,70,70,0,1,0,1,0
63771,445,0,0,drop,70,70,0,1,0,1,0
63926,445,0,0,drop,66,66,0,1,0,1,0
63766,445,0,0,drop,70,70,0,1,0,1,0
63765,445,0,0,drop,70,70,0,1,0,1,0
63918,445,0,0,drop,66,66,0,1,0,1,0
63753,445,0,0,drop,70,70,0,1,0,1,0
63752,445,0,0,drop,70,70,0,1,0,1,0
63749,445,0,0,drop,70,70,0,1,0,1,0
63743,445,0,0,drop,70,70,0,1,0,1,0
63742,445,0,0,drop,70,70,0,1,0,1,0
52142,445,0,0,drop,70,70,0,1,0,1,0
52139,445,0,0,drop,70,70,0,1,0,1,0
52138,445,0,0,drop,70,70,0,1,0,1,0
63901,445,0,0,drop,66,66,0,1,0,1,0
63905,445,0,0,drop,66,66,0,1,0,1,0
63908,445,0,0,drop,66,66,0,1,0,1,0
63907,445,0,0,drop,66,66,0,1,0,1,0
63902,445,0,0,drop,66,66,0,1,0,1,0
63904,445,0,0,drop,66,66,0,1,0,1,0
63903,445,0,0,drop,66,66,0,1,0,1,0
63900,445,0,0,drop,66,66,0,1,0,1,0
63731,445,0,0,drop,70,70,0,1,0,1,0
52134,445,0,0,drop,70,70,0,1,0,1,0
52133,445,0,0,drop,70,70,0,1,0,1,0
52131,445,0,0,drop,70,70,0,1,0,1,0
52122,445,0,0,drop,70,70,0,1,0,1,0
63886,445,0,0,drop,66,66,0,1,0,1,0
63885,445,0,0,drop,66,66,0,1,0,1,0
63884,445,0,0,drop,66,66,0,1,0,1,0
63727,445,0,0,drop,70,70,0,1,0,1,0
52118,445,0,0,drop,70,70,0,1,0,1,0
49531,80,57829,80,allow,78,78,0,1,5,1,0
59893,80,45322,80,allow,130,70,60,2,15,1,1
57410,53,64082,53,allow,711,87,624,2,30,1,1
56082,53,58517,53,allow,271,88,183,4,38,2,2
56467,53,49050,53,allow,578,286,292,9,15,5,4
56937,53,51825,53,allow,178,91,87,2,30,1,1
55542,53,5716,53,allow,170,87,83,2,30,1,1
64117,53,64117,53,allow,209,77,132,2,32,1,1
57231,53,16422,53,allow,168,86,82,2,31,1,1
46720,53,0,0,allow,82,82,0,1,30,1,0
56440,53,9792,53,allow,711,87,624,2,31,1,1
57164,443,51715,443,allow,522,78,444,8,22,2,6
63716,445,0,0,drop,70,70,0,1,0,1,0
63718,445,0,0,drop,70,70,0,1,0,1,0
63717,445,0,0,drop,70,70,0,1,0,1,0
52117,445,0,0,drop,70,70,0,1,0,1,0
52110,445,0,0,drop,70,70,0,1,0,1,0
52109,445,0,0,drop,70,70,0,1,0,1,0
63714,445,0,0,drop,70,70,0,1,0,1,0
63711,445,0,0,drop,70,70,0,1,0,1,0
41970,23,0,0,deny,60,60,0,1,0,1,0
63704,445,0,0,drop,70,70,0,1,0,1,0
52101,445,0,0,drop,70,70,0,1,0,1,0
52098,445,0,0,drop,70,70,0,1,0,1,0
52096,445,0,0,drop,70,70,0,1,0,1,0
63873,445,0,0,drop,66,66,0,1,0,1,0
63697,445,0,0,drop,70,70,0,1,0,1,0
63696,445,0,0,drop,70,70,0,1,0,1,0
49781,53,35337,53,allow,254,102,152,2,29,1,1
50405,443,58184,443,allow,612,280,332,10,26,5,5
54819,443,17467,443,allow,70,70,0,1,4,1,0
60514,80,54084,80,allow,1641,944,697,9,15,5,4
44680,80,65456,80,allow,1658,922,736,10,17,6,4
52105,1024,36023,1024,allow,70,70,0,2,7,2,0
54813,443,48795,443,allow,1633,819,814,16,40,8,8
56737,80,46127,80,allow,194,128,66,4,25,3,1
55542,53,10496,53,allow,177,94,83,2,29,1,1
56937,53,49569,53,allow,181,94,87,2,33,1,1
49773,80,31365,80,allow,70,70,0,1,5,1,0
52093,445,0,0,drop,70,70,0,1,0,1,0
52090,445,0,0,drop,70,70,0,1,0,1,0
63690,445,0,0,drop,70,70,0,1,0,1,0
49558,53,42255,53,allow,350,93,257,4,42,2,2
36983,80,52569,80,allow,130,70,60,2,15,1,1
65386,53,35268,53,allow,197,102,95,2,33,1,1
65507,53,1633,53,allow,177,94,83,2,30,1,1
55542,53,62446,53,allow,177,94,83,2,30,1,1
49428,53,23705,53,allow,200,94,106,2,30,1,1
49730,53,34301,53,allow,539,100,439,4,54,2,2
40587,53,36507,53,allow,271,102,169,2,30,1,1
57308,53,39831,53,allow,302,110,192,2,30,1,1
50656,80,17387,80,allow,318,192,126,6,25,4,2
56082,53,15374,53,allow,271,88,183,4,37,2,2
49634,53,57122,53,allow,718,94,624,2,30,1,1
41336,443,51571,443,allow,350,210,140,6,30,4,2
56671,80,31736,80,allow,234,234,0,4,12,4,0
56736,80,11534,80,allow,194,128,66,4,25,3,1
65331,53,14108,53,allow,308,102,206,2,30,1,1
64687,53,30992,53,allow,495,109,386,4,53,2,2
56734,80,64954,80,allow,194,128,66,4,25,3,1
64458,53,4904,53,allow,292,102,190,2,30,1,1
55542,53,50778,53,allow,177,94,83,2,30,1,1
65293,53,50670,53,allow,94,94,0,1,30,1,0
52474,123,6683,123,allow,184,94,90,2,30,1,1
65507,53,62722,53,allow,177,94,83,2,30,1,1
56735,80,63370,80,allow,194,128,66,4,25,3,1
54432,53,45895,53,allow,168,78,90,2,30,1,1
56082,53,31858,53,allow,271,88,183,4,37,2,2
60439,53,58321,53,allow,70,70,0,1,30,1,0
39236,80,55447,80,allow,190,70,120,4,16,2,2
49498,53,33432,53,allow,211,102,109,2,30,1,1
56213,53,25430,53,allow,168,78,90,2,30,1,1
56274,53,38501,53,allow,177,94,83,2,30,1,1
56082,53,50090,53,allow,271,88,183,4,38,2,2
51558,443,41569,443,allow,254,70,184,5,22,2,3
65359,53,37489,53,allow,210,102,108,2,30,1,1
55232,53,52840,53,allow,177,94,83,2,30,1,1
49835,53,10267,53,allow,199,94,105,2,31,1,1
45844,80,40841,80,allow,152,78,74,2,5,1,1
63689,445,0,0,drop,70,70,0,1,0,1,0
63860,445,0,0,drop,66,66,0,1,0,1,0
63855,445,0,0,drop,66,66,0,1,0,1,0
63685,445,0,0,drop,70,70,0,1,0,1,0
52083,445,0,0,drop,70,70,0,1,0,1,0
52080,445,0,0,drop,70,70,0,1,0,1,0
52076,445,0,0,drop,70,70,0,1,0,1,0
52072,445,0,0,drop,70,70,0,1,0,1,0
63684,445,0,0,drop,70,70,0,1,0,1,0
63852,445,0,0,drop,66,66,0,1,0,1,0
63838,445,0,0,drop,66,66,0,1,0,1,0
63847,445,0,0,drop,66,66,0,1,0,1,0
63844,445,0,0,drop,66,66,0,1,0,1,0
63841,445,0,0,drop,66,66,0,1,0,1,0
63843,445,0,0,drop,66,66,0,1,0,1,0
63839,445,0,0,drop,66,66,0,1,0,1,0
63846,445,0,0,drop,66,66,0,1,0,1,0
63679,445,0,0,drop,70,70,0,1,0,1,0
52067,445,0,0,drop,70,70,0,1,0,1,0
52060,445,0,0,drop,70,70,0,1,0,1,0
52063,445,0,0,drop,70,70,0,1,0,1,0
52059,445,0,0,drop,70,70,0,1,0,1,0
52056,445,0,0,drop,70,70,0,1,0,1,0
52053,445,0,0,drop,70,70,0,1,0,1,0
52052,445,0,0,drop,70,70,0,1,0,1,0
63666,445,0,0,drop,70,70,0,1,0,1,0
63830,445,0,0,drop,66,66,0,1,0,1,0
52050,445,0,0,drop,70,70,0,1,0,1,0
63827,445,0,0,drop,66,66,0,1,0,1,0
63663,445,0,0,drop,70,70,0,1,0,1,0
63826,445,0,0,drop,66,66,0,1,0,1,0
63824,445,0,0,drop,66,66,0,1,0,1,0
63823,445,0,0,drop,66,66,0,1,0,1,0
52045,445,0,0,drop,70,70,0,1,0,1,0
63658,445,0,0,drop,70,70,0,1,0,1,0
63657,445,0,0,drop,70,70,0,1,0,1,0
52039,445,0,0,drop,70,70,0,1,0,1,0
52036,445,0,0,drop,70,70,0,1,0,1,0
63655,445,0,0,drop,70,70,0,1,0,1,0
63811,445,0,0,drop,66,66,0,1,0,1,0
63804,445,0,0,drop,66,66,0,1,0,1,0
52024,445,0,0,drop,70,70,0,1,0,1,0
57860,23,0,0,deny,60,60,0,1,0,1,0
63648,445,0,0,drop,70,70,0,1,0,1,0
63646,445,0,0,drop,70,70,0,1,0,1,0
63802,445,0,0,drop,66,66,0,1,0,1,0
63645,445,0,0,drop,70,70,0,1,0,1,0
63644,445,0,0,drop,70,70,0,1,0,1,0
63643,445,0,0,drop,70,70,0,1,0,1,0
63640,445,0,0,drop,70,70,0,1,0,1,0
63639,445,0,0,drop,70,70,0,1,0,1,0
63795,445,0,0,drop,66,66,0,1,0,1,0
63787,445,0,0,drop,66,66,0,1,0,1,0
41210,23,0,0,deny,60,60,0,1,0,1,0
63625,445,0,0,drop,70,70,0,1,0,1,0
63624,445,0,0,drop,70,70,0,1,0,1,0
63621,445,0,0,drop,70,70,0,1,0,1,0
63614,445,0,0,drop,70,70,0,1,0,1,0
63615,445,0,0,drop,70,70,0,1,0,1,0
52014,445,0,0,drop,70,70,0,1,0,1,0
52012,445,0,0,drop,70,70,0,1,0,1,0
52010,445,0,0,drop,70,70,0,1,0,1,0
63775,445,0,0,drop,66,66,0,1,0,1,0
63771,445,0,0,drop,66,66,0,1,0,1,0
63778,445,0,0,drop,66,66,0,1,0,1,0
63776,445,0,0,drop,66,66,0,1,0,1,0
63779,445,0,0,drop,66,66,0,1,0,1,0
63772,445,0,0,drop,66,66,0,1,0,1,0
63773,445,0,0,drop,66,66,0,1,0,1,0
63777,445,0,0,drop,66,66,0,1,0,1,0
63603,445,0,0,drop,70,70,0,1,0,1,0
39186,53,39186,53,allow,371,237,134,3,33,2,1
56354,53,56354,53,allow,214,97,117,2,30,1,1
49665,53,35069,53,allow,168,86,82,2,32,1,1
61509,443,47638,443,allow,1506,984,522,14,27,8,6
38019,443,55149,443,allow,884,464,420,13,28,7,6
56303,53,13622,53,allow,170,87,83,2,30,1,1
64455,53,64455,53,allow,257,101,156,2,33,1,1
64343,53,64343,53,allow,216,98,118,2,30,1,1
65047,53,45819,53,allow,206,91,115,2,30,1,1
56737,53,36153,53,allow,817,98,719,2,31,1,1
65165,53,27998,53,allow,783,96,687,2,31,1,1
55193,53,60056,53,allow,170,87,83,2,31,1,1
45202,23,0,0,deny,60,60,0,1,0,1,0
52007,445,0,0,drop,70,70,0,1,0,1,0
52006,445,0,0,drop,70,70,0,1,0,1,0
52001,445,0,0,drop,70,70,0,1,0,1,0
51998,445,0,0,drop,70,70,0,1,0,1,0
63599,445,0,0,drop,70,70,0,1,0,1,0
63756,445,0,0,drop,66,66,0,1,0,1,0
63758,445,0,0,drop,66,66,0,1,0,1,0
63755,445,0,0,drop,66,66,0,1,0,1,0
64814,53,31747,53,allow,565,215,350,6,37,3,3
63588,445,0,0,drop,70,70,0,1,0,1,0
63589,445,0,0,drop,70,70,0,1,0,1,0
63590,445,0,0,drop,70,70,0,1,0,1,0
63584,445,0,0,drop,70,70,0,1,0,1,0
63582,445,0,0,drop,70,70,0,1,0,1,0
51985,445,0,0,drop,70,70,0,1,0,1,0
51984,445,0,0,drop,70,70,0,1,0,1,0
51981,445,0,0,drop,70,70,0,1,0,1,0
63576,445,0,0,drop,70,70,0,1,0,1,0
51973,445,0,0,drop,70,70,0,1,0,1,0
51972,445,0,0,drop,70,70,0,1,0,1,0
51968,445,0,0,drop,70,70,0,1,0,1,0
63745,445,0,0,drop,66,66,0,1,0,1,0
63569,445,0,0,drop,70,70,0,1,0,1,0
63567,445,0,0,drop,70,70,0,1,0,1,0
63562,445,0,0,drop,70,70,0,1,0,1,0
57231,53,2071,53,allow,168,86,82,2,31,1,1
56274,53,29071,53,allow,177,94,83,2,29,1,1
58094,53,1806,53,allow,249,102,147,2,29,1,1
49278,80,1561,80,allow,254,128,126,5,16,3,2
49944,53,58340,53,allow,334,90,244,4,38,2,2
64708,53,37304,53,allow,437,89,348,4,48,2,2
49228,53,52033,53,allow,209,110,99,2,30,1,1
46310,443,24043,443,allow,172,172,0,2,5,2,0
64341,53,61484,53,allow,355,118,237,2,30,1,1
55669,53,24694,53,allow,195,94,101,2,30,1,1
51283,443,17367,443,allow,638,292,346,10,28,5,5
51559,443,32426,443,allow,254,70,184,5,21,2,3
65344,53,8855,53,allow,180,94,86,2,35,1,1
56303,53,31666,53,allow,177,94,83,2,30,1,1
49631,53,6299,53,allow,198,102,96,2,33,1,1
55232,53,34536,53,allow,177,94,83,2,29,1,1
44720,53,0,0,allow,86,86,0,1,29,1,0
65224,53,29187,53,allow,232,110,122,2,30,1,1
49665,53,15025,53,allow,168,86,82,2,29,1,1
56303,53,55286,53,allow,177,94,83,2,30,1,1
40662,53,39686,53,allow,223,78,145,2,30,1,1
52422,443,1583,443,allow,1043,556,487,10,15,6,4
49527,53,63553,53,allow,415,98,317,4,51,2,2
51971,53,51971,53,allow,240,98,142,2,30,1,1
49824,53,50073,53,allow,198,94,104,2,30,1,1
55454,53,64127,53,allow,168,86,82,2,32,1,1
64249,53,6288,53,allow,181,94,87,2,33,1,1
65071,53,53845,53,allow,411,99,312,4,52,2,2
49819,53,24234,53,allow,94,94,0,1,30,1,0
59189,53,53487,53,allow,222,94,128,2,30,1,1
51944,53,51944,53,allow,832,106,726,2,30,1,1
55133,53,55133,53,allow,228,90,138,2,30,1,1
52854,53,0,0,allow,86,86,0,1,30,1,0
52018,53,53682,53,allow,164,78,86,2,30,1,1
36661,53,19439,53,allow,164,78,86,2,31,1,1
55868,53,18445,53,allow,177,94,83,2,30,1,1
53581,53,57842,53,allow,231,94,137,2,30,1,1
49767,53,4502,53,allow,177,94,83,2,30,1,1
49562,53,28687,53,allow,198,94,104,2,30,1,1
64030,53,24656,53,allow,338,110,228,2,30,1,1
51965,445,0,0,drop,70,70,0,1,0,1,0
63561,445,0,0,drop,70,70,0,1,0,1,0
51963,445,0,0,drop,70,70,0,1,0,1,0
63557,445,0,0,drop,70,70,0,1,0,1,0
63731,445,0,0,drop,66,66,0,1,0,1,0
63726,445,0,0,drop,66,66,0,1,0,1,0
63556,445,0,0,drop,70,70,0,1,0,1,0
51948,445,0,0,drop,70,70,0,1,0,1,0
51946,445,0,0,drop,70,70,0,1,0,1,0
51944,445,0,0,drop,70,70,0,1,0,1,0
51945,445,0,0,drop,70,70,0,1,0,1,0
63724,445,0,0,drop,66,66,0,1,0,1,0
63551,445,0,0,drop,70,70,0,1,0,1,0
63715,445,0,0,drop,66,66,0,1,0,1,0
63713,445,0,0,drop,66,66,0,1,0,1,0
63712,445,0,0,drop,66,66,0,1,0,1,0
63717,445,0,0,drop,66,66,0,1,0,1,0
63719,445,0,0,drop,66,66,0,1,0,1,0
63711,445,0,0,drop,66,66,0,1,0,1,0
63708,445,0,0,drop,66,66,0,1,0,1,0
51938,445,0,0,drop,70,70,0,1,0,1,0
51935,445,0,0,drop,70,70,0,1,0,1,0
51932,445,0,0,drop,70,70,0,1,0,1,0
51931,445,0,0,drop,70,70,0,1,0,1,0
63538,445,0,0,drop,70,70,0,1,0,1,0
51930,445,0,0,drop,70,70,0,1,0,1,0
51928,445,0,0,drop,70,70,0,1,0,1,0
51927,445,0,0,drop,70,70,0,1,0,1,0
63702,445,0,0,drop,66,66,0,1,0,1,0
51922,445,0,0,drop,70,70,0,1,0,1,0
63535,445,0,0,drop,70,70,0,1,0,1,0
63699,445,0,0,drop,66,66,0,1,0,1,0
63696,445,0,0,drop,66,66,0,1,0,1,0
63695,445,0,0,drop,66,66,0,1,0,1,0
63694,445,0,0,drop,66,66,0,1,0,1,0
63531,445,0,0,drop,70,70,0,1,0,1,0
63529,445,0,0,drop,70,70,0,1,0,1,0
51918,445,0,0,drop,70,70,0,1,0,1,0
63527,445,0,0,drop,70,70,0,1,0,1,0
51904,445,0,0,drop,70,70,0,1,0,1,0
63683,445,0,0,drop,66,66,0,1,0,1,0
63520,445,0,0,drop,70,70,0,1,0,1,0
63675,445,0,0,drop,66,66,0,1,0,1,0
63518,445,0,0,drop,70,70,0,1,0,1,0
51894,445,0,0,drop,70,70,0,1,0,1,0
63517,445,0,0,drop,70,70,0,1,0,1,0
63516,445,0,0,drop,70,70,0,1,0,1,0
63515,445,0,0,drop,70,70,0,1,0,1,0
63672,445,0,0,drop,66,66,0,1,0,1,0
63509,445,0,0,drop,70,70,0,1,0,1,0
63510,445,0,0,drop,70,70,0,1,0,1,0
63666,445,0,0,drop,66,66,0,1,0,1,0
63497,445,0,0,drop,70,70,0,1,0,1,0
63495,445,0,0,drop,70,70,0,1,0,1,0
63658,445,0,0,drop,66,66,0,1,0,1,0
63494,445,0,0,drop,70,70,0,1,0,1,0
63487,445,0,0,drop,70,70,0,1,0,1,0
63486,445,0,0,drop,70,70,0,1,0,1,0
61572,53,61572,53,allow,213,79,134,2,33,1,1
49767,53,37135,53,allow,170,87,83,2,30,1,1
50400,443,40237,443,allow,316,136,180,6,6,3,3
56324,53,56324,53,allow,257,101,156,2,34,1,1
60415,53,60415,53,allow,257,101,156,2,33,1,1
48150,443,17947,443,allow,502,222,280,8,28,4,4
56705,53,36648,53,allow,711,87,624,2,30,1,1
64913,53,45280,53,allow,188,96,92,2,30,1,1
56285,53,40728,53,allow,711,87,624,2,30,1,1
49420,53,3179,53,allow,170,87,83,2,31,1,1
57051,53,63796,53,allow,783,96,687,2,30,1,1
55423,53,61643,53,allow,711,87,624,2,31,1,1
38049,53,38049,53,allow,213,87,126,2,31,1,1
65388,53,55189,53,allow,764,99,665,2,31,1,1
44274,53,0,0,allow,82,82,0,1,31,1,0
59360,53,6794,53,allow,429,116,313,2,31,1,1
49676,53,60800,53,allow,322,110,212,4,31,2,2
55897,53,62688,53,allow,711,87,624,2,31,1,1
50280,53,20623,53,allow,916,86,830,2,31,1,1
51887,445,0,0,drop,70,70,0,1,0,1,0
51885,445,0,0,drop,70,70,0,1,0,1,0
51882,445,0,0,drop,70,70,0,1,0,1,0
63646,445,0,0,drop,66,66,0,1,0,1,0
63644,445,0,0,drop,66,66,0,1,0,1,0
63645,445,0,0,drop,66,66,0,1,0,1,0
63647,445,0,0,drop,66,66,0,1,0,1,0
63643,445,0,0,drop,66,66,0,1,0,1,0
63642,445,0,0,drop,66,66,0,1,0,1,0
63649,445,0,0,drop,66,66,0,1,0,1,0
63641,445,0,0,drop,66,66,0,1,0,1,0
63475,445,0,0,drop,70,70,0,1,0,1,0
51880,445,0,0,drop,70,70,0,1,0,1,0
51879,445,0,0,drop,70,70,0,1,0,1,0
51877,445,0,0,drop,70,70,0,1,0,1,0
51866,445,0,0,drop,70,70,0,1,0,1,0
63471,445,0,0,drop,70,70,0,1,0,1,0
63628,445,0,0,drop,66,66,0,1,0,1,0
63627,445,0,0,drop,66,66,0,1,0,1,0
63626,445,0,0,drop,66,66,0,1,0,1,0
60885,443,31610,443,allow,887,542,345,11,15,6,5
55868,53,41641,53,allow,177,94,83,2,29,1,1
56670,80,44971,80,allow,234,234,0,4,12,4,0
58894,443,4103,443,allow,152,86,66,2,4,1,1
56303,53,63690,53,allow,177,94,83,2,29,1,1
49704,80,54649,80,allow,2058,589,1469,10,44,6,4
64913,53,33116,53,allow,194,102,92,2,30,1,1
55193,53,27254,53,allow,177,94,83,2,30,1,1
48861,53,40652,53,allow,164,78,86,2,30,1,1
52246,443,52246,443,allow,1615,941,674,15,21,7,8
64787,53,13133,53,allow,299,101,198,4,34,2,2
49386,53,12060,53,allow,332,102,230,2,30,1,1
49420,53,37701,53,allow,185,102,83,2,30,1,1
58140,53,58140,53,allow,262,106,156,2,34,1,1
63201,53,63201,53,allow,262,106,156,2,32,1,1
57204,443,62645,443,allow,340,140,200,6,25,3,3
49925,53,18861,53,allow,953,215,738,6,46,3,3
55193,53,2306,53,allow,177,94,83,2,30,1,1
64636,53,4639,53,allow,325,102,223,2,30,1,1
65336,53,64946,53,allow,275,94,181,2,30,1,1
49367,53,52320,53,allow,718,94,624,2,30,1,1
64528,53,42814,53,allow,353,118,235,2,30,1,1
54197,443,61116,443,allow,190,70,120,4,15,2,2
38822,80,14880,80,allow,810,413,397,7,19,5,2
57444,53,13400,53,allow,198,94,104,2,29,1,1
49767,53,3628,53,allow,177,94,83,2,29,1,1
50616,53,45129,53,allow,177,94,83,2,30,1,1
64913,53,23262,53,allow,194,102,92,2,29,1,1
55222,53,59150,53,allow,1210,950,260,2,29,1,1
64773,53,48477,53,allow,328,150,178,2,30,1,1
42318,53,4117,53,allow,164,78,86,2,30,1,1
65117,53,25899,53,allow,230,94,136,2,30,1,1
44757,53,59516,53,allow,179,86,93,2,30,1,1
49666,53,7037,53,allow,325,126,199,2,30,1,1
64750,53,14070,53,allow,276,102,174,2,30,1,1
41269,443,9096,443,allow,78,78,0,1,5,1,0
49490,53,51051,53,allow,246,94,152,2,30,1,1
50358,80,6074,80,allow,306,180,126,6,25,4,2
46193,53,56530,53,allow,311,86,225,2,30,1,1
43539,53,26606,53,allow,168,78,90,2,30,1,1
38700,53,38476,53,allow,164,78,86,2,30,1,1
64173,53,16220,53,allow,210,94,116,2,30,1,1
50654,123,28946,123,allow,184,94,90,2,30,1,1
50616,53,27498,53,allow,177,94,83,2,30,1,1
55026,53,14938,53,allow,177,94,83,2,30,1,1
57044,53,54820,53,allow,177,94,83,2,31,1,1
57169,53,45860,53,allow,177,94,83,2,31,1,1
49453,53,64414,53,allow,227,110,117,2,31,1,1
53722,443,28671,443,allow,70,70,0,1,5,1,0
50379,80,42640,80,allow,1083,653,430,8,16,5,3
64123,443,56759,443,allow,1411,852,559,13,25,7,6
65451,53,3084,53,allow,728,234,494,6,67,3,3
55026,53,50435,53,allow,177,94,83,2,30,1,1
57306,53,57306,53,allow,220,90,130,2,30,1,1
57452,53,57452,53,allow,203,82,121,2,30,1,1
63462,445,0,0,drop,70,70,0,1,0,1,0
63459,445,0,0,drop,70,70,0,1,0,1,0
63460,445,0,0,drop,70,70,0,1,0,1,0
63458,445,0,0,drop,70,70,0,1,0,1,0
63455,445,0,0,drop,70,70,0,1,0,1,0
51863,445,0,0,drop,70,70,0,1,0,1,0
51861,445,0,0,drop,70,70,0,1,0,1,0
51858,445,0,0,drop,70,70,0,1,0,1,0
51852,445,0,0,drop,70,70,0,1,0,1,0
63449,445,0,0,drop,70,70,0,1,0,1,0
51845,445,0,0,drop,70,70,0,1,0,1,0
51843,445,0,0,drop,70,70,0,1,0,1,0
51841,445,0,0,drop,70,70,0,1,0,1,0
63441,445,0,0,drop,70,70,0,1,0,1,0
63438,445,0,0,drop,70,70,0,1,0,1,0
63615,445,0,0,drop,66,66,0,1,0,1,0
63435,445,0,0,drop,70,70,0,1,0,1,0
63433,445,0,0,drop,70,70,0,1,0,1,0
51837,445,0,0,drop,70,70,0,1,0,1,0
51836,445,0,0,drop,70,70,0,1,0,1,0
63429,445,0,0,drop,70,70,0,1,0,1,0
63599,445,0,0,drop,66,66,0,1,0,1,0
63598,445,0,0,drop,66,66,0,1,0,1,0
63428,445,0,0,drop,70,70,0,1,0,1,0
51815,445,0,0,drop,70,70,0,1,0,1,0
51825,445,0,0,drop,70,70,0,1,0,1,0
51823,445,0,0,drop,70,70,0,1,0,1,0
51822,445,0,0,drop,70,70,0,1,0,1,0
63423,445,0,0,drop,70,70,0,1,0,1,0
63596,445,0,0,drop,66,66,0,1,0,1,0
63586,445,0,0,drop,66,66,0,1,0,1,0
63590,445,0,0,drop,66,66,0,1,0,1,0
63585,445,0,0,drop,66,66,0,1,0,1,0
63579,445,0,0,drop,66,66,0,1,0,1,0
63588,445,0,0,drop,66,66,0,1,0,1,0
63582,445,0,0,drop,66,66,0,1,0,1,0
63581,445,0,0,drop,66,66,0,1,0,1,0
51811,445,0,0,drop,70,70,0,1,0,1,0
51806,445,0,0,drop,70,70,0,1,0,1,0
51805,445,0,0,drop,70,70,0,1,0,1,0
51803,445,0,0,drop,70,70,0,1,0,1,0
63410,445,0,0,drop,70,70,0,1,0,1,0
56800,23,0,0,deny,60,60,0,1,0,1,0
63407,445,0,0,drop,70,70,0,1,0,1,0
51800,445,0,0,drop,70,70,0,1,0,1,0
51799,445,0,0,drop,70,70,0,1,0,1,0
51798,445,0,0,drop,70,70,0,1,0,1,0
63573,445,0,0,drop,66,66,0,1,0,1,0
51794,445,0,0,drop,70,70,0,1,0,1,0
63569,445,0,0,drop,66,66,0,1,0,1,0
63568,445,0,0,drop,66,66,0,1,0,1,0
63566,445,0,0,drop,66,66,0,1,0,1,0
63564,445,0,0,drop,66,66,0,1,0,1,0
63403,445,0,0,drop,70,70,0,1,0,1,0
63401,445,0,0,drop,70,70,0,1,0,1,0
63399,445,0,0,drop,70,70,0,1,0,1,0
51789,445,0,0,drop,70,70,0,1,0,1,0
51783,445,0,0,drop,70,70,0,1,0,1,0
51777,445,0,0,drop,70,70,0,1,0,1,0
63553,445,0,0,drop,66,66,0,1,0,1,0
63392,445,0,0,drop,70,70,0,1,0,1,0
63390,445,0,0,drop,70,70,0,1,0,1,0
63546,445,0,0,drop,66,66,0,1,0,1,0
51767,445,0,0,drop,70,70,0,1,0,1,0
63389,445,0,0,drop,70,70,0,1,0,1,0
49676,53,19443,53,allow,216,110,106,2,30,1,1
57001,53,10240,53,allow,170,87,83,2,31,1,1
49994,443,47759,443,allow,352,292,60,2,5,1,1
52245,443,52245,443,allow,1615,941,674,15,21,7,8
50387,443,3636,443,allow,2227,1018,1209,17,16,8,9
50354,80,47927,80,allow,306,180,126,6,25,4,2
54516,53,54516,53,allow,235,90,145,2,33,1,1
55454,53,60300,53,allow,168,86,82,2,33,1,1
50604,80,50604,80,allow,1707,1007,700,11,21,6,5
49721,80,41494,80,allow,340,140,200,6,15,3,3
56225,53,16256,53,allow,188,96,92,2,30,1,1
56553,53,20095,53,allow,701,88,613,2,30,1,1
57169,53,44732,53,allow,170,87,83,2,30,1,1
56879,53,15909,53,allow,780,93,687,2,31,1,1
65528,53,47715,53,allow,217,75,142,4,30,2,2
55065,53,19490,53,allow,711,87,624,2,30,1,1
56181,53,54189,53,allow,764,99,665,2,31,1,1
49485,53,58732,53,allow,752,93,659,2,31,1,1
56728,53,40582,53,allow,744,95,649,2,31,1,1
55036,53,30063,53,allow,733,93,640,2,31,1,1
50038,53,5932,53,allow,170,87,83,2,31,1,1
64877,53,24917,53,allow,182,93,89,2,31,1,1
55214,53,41945,53,allow,711,87,624,2,31,1,1
57246,53,12706,53,allow,752,93,659,2,31,1,1
64931,53,32751,53,allow,174,89,85,2,31,1,1
57109,53,44560,53,allow,711,87,624,2,31,1,1
50645,53,43858,53,allow,256,93,163,2,31,1,1
55318,53,46114,53,allow,711,87,624,2,31,1,1
63388,445,0,0,drop,70,70,0,1,0,1,0
63387,445,0,0,drop,70,70,0,1,0,1,0
63384,445,0,0,drop,70,70,0,1,0,1,0
63385,445,0,0,drop,70,70,0,1,0,1,0
63543,445,0,0,drop,66,66,0,1,0,1,0
63369,445,0,0,drop,70,70,0,1,0,1,0
63368,445,0,0,drop,70,70,0,1,0,1,0
44993,53,47761,53,allow,168,78,90,2,30,1,1
57136,53,53104,53,allow,177,94,83,2,30,1,1
65513,53,25094,53,allow,178,94,84,2,30,1,1
63362,445,0,0,drop,70,70,0,1,0,1,0
63536,445,0,0,drop,66,66,0,1,0,1,0
63359,445,0,0,drop,70,70,0,1,0,1,0
63358,445,0,0,drop,70,70,0,1,0,1,0
63527,445,0,0,drop,66,66,0,1,0,1,0
51759,445,0,0,drop,70,70,0,1,0,1,0
51754,445,0,0,drop,70,70,0,1,0,1,0
51755,445,0,0,drop,70,70,0,1,0,1,0
63347,445,0,0,drop,70,70,0,1,0,1,0
63517,445,0,0,drop,66,66,0,1,0,1,0
63518,445,0,0,drop,66,66,0,1,0,1,0
63515,445,0,0,drop,66,66,0,1,0,1,0
63520,445,0,0,drop,66,66,0,1,0,1,0
63513,445,0,0,drop,66,66,0,1,0,1,0
63514,445,0,0,drop,66,66,0,1,0,1,0
63519,445,0,0,drop,66,66,0,1,0,1,0
63512,445,0,0,drop,66,66,0,1,0,1,0
63342,445,0,0,drop,70,70,0,1,0,1,0
51752,445,0,0,drop,70,70,0,1,0,1,0
51753,445,0,0,drop,70,70,0,1,0,1,0
51751,445,0,0,drop,70,70,0,1,0,1,0
51738,445,0,0,drop,70,70,0,1,0,1,0
63333,445,0,0,drop,70,70,0,1,0,1,0
63334,445,0,0,drop,70,70,0,1,0,1,0
63332,445,0,0,drop,70,70,0,1,0,1,0
44293,23,0,0,deny,60,60,0,1,0,1,0
44797,53,29838,53,allow,179,86,93,2,29,1,1
50102,53,50102,53,allow,216,90,126,2,29,1,1
57100,53,13292,53,allow,402,118,284,2,30,1,1
56733,80,32206,80,allow,214,140,74,4,25,3,1
56225,53,65429,53,allow,194,102,92,2,29,1,1
57044,53,13631,53,allow,177,94,83,2,29,1,1
55193,53,10853,53,allow,177,94,83,2,29,1,1
57169,53,49234,53,allow,177,94,83,2,30,1,1
39735,53,51086,53,allow,223,78,145,2,30,1,1
44313,53,51644,53,allow,199,94,105,2,30,1,1
64967,53,44002,53,allow,751,102,649,2,30,1,1
57017,53,22107,53,allow,177,94,83,2,30,1,1
49665,53,61260,53,allow,361,118,243,4,33,2,2
65513,53,49907,53,allow,186,102,84,2,30,1,1
50820,80,16954,80,allow,550,476,74,6,15,5,1
46750,443,52499,443,allow,350,210,140,6,25,4,2
49717,53,61877,53,allow,781,94,687,2,30,1,1
50822,80,16918,80,allow,550,476,74,6,15,5,1
49715,53,2852,53,allow,734,94,640,2,30,1,1
57169,53,55485,53,allow,177,94,83,2,30,1,1
54598,53,30660,53,allow,168,78,90,2,30,1,1
54953,53,34688,53,allow,263,94,169,2,30,1,1
49676,53,26255,53,allow,216,110,106,2,30,1,1
57136,53,3723,53,allow,177,94,83,2,30,1,1
49782,443,53470,443,allow,70,70,0,2,7,2,0
65378,53,29573,53,allow,476,121,355,4,40,2,2
50603,80,50603,80,allow,1706,1006,700,11,21,6,5
56225,53,8973,53,allow,194,102,92,2,29,1,1
43861,123,6210,123,allow,184,94,90,2,29,1,1
49800,53,35452,53,allow,485,93,392,4,48,2,2
64040,53,17235,53,allow,226,102,124,2,29,1,1
40495,53,8395,53,allow,168,78,90,2,29,1,1
54998,53,24555,53,allow,168,78,90,2,30,1,1
65110,53,31746,53,allow,406,142,264,2,30,1,1
41153,53,8565,53,allow,168,78,90,2,30,1,1
64950,53,51754,53,allow,728,102,626,2,30,1,1
65314,53,39947,53,allow,195,102,93,2,30,1,1
50130,53,10528,53,allow,183,94,89,2,30,1,1
56703,53,62070,53,allow,183,94,89,2,31,1,1
49858,53,41757,53,allow,177,94,83,2,30,1,1
47135,53,52086,53,allow,199,94,105,2,30,1,1
56367,53,30541,53,allow,194,102,92,2,30,1,1
65139,53,58108,53,allow,754,94,660,2,31,1,1
65386,53,49656,53,allow,197,102,95,2,33,1,1
62488,443,33482,443,allow,1326,876,450,11,32,6,5
36815,443,48632,443,allow,416,210,206,7,29,4,3
65314,53,31001,53,allow,195,102,93,2,30,1,1
51081,53,49643,53,allow,168,78,90,2,30,1,1
57017,53,16260,53,allow,177,94,83,2,30,1,1
57027,53,59688,53,allow,177,94,83,2,31,1,1
51989,80,9142,80,allow,1344,899,445,8,15,6,2
50477,443,60268,443,allow,130,70,60,2,15,1,1
51756,53,33754,53,allow,168,78,90,2,30,1,1
49858,53,34344,53,allow,177,94,83,2,30,1,1
49657,53,23289,53,allow,198,94,104,2,30,1,1
57001,53,43521,53,allow,177,94,83,2,30,1,1
57027,53,37270,53,allow,177,94,83,2,30,1,1
46500,443,37783,443,allow,494,280,214,8,29,5,3
57115,53,44854,53,allow,728,102,626,2,30,1,1
57001,53,25113,53,allow,177,94,83,2,30,1,1
50499,53,23624,53,allow,718,94,624,2,30,1,1
52434,53,49925,53,allow,183,86,97,2,30,1,1
65528,53,44314,53,allow,168,86,82,2,30,1,1
50091,53,1529,53,allow,172,94,78,2,31,1,1
50038,53,46782,53,allow,177,94,83,2,31,1,1
49676,53,4887,53,allow,216,110,106,2,30,1,1
43366,53,27594,53,allow,168,78,90,2,30,1,1
50038,53,24889,53,allow,177,94,83,2,30,1,1
57387,53,49331,53,allow,178,94,84,2,30,1,1
42903,53,55150,53,allow,168,78,90,2,30,1,1
57001,53,51576,53,allow,177,94,83,2,31,1,1
65367,53,17484,53,allow,271,94,177,2,30,1,1
64741,53,19831,53,allow,420,110,310,2,30,1,1
59218,53,41217,53,allow,511,126,385,2,31,1,1
65528,53,30567,53,allow,168,86,82,2,31,1,1
45755,443,42960,443,allow,1625,1038,587,14,26,8,6
37564,443,37233,443,allow,1386,924,462,12,30,7,5
37566,443,61835,443,allow,1386,924,462,12,30,7,5
63500,445,0,0,drop,66,66,0,1,0,1,0
63498,445,0,0,drop,66,66,0,1,0,1,0
63497,445,0,0,drop,66,66,0,1,0,1,0
63328,445,0,0,drop,70,70,0,1,0,1,0
63326,445,0,0,drop,70,70,0,1,0,1,0
53389,23,0,0,deny,60,60,0,1,0,1,0
51734,445,0,0,drop,70,70,0,1,0,1,0
51732,445,0,0,drop,70,70,0,1,0,1,0
51727,445,0,0,drop,70,70,0,1,0,1,0
51724,445,0,0,drop,70,70,0,1,0,1,0
63320,445,0,0,drop,70,70,0,1,0,1,0
63313,445,0,0,drop,70,70,0,1,0,1,0
63310,445,0,0,drop,70,70,0,1,0,1,0
51717,445,0,0,drop,70,70,0,1,0,1,0
51716,445,0,0,drop,70,70,0,1,0,1,0
51711,445,0,0,drop,70,70,0,1,0,1,0
63488,445,0,0,drop,66,66,0,1,0,1,0
63307,445,0,0,drop,70,70,0,1,0,1,0
63305,445,0,0,drop,70,70,0,1,0,1,0
51709,445,0,0,drop,70,70,0,1,0,1,0
63301,445,0,0,drop,70,70,0,1,0,1,0
51708,445,0,0,drop,70,70,0,1,0,1,0
63300,445,0,0,drop,70,70,0,1,0,1,0
63472,445,0,0,drop,66,66,0,1,0,1,0
63468,445,0,0,drop,66,66,0,1,0,1,0
51695,445,0,0,drop,70,70,0,1,0,1,0
51692,445,0,0,drop,70,70,0,1,0,1,0
51691,445,0,0,drop,70,70,0,1,0,1,0
51686,445,0,0,drop,70,70,0,1,0,1,0
63295,445,0,0,drop,70,70,0,1,0,1,0
63467,445,0,0,drop,66,66,0,1,0,1,0
63457,445,0,0,drop,66,66,0,1,0,1,0
63459,445,0,0,drop,66,66,0,1,0,1,0
63455,445,0,0,drop,66,66,0,1,0,1,0
63453,445,0,0,drop,66,66,0,1,0,1,0
63452,445,0,0,drop,66,66,0,1,0,1,0
63450,445,0,0,drop,66,66,0,1,0,1,0
51684,445,0,0,drop,70,70,0,1,0,1,0
51678,445,0,0,drop,70,70,0,1,0,1,0
51676,445,0,0,drop,70,70,0,1,0,1,0
51675,445,0,0,drop,70,70,0,1,0,1,0
63282,445,0,0,drop,70,70,0,1,0,1,0
63279,445,0,0,drop,70,70,0,1,0,1,0
51674,445,0,0,drop,70,70,0,1,0,1,0
51672,445,0,0,drop,70,70,0,1,0,1,0
51669,445,0,0,drop,70,70,0,1,0,1,0
63442,445,0,0,drop,66,66,0,1,0,1,0
51666,445,0,0,drop,70,70,0,1,0,1,0
63440,445,0,0,drop,66,66,0,1,0,1,0
63438,445,0,0,drop,66,66,0,1,0,1,0
63437,445,0,0,drop,66,66,0,1,0,1,0
63274,445,0,0,drop,70,70,0,1,0,1,0
63273,445,0,0,drop,70,70,0,1,0,1,0
63436,445,0,0,drop,66,66,0,1,0,1,0
63271,445,0,0,drop,70,70,0,1,0,1,0
51663,445,0,0,drop,70,70,0,1,0,1,0
56367,53,52598,53,allow,188,96,92,2,31,1,1
49601,53,48706,53,allow,762,97,665,2,30,1,1
55892,53,8349,53,allow,182,93,89,2,30,1,1
57809,53,57809,53,allow,213,79,134,2,33,1,1
41850,53,41850,53,allow,257,101,156,2,33,1,1
55388,53,60267,53,allow,170,87,83,2,31,1,1
53918,53,0,0,allow,222,82,140,2,30,1,1
57196,53,50893,53,allow,182,93,89,2,30,1,1
53512,443,1529,443,allow,1625,1038,587,14,34,8,6
58463,53,64645,53,allow,380,88,292,2,30,1,1
53513,443,7067,443,allow,1625,1038,587,14,34,8,6
53516,443,26441,443,allow,560,280,280,9,34,5,4
41252,53,41252,53,allow,398,255,143,3,32,2,1
64877,53,58345,53,allow,182,93,89,2,30,1,1
46441,443,33380,443,allow,416,210,206,7,28,4,3
56312,53,62143,53,allow,711,87,624,2,30,1,1
56615,53,58132,53,allow,170,87,83,2,30,1,1
57027,53,52973,53,allow,170,87,83,2,30,1,1
50619,53,43137,53,allow,815,95,720,2,30,1,1
63440,53,0,0,allow,206,95,111,2,30,1,1
56088,53,23327,53,allow,256,93,163,2,31,1,1
55179,53,34684,53,allow,182,93,89,2,31,1,1
50176,53,47477,53,allow,768,99,669,2,31,1,1
55349,53,40115,53,allow,701,88,613,2,31,1,1
51656,445,0,0,drop,70,70,0,1,0,1,0
51652,445,0,0,drop,70,70,0,1,0,1,0
63264,445,0,0,drop,70,70,0,1,0,1,0
63423,445,0,0,drop,66,66,0,1,0,1,0
63262,445,0,0,drop,70,70,0,1,0,1,0
63261,445,0,0,drop,70,70,0,1,0,1,0
63260,445,0,0,drop,70,70,0,1,0,1,0
63416,445,0,0,drop,66,66,0,1,0,1,0
63259,445,0,0,drop,70,70,0,1,0,1,0
51638,445,0,0,drop,70,70,0,1,0,1,0
63253,445,0,0,drop,70,70,0,1,0,1,0
63254,445,0,0,drop,70,70,0,1,0,1,0
63414,445,0,0,drop,66,66,0,1,0,1,0
63239,445,0,0,drop,70,70,0,1,0,1,0
63237,445,0,0,drop,70,70,0,1,0,1,0
63234,445,0,0,drop,70,70,0,1,0,1,0
63229,445,0,0,drop,70,70,0,1,0,1,0
56367,53,38735,53,allow,194,102,92,2,30,1,1
50038,53,65055,53,allow,286,87,199,4,59,2,2
54762,53,0,0,allow,86,86,0,1,30,1,0
45754,443,17919,443,allow,1625,1038,587,14,25,8,6
41821,80,46291,80,allow,1056,362,694,10,49,6,4
64877,53,56552,53,allow,183,94,89,2,29,1,1
41612,80,44236,80,allow,2016,552,1464,8,16,5,3
56615,53,39007,53,allow,177,94,83,2,29,1,1
57111,53,59340,53,allow,199,94,105,2,30,1,1
56669,80,21282,80,allow,234,234,0,4,12,4,0
64723,53,45766,53,allow,329,118,211,2,30,1,1
38360,53,56266,53,allow,168,78,90,2,30,1,1
57027,53,33808,53,allow,177,94,83,2,30,1,1
55388,53,1153,53,allow,177,94,83,2,30,1,1
56747,53,48027,53,allow,226,110,116,2,30,1,1
56492,53,39207,53,allow,177,94,83,2,30,1,1
56747,53,24796,53,allow,172,94,78,2,30,1,1
55171,53,4183,53,allow,79,79,0,2,34,2,0
64009,80,25096,80,allow,314,192,122,6,15,4,2
56703,53,54677,53,allow,183,94,89,2,30,1,1
55258,53,4040,53,allow,177,94,83,2,30,1,1
56615,53,33953,53,allow,177,94,83,2,30,1,1
64443,53,23166,53,allow,878,184,694,6,71,3,3
57235,53,31902,53,allow,210,102,108,2,30,1,1
55179,53,18189,53,allow,183,94,89,2,30,1,1
56492,53,3429,53,allow,177,94,83,2,30,1,1
63989,53,19416,53,allow,259,110,149,2,30,1,1
65528,53,21468,53,allow,168,86,82,2,30,1,1
55937,53,13424,53,allow,177,94,83,2,30,1,1
65480,53,23239,53,allow,211,102,109,2,30,1,1
65263,53,53101,53,allow,232,110,122,2,30,1,1
56747,53,24392,53,allow,172,94,78,2,30,1,1
49935,443,48016,443,allow,366,180,186,7,28,4,3
49631,53,64330,53,allow,198,102,96,2,33,1,1
65422,53,8384,53,allow,448,84,364,4,54,2,2
45727,443,38522,443,allow,1625,1038,587,14,29,8,6
41820,80,9493,80,allow,1056,362,694,10,49,6,4
38142,53,38142,53,allow,404,259,145,3,32,2,1
59779,443,11374,443,allow,142,142,0,1,5,1,0
58420,53,57046,53,allow,351,78,273,2,29,1,1
56615,53,15642,53,allow,177,94,83,2,29,1,1
50130,53,58704,53,allow,183,94,89,2,29,1,1
50130,53,12691,53,allow,183,94,89,2,29,1,1
49008,53,13913,53,allow,168,78,90,2,29,1,1
57387,53,39674,53,allow,178,94,84,2,30,1,1
50091,53,50600,53,allow,164,86,78,2,30,1,1
64927,53,2368,53,allow,315,110,205,2,30,1,1
55388,53,28391,53,allow,177,94,83,2,30,1,1
55258,53,48782,53,allow,177,94,83,2,30,1,1
64938,53,18539,53,allow,210,102,108,2,30,1,1
49545,53,14108,53,allow,195,102,93,2,30,1,1
57196,53,25390,53,allow,183,94,89,2,30,1,1
64249,53,23999,53,allow,181,94,87,2,33,1,1
56513,53,54850,53,allow,215,102,113,2,30,1,1
56703,53,38555,53,allow,183,94,89,2,30,1,1
55840,53,36401,53,allow,199,94,105,2,30,1,1
56559,53,54013,53,allow,177,94,83,2,30,1,1
41554,53,50330,53,allow,199,94,105,2,30,1,1
59773,53,11146,53,allow,218,78,140,2,31,1,1
56134,53,62024,53,allow,183,94,89,2,31,1,1
65455,53,29477,53,allow,564,108,456,4,50,2,2
50635,53,9293,53,allow,199,94,105,2,30,1,1
43818,53,4303,53,allow,168,78,90,2,30,1,1
64931,53,5623,53,allow,179,94,85,2,30,1,1
56588,53,8372,53,allow,197,102,95,2,30,1,1
56559,53,63676,53,allow,177,94,83,2,30,1,1
65390,53,64921,53,allow,387,134,253,2,30,1,1
64023,53,29476,53,allow,179,94,85,2,30,1,1
65427,53,2149,53,allow,238,94,144,2,30,1,1
55759,53,49971,53,allow,177,94,83,2,30,1,1
64707,53,25293,53,allow,216,102,114,2,30,1,1
50077,80,42513,80,allow,804,380,424,9,15,5,4
55937,53,36384,53,allow,177,94,83,2,30,1,1
55643,53,52917,53,allow,183,94,89,2,31,1,1
55179,53,17808,53,allow,183,94,89,2,30,1,1
63228,445,0,0,drop,70,70,0,1,0,1,0
63407,445,0,0,drop,66,66,0,1,0,1,0
63404,445,0,0,drop,66,66,0,1,0,1,0
63217,445,0,0,drop,70,70,0,1,0,1,0
51630,445,0,0,drop,70,70,0,1,0,1,0
51626,445,0,0,drop,70,70,0,1,0,1,0
51627,445,0,0,drop,70,70,0,1,0,1,0
63387,445,0,0,drop,66,66,0,1,0,1,0
63389,445,0,0,drop,66,66,0,1,0,1,0
63391,445,0,0,drop,66,66,0,1,0,1,0
63390,445,0,0,drop,66,66,0,1,0,1,0
63388,445,0,0,drop,66,66,0,1,0,1,0
63385,445,0,0,drop,66,66,0,1,0,1,0
63386,445,0,0,drop,66,66,0,1,0,1,0
63384,445,0,0,drop,66,66,0,1,0,1,0
63213,445,0,0,drop,70,70,0,1,0,1,0
63203,445,0,0,drop,70,70,0,1,0,1,0
63204,445,0,0,drop,70,70,0,1,0,1,0
51621,445,0,0,drop,70,70,0,1,0,1,0
51622,445,0,0,drop,70,70,0,1,0,1,0
51609,445,0,0,drop,70,70,0,1,0,1,0
51610,445,0,0,drop,70,70,0,1,0,1,0
63200,445,0,0,drop,70,70,0,1,0,1,0
63196,445,0,0,drop,70,70,0,1,0,1,0
63369,445,0,0,drop,66,66,0,1,0,1,0
63370,445,0,0,drop,66,66,0,1,0,1,0
63368,445,0,0,drop,66,66,0,1,0,1,0
59476,23,0,0,deny,60,60,0,1,0,1,0
51607,445,0,0,drop,70,70,0,1,0,1,0
51604,445,0,0,drop,70,70,0,1,0,1,0
51600,445,0,0,drop,70,70,0,1,0,1,0
51597,445,0,0,drop,70,70,0,1,0,1,0
63191,445,0,0,drop,70,70,0,1,0,1,0
63183,445,0,0,drop,70,70,0,1,0,1,0
63182,445,0,0,drop,70,70,0,1,0,1,0
51588,445,0,0,drop,70,70,0,1,0,1,0
51587,445,0,0,drop,70,70,0,1,0,1,0
51584,445,0,0,drop,70,70,0,1,0,1,0
63176,445,0,0,drop,70,70,0,1,0,1,0
63357,445,0,0,drop,66,66,0,1,0,1,0
63175,445,0,0,drop,70,70,0,1,0,1,0
63171,445,0,0,drop,70,70,0,1,0,1,0
51581,445,0,0,drop,70,70,0,1,0,1,0
51579,445,0,0,drop,70,70,0,1,0,1,0
63170,445,0,0,drop,70,70,0,1,0,1,0
63339,445,0,0,drop,66,66,0,1,0,1,0
63341,445,0,0,drop,66,66,0,1,0,1,0
63165,445,0,0,drop,70,70,0,1,0,1,0
51569,445,0,0,drop,70,70,0,1,0,1,0
51567,445,0,0,drop,70,70,0,1,0,1,0
51566,445,0,0,drop,70,70,0,1,0,1,0
51560,445,0,0,drop,70,70,0,1,0,1,0
63336,445,0,0,drop,66,66,0,1,0,1,0
63325,445,0,0,drop,66,66,0,1,0,1,0
63331,445,0,0,drop,66,66,0,1,0,1,0
63330,445,0,0,drop,66,66,0,1,0,1,0
63328,445,0,0,drop,66,66,0,1,0,1,0
63320,445,0,0,drop,66,66,0,1,0,1,0
63329,445,0,0,drop,66,66,0,1,0,1,0
63326,445,0,0,drop,66,66,0,1,0,1,0
51554,445,0,0,drop,70,70,0,1,0,1,0
51551,445,0,0,drop,70,70,0,1,0,1,0
51548,445,0,0,drop,70,70,0,1,0,1,0
51547,445,0,0,drop,70,70,0,1,0,1,0
63152,445,0,0,drop,70,70,0,1,0,1,0
63149,445,0,0,drop,70,70,0,1,0,1,0
51543,445,0,0,drop,70,70,0,1,0,1,0
51544,445,0,0,drop,70,70,0,1,0,1,0
51540,445,0,0,drop,70,70,0,1,0,1,0
63316,445,0,0,drop,66,66,0,1,0,1,0
57702,53,57702,53,allow,398,255,143,3,32,2,1
56149,53,12166,53,allow,174,89,85,2,30,1,1
56902,53,41488,53,allow,768,99,669,2,30,1,1
55609,53,45313,53,allow,172,88,84,2,30,1,1
59923,53,59923,53,allow,365,233,132,3,33,2,1
50134,53,55373,53,allow,748,106,642,2,30,1,1
56803,53,43368,53,allow,182,93,89,2,30,1,1
49718,53,39555,53,allow,793,101,692,2,30,1,1
56503,53,37647,53,allow,578,286,292,9,15,5,4
56556,53,39317,53,allow,762,97,665,2,30,1,1
64023,53,59287,53,allow,174,89,85,2,30,1,1
64628,53,26706,53,allow,753,93,660,2,30,1,1
56354,53,25392,53,allow,753,93,660,2,30,1,1
55156,53,48355,53,allow,256,87,169,4,37,2,2
56588,53,28936,53,allow,194,99,95,2,30,1,1
52385,53,0,0,allow,138,69,69,2,30,1,1
50108,53,31749,53,allow,174,89,85,2,30,1,1
56668,53,61467,53,allow,701,88,613,2,30,1,1
64950,53,8334,53,allow,186,95,91,2,31,1,1
52079,1024,34017,1024,allow,70,70,0,2,8,2,0
55759,53,57416,53,allow,170,87,83,2,30,1,1
50552,53,56537,53,allow,710,89,621,2,30,1,1
56926,53,27418,53,allow,711,87,624,2,30,1,1
55376,53,48930,53,allow,789,110,679,2,31,1,1
56375,53,7555,53,allow,216,110,106,2,31,1,1
55489,53,34902,53,allow,748,106,642,2,31,1,1
56373,53,1027,53,allow,181,98,83,2,31,1,1
49313,53,6801,53,allow,295,101,194,4,31,2,2
64787,53,4166,53,allow,174,89,85,2,31,1,1
56185,53,24061,53,allow,168,86,82,2,31,1,1
55058,53,41146,53,allow,216,110,106,2,31,1,1
56960,53,22344,53,allow,192,98,94,2,31,1,1
56272,53,26836,53,allow,186,95,91,2,31,1,1
64668,53,32390,53,allow,772,103,669,2,31,1,1
57119,53,0,0,allow,318,95,223,2,31,1,1
50504,53,13475,53,allow,168,86,82,2,31,1,1
56260,53,39887,53,allow,170,87,83,2,31,1,1
64787,53,24820,53,allow,740,93,647,2,31,1,1
55251,53,62666,53,allow,208,106,102,2,31,1,1
54959,53,17105,53,allow,206,105,101,2,31,1,1
57063,53,16093,53,allow,186,95,91,2,31,1,1
55829,53,4732,53,allow,208,106,102,2,31,1,1
64551,53,55757,53,allow,755,94,661,2,31,1,1
56375,53,32161,53,allow,216,110,106,2,31,1,1
55190,53,7214,53,allow,733,86,647,2,31,1,1
57083,53,56856,53,allow,755,94,661,2,31,1,1
63090,53,11762,53,allow,510,164,346,2,31,1,1
65354,53,6099,53,allow,168,86,82,2,31,1,1
56762,53,35908,53,allow,168,86,82,2,31,1,1
56810,53,54787,53,allow,170,87,83,2,31,1,1
51538,445,0,0,drop,70,70,0,1,0,1,0
63145,445,0,0,drop,70,70,0,1,0,1,0
63311,445,0,0,drop,66,66,0,1,0,1,0
63143,445,0,0,drop,70,70,0,1,0,1,0
63308,445,0,0,drop,66,66,0,1,0,1,0
63310,445,0,0,drop,66,66,0,1,0,1,0
63141,445,0,0,drop,70,70,0,1,0,1,0
51567,443,62736,443,allow,400,70,330,7,17,2,5
55156,53,47566,53,allow,256,87,169,4,37,2,2
63307,445,0,0,drop,66,66,0,1,0,1,0
51532,445,0,0,drop,70,70,0,1,0,1,0
58193,23,0,0,deny,60,60,0,1,0,1,0
51522,445,0,0,drop,70,70,0,1,0,1,0
51525,445,0,0,drop,70,70,0,1,0,1,0
63134,445,0,0,drop,70,70,0,1,0,1,0
63132,445,0,0,drop,70,70,0,1,0,1,0
63294,445,0,0,drop,66,66,0,1,0,1,0
63131,445,0,0,drop,70,70,0,1,0,1,0
63130,445,0,0,drop,70,70,0,1,0,1,0
63129,445,0,0,drop,70,70,0,1,0,1,0
64963,53,58073,53,allow,453,186,267,6,30,3,3
49791,53,37520,53,allow,412,90,322,4,34,2,2
55388,53,11740,53,allow,292,87,205,4,42,2,2
56803,53,52529,53,allow,183,94,89,2,30,1,1
57264,53,53973,53,allow,197,102,95,2,30,1,1
50204,80,48586,80,allow,1221,781,440,11,14,6,5
64735,53,3296,53,allow,730,102,628,2,30,1,1
55156,53,28197,53,allow,256,87,169,4,36,2,2
61066,53,0,0,allow,283,78,205,2,29,1,1
55156,53,47092,53,allow,256,87,169,4,36,2,2
61230,53,16263,53,allow,177,94,83,2,29,1,1
64069,53,35417,53,allow,183,86,97,2,29,1,1
52413,53,24477,53,allow,168,78,90,2,30,1,1
53801,53,14956,53,allow,167,78,89,2,30,1,1
58173,993,62958,993,allow,430,60,370,7,24,2,5
49376,53,15412,53,allow,391,134,257,2,30,1,1
55641,53,43709,53,allow,70,70,0,1,30,1,0
49686,53,47017,53,allow,183,94,89,2,30,1,1
46674,53,59897,53,allow,168,78,90,2,30,1,1
55643,53,36774,53,allow,183,94,89,2,30,1,1
56067,53,5556,53,allow,195,102,93,2,30,1,1
64900,53,45787,53,allow,197,102,95,2,30,1,1
49447,53,53080,53,allow,168,78,90,2,30,1,1
55669,53,38123,53,allow,177,94,83,2,30,1,1
55759,53,16569,53,allow,177,94,83,2,30,1,1
49777,53,52771,53,allow,216,110,106,2,30,1,1
49747,53,22028,53,allow,278,94,184,2,30,1,1
63884,53,63884,53,allow,400,257,143,3,33,2,1
55609,53,21760,53,allow,178,94,84,2,30,1,1
45679,53,45679,53,allow,262,106,156,2,33,1,1
57206,53,29989,53,allow,292,85,207,4,50,2,2
59782,53,21953,53,allow,168,78,90,2,30,1,1
55179,53,32980,53,allow,183,94,89,2,30,1,1
55609,53,6401,53,allow,178,94,84,2,30,1,1
49251,53,13051,53,allow,94,94,0,1,30,1,0
49908,53,39258,53,allow,789,110,679,2,30,1,1
56149,53,1500,53,allow,179,94,85,2,30,1,1
64787,53,33533,53,allow,179,94,85,2,30,1,1
56588,53,38290,53,allow,305,99,206,4,49,2,2
38405,80,54534,80,allow,1114,534,580,12,16,7,5
54816,443,23557,443,allow,130,70,60,3,4,2,1
53964,443,1978,443,allow,152,78,74,2,5,1,1
49545,53,14394,53,allow,195,102,93,2,29,1,1
51709,53,0,0,allow,201,94,107,2,29,1,1
55643,53,52326,53,allow,183,94,89,2,29,1,1
54550,53,0,0,allow,188,86,102,2,29,1,1
56803,53,37278,53,allow,183,94,89,2,29,1,1
56134,53,59241,53,allow,183,94,89,2,29,1,1
55759,53,35937,53,allow,177,94,83,2,30,1,1
56588,53,41777,53,allow,197,102,95,2,29,1,1
64023,53,2522,53,allow,179,94,85,2,29,1,1
64900,53,46043,53,allow,197,102,95,2,30,1,1
58764,53,65299,53,allow,268,94,174,2,30,1,1
50108,53,40711,53,allow,179,94,85,2,30,1,1
64023,53,57287,53,allow,179,94,85,2,30,1,1
50376,53,47622,53,allow,167,78,89,2,30,1,1
55609,53,4360,53,allow,178,94,84,2,30,1,1
50077,53,35101,53,allow,787,110,677,2,30,1,1
49777,53,28087,53,allow,216,110,106,2,30,1,1
49620,53,15285,53,allow,211,110,101,2,30,1,1
56267,53,59732,53,allow,453,186,267,6,30,3,3
49686,53,55592,53,allow,183,94,89,2,30,1,1
54974,53,5978,53,allow,212,102,110,2,30,1,1
56260,53,6502,53,allow,177,94,83,2,30,1,1
64892,53,23593,53,allow,772,102,670,2,30,1,1
55058,53,43398,53,allow,216,110,106,2,31,1,1
56960,53,21026,53,allow,196,102,94,2,31,1,1
65381,53,27857,53,allow,317,102,215,2,31,1,1
56809,53,56809,53,allow,404,259,145,3,33,2,1
56109,53,22951,53,allow,177,94,83,2,30,1,1
54528,53,37583,53,allow,197,94,103,2,30,1,1
46331,53,26643,53,allow,199,94,105,2,30,1,1
65506,53,15371,53,allow,197,102,95,2,30,1,1
58614,53,27966,53,allow,168,78,90,2,30,1,1
49866,53,19774,53,allow,225,110,115,2,30,1,1
64546,53,63352,53,allow,889,404,485,10,30,5,5
49359,53,28261,53,allow,718,94,624,2,30,1,1
55669,53,15952,53,allow,177,94,83,2,30,1,1
51622,53,52520,53,allow,260,86,174,2,30,1,1
64549,53,44048,53,allow,273,86,187,2,30,1,1
56067,53,40948,53,allow,195,102,93,2,30,1,1
55961,53,7584,53,allow,214,102,112,2,30,1,1
49224,53,60967,53,allow,177,94,83,2,30,1,1
49598,53,15528,53,allow,214,102,112,2,30,1,1
49255,53,62654,53,allow,212,102,110,2,30,1,1
56160,53,58234,53,allow,195,102,93,2,31,1,1
49977,53,38356,53,allow,209,110,99,2,30,1,1
64950,53,65250,53,allow,193,102,91,2,30,1,1
65335,53,50606,53,allow,216,102,114,2,30,1,1
55417,53,42244,53,allow,179,94,85,2,30,1,1
56367,53,31807,53,allow,194,102,92,2,30,1,1
56160,53,61640,53,allow,195,102,93,2,30,1,1
64357,53,56985,53,allow,183,94,89,2,30,1,1
57210,53,57210,53,allow,628,82,546,2,30,1,1
55660,53,31252,53,allow,177,94,83,2,30,1,1
63095,443,9067,443,allow,571,166,405,2,30,1,1
63094,53,39482,53,allow,384,166,218,2,30,1,1
63092,53,40692,53,allow,304,86,218,2,30,1,1
55945,53,49702,53,allow,177,94,83,2,31,1,1
54959,53,55132,53,allow,211,110,101,2,31,1,1
55417,53,15668,53,allow,179,94,85,2,31,1,1
56272,53,13597,53,allow,193,102,91,2,31,1,1
56560,53,25642,53,allow,900,110,790,2,31,1,1
64357,53,37789,53,allow,183,94,89,2,31,1,1
56373,53,9374,53,allow,177,94,83,2,30,1,1
56260,53,30984,53,allow,177,94,83,2,31,1,1
50999,53,58447,53,allow,214,78,136,2,30,1,1
65506,53,20953,53,allow,197,102,95,2,30,1,1
49828,53,30864,53,allow,340,110,230,2,31,1,1
55320,53,54468,53,allow,304,94,210,2,30,1,1
55417,53,40418,53,allow,179,94,85,2,30,1,1
55750,53,13328,53,allow,211,110,101,2,30,1,1
63093,443,45246,443,allow,304,86,218,2,30,1,1
50098,53,35550,53,allow,199,102,97,2,31,1,1
60596,53,45720,53,allow,300,86,214,2,31,1,1
55942,53,19231,53,allow,197,102,95,2,31,1,1
63319,53,8378,53,allow,315,102,213,2,31,1,1
55454,53,12163,53,allow,168,86,82,2,32,1,1
55989,53,49458,53,allow,205,86,119,2,30,1,1
53800,53,27732,53,allow,260,86,174,2,30,1,1
64472,53,59070,53,allow,183,94,89,2,31,1,1
63087,443,39607,443,allow,448,166,282,2,31,1,1
64576,53,14840,53,allow,194,102,92,2,31,1,1
63076,443,26735,443,allow,304,86,218,2,31,1,1
50458,53,29574,53,allow,177,94,83,2,31,1,1
57359,53,20340,53,allow,458,188,270,6,31,3,3
49763,53,30741,53,allow,258,110,148,2,30,1,1
49224,53,31598,53,allow,177,94,83,2,30,1,1
63126,445,0,0,drop,70,70,0,1,0,1,0
63124,445,0,0,drop,70,70,0,1,0,1,0
63287,445,0,0,drop,66,66,0,1,0,1,0
51511,445,0,0,drop,70,70,0,1,0,1,0
63111,445,0,0,drop,70,70,0,1,0,1,0
63110,445,0,0,drop,70,70,0,1,0,1,0
63106,445,0,0,drop,70,70,0,1,0,1,0
63285,445,0,0,drop,66,66,0,1,0,1,0
63101,445,0,0,drop,70,70,0,1,0,1,0
63100,445,0,0,drop,70,70,0,1,0,1,0
63278,445,0,0,drop,66,66,0,1,0,1,0
63272,445,0,0,drop,66,66,0,1,0,1,0
63089,445,0,0,drop,70,70,0,1,0,1,0
51503,445,0,0,drop,70,70,0,1,0,1,0
51501,445,0,0,drop,70,70,0,1,0,1,0
51499,445,0,0,drop,70,70,0,1,0,1,0
63262,445,0,0,drop,66,66,0,1,0,1,0
63260,445,0,0,drop,66,66,0,1,0,1,0
63259,445,0,0,drop,66,66,0,1,0,1,0
63255,445,0,0,drop,66,66,0,1,0,1,0
63257,445,0,0,drop,66,66,0,1,0,1,0
63258,445,0,0,drop,66,66,0,1,0,1,0
63261,445,0,0,drop,66,66,0,1,0,1,0
63254,445,0,0,drop,66,66,0,1,0,1,0
63085,445,0,0,drop,70,70,0,1,0,1,0
63076,445,0,0,drop,70,70,0,1,0,1,0
63075,445,0,0,drop,70,70,0,1,0,1,0
63074,445,0,0,drop,70,70,0,1,0,1,0
63071,445,0,0,drop,70,70,0,1,0,1,0
63068,445,0,0,drop,70,70,0,1,0,1,0
51492,445,0,0,drop,70,70,0,1,0,1,0
51487,445,0,0,drop,70,70,0,1,0,1,0
51485,445,0,0,drop,70,70,0,1,0,1,0
51480,445,0,0,drop,70,70,0,1,0,1,0
63241,445,0,0,drop,66,66,0,1,0,1,0
63240,445,0,0,drop,66,66,0,1,0,1,0
63239,445,0,0,drop,66,66,0,1,0,1,0
51478,445,0,0,drop,70,70,0,1,0,1,0
63062,445,0,0,drop,70,70,0,1,0,1,0
51471,445,0,0,drop,70,70,0,1,0,1,0
51470,445,0,0,drop,70,70,0,1,0,1,0
51468,445,0,0,drop,70,70,0,1,0,1,0
63055,445,0,0,drop,70,70,0,1,0,1,0
63053,445,0,0,drop,70,70,0,1,0,1,0
52359,23,0,0,deny,60,60,0,1,0,1,0
63049,445,0,0,drop,70,70,0,1,0,1,0
51461,445,0,0,drop,70,70,0,1,0,1,0
51457,445,0,0,drop,70,70,0,1,0,1,0
51458,445,0,0,drop,70,70,0,1,0,1,0
63047,445,0,0,drop,70,70,0,1,0,1,0
63230,445,0,0,drop,66,66,0,1,0,1,0
63043,445,0,0,drop,70,70,0,1,0,1,0
63041,445,0,0,drop,70,70,0,1,0,1,0
51453,445,0,0,drop,70,70,0,1,0,1,0
51451,445,0,0,drop,70,70,0,1,0,1,0
63211,445,0,0,drop,66,66,0,1,0,1,0
63212,445,0,0,drop,66,66,0,1,0,1,0
63037,445,0,0,drop,70,70,0,1,0,1,0
51441,445,0,0,drop,70,70,0,1,0,1,0
51434,445,0,0,drop,70,70,0,1,0,1,0
51433,445,0,0,drop,70,70,0,1,0,1,0
51431,445,0,0,drop,70,70,0,1,0,1,0
63208,445,0,0,drop,66,66,0,1,0,1,0
59373,22,59373,22,deny,295,126,169,4,1,2,2
63202,445,0,0,drop,66,66,0,1,0,1,0
63200,445,0,0,drop,66,66,0,1,0,1,0
63203,445,0,0,drop,66,66,0,1,0,1,0
63083,53,63784,53,allow,303,85,218,2,30,1,1
64357,53,46898,53,allow,182,93,89,2,30,1,1
63091,443,18908,443,allow,382,164,218,2,30,1,1
49197,53,13288,53,allow,777,87,690,2,30,1,1
65506,53,39413,53,allow,194,99,95,2,30,1,1
50641,53,60493,53,allow,760,97,663,2,30,1,1
64472,53,7630,53,allow,182,93,89,2,30,1,1
50052,53,19645,53,allow,738,86,652,2,30,1,1
55945,53,26703,53,allow,170,87,83,2,30,1,1
42379,443,33462,443,allow,1622,1137,485,11,26,7,4
65147,53,28135,53,allow,763,101,662,2,30,1,1
56582,53,23626,53,allow,711,87,624,2,31,1,1
55965,53,22177,53,allow,184,94,90,2,30,1,1
56020,53,29198,53,allow,711,87,624,2,30,1,1
49756,53,23691,53,allow,264,89,175,4,48,2,2
39233,53,39233,53,allow,235,90,145,2,33,1,1
41036,443,13628,443,allow,153,93,60,2,5,1,1
45021,53,45021,53,allow,213,79,134,2,32,1,1
54977,53,19132,53,allow,275,93,182,4,32,2,2
50663,80,56397,80,allow,1366,865,501,8,15,5,3
49531,80,27250,80,allow,78,78,0,2,8,2,0
42377,443,33699,443,allow,1622,1137,485,11,26,7,4
55907,53,13623,53,allow,711,87,624,2,30,1,1
49363,53,12270,53,allow,208,106,102,2,30,1,1
55417,53,13088,53,allow,174,89,85,2,30,1,1
57082,53,0,0,allow,82,82,0,1,30,1,0
41576,443,2351,443,allow,2227,1018,1209,17,15,8,9
64135,53,50232,53,allow,192,98,94,2,31,1,1
42380,443,32272,443,allow,1622,1137,485,11,26,7,4
42631,443,38369,443,allow,153,93,60,2,5,1,1
65315,53,25931,53,allow,770,101,669,2,30,1,1
55566,53,37015,53,allow,740,93,647,2,30,1,1
49686,53,35211,53,allow,182,93,89,2,30,1,1
63082,443,41312,443,allow,303,85,218,2,30,1,1
55772,53,9529,53,allow,782,105,677,2,30,1,1
60089,53,50988,53,allow,297,83,214,2,30,1,1
55134,53,55134,53,allow,825,99,726,2,31,1,1
56294,53,56294,53,allow,229,89,140,2,31,1,1
64746,53,11815,53,allow,186,95,91,2,31,1,1
55275,53,41187,53,allow,770,101,669,2,30,1,1
65386,53,25163,53,allow,194,99,95,2,30,1,1
56912,53,9519,53,allow,198,101,97,2,31,1,1
56160,53,63340,53,allow,190,97,93,2,30,1,1
56845,53,56845,53,allow,825,99,726,2,30,1,1
60384,53,44713,53,allow,234,96,138,2,31,1,1
56246,53,10681,53,allow,816,97,719,2,31,1,1
64414,53,56894,53,allow,182,93,89,2,31,1,1
63952,53,34336,53,allow,206,105,101,2,31,1,1
57681,53,57681,53,allow,220,100,120,2,31,1,1
55942,53,46906,53,allow,194,99,95,2,31,1,1
57371,53,9888,53,allow,755,93,662,2,31,1,1
56805,53,62222,53,allow,815,95,720,2,31,1,1
64318,53,59823,53,allow,182,93,89,2,31,1,1
55230,53,36374,53,allow,182,93,89,2,30,1,1
54980,53,25043,53,allow,763,101,662,2,30,1,1
57294,53,3249,53,allow,760,97,663,2,31,1,1
58390,53,44510,53,allow,240,76,164,2,31,1,1
56913,53,30099,53,allow,772,103,669,2,31,1,1
56561,53,2642,53,allow,216,110,106,2,31,1,1
49802,53,5262,53,allow,755,93,662,2,31,1,1
49978,53,54478,53,allow,760,97,663,2,31,1,1
57384,53,45393,53,allow,752,93,659,2,31,1,1
49286,53,16984,53,allow,184,94,90,2,31,1,1
55024,53,56157,53,allow,168,86,82,2,31,1,1
55194,53,53010,53,allow,190,97,93,2,31,1,1
49631,53,31277,53,allow,196,100,96,2,31,1,1
56497,53,2084,53,allow,170,87,83,2,31,1,1
65336,53,14965,53,allow,732,89,643,2,31,1,1
55786,53,65115,53,allow,186,95,91,2,31,1,1
63195,445,0,0,drop,66,66,0,1,0,1,0
63197,445,0,0,drop,66,66,0,1,0,1,0
63201,445,0,0,drop,66,66,0,1,0,1,0
63192,445,0,0,drop,66,66,0,1,0,1,0
63024,445,0,0,drop,70,70,0,1,0,1,0
51427,445,0,0,drop,70,70,0,1,0,1,0
51423,445,0,0,drop,70,70,0,1,0,1,0
51419,445,0,0,drop,70,70,0,1,0,1,0
51420,445,0,0,drop,70,70,0,1,0,1,0
63021,445,0,0,drop,70,70,0,1,0,1,0
56762,53,10998,53,allow,168,86,82,2,30,1,1
50098,53,37375,53,allow,199,102,97,2,30,1,1
63089,53,1694,53,allow,512,166,346,2,30,1,1
64135,53,40678,53,allow,196,102,94,2,30,1,1
49270,80,7008,80,allow,254,128,126,5,15,3,2
41611,80,9523,80,allow,1860,712,1148,8,15,5,3
55829,53,51099,53,allow,177,94,83,2,30,1,1
41790,443,32230,443,allow,232,172,60,3,4,2,1
49773,80,19021,80,allow,70,70,0,2,8,2,0
56940,53,20579,53,allow,316,97,219,4,33,2,2
49363,53,19246,53,allow,212,110,102,2,29,1,1
57063,53,6247,53,allow,193,102,91,2,29,1,1
55492,53,7520,53,allow,216,110,106,2,29,1,1
56082,53,1185,53,allow,730,102,628,2,29,1,1
49620,53,9957,53,allow,211,110,101,2,29,1,1
55492,53,34032,53,allow,216,110,106,2,29,1,1
55945,53,7616,53,allow,177,94,83,2,29,1,1
55660,53,60167,53,allow,177,94,83,2,30,1,1
49756,53,23582,53,allow,264,89,175,4,47,2,2
49875,53,51820,53,allow,399,86,313,4,49,2,2
56375,53,4140,53,allow,322,110,212,4,30,2,2
56810,53,11762,53,allow,177,94,83,2,30,1,1
56960,53,26282,53,allow,196,102,94,2,30,1,1
64746,53,35675,53,allow,193,102,91,2,30,1,1
65248,53,49147,53,allow,212,110,102,2,30,1,1
65225,53,20120,53,allow,822,102,720,2,30,1,1
56561,53,19091,53,allow,216,110,106,2,30,1,1
63079,443,63360,443,allow,304,86,218,2,30,1,1
53271,443,21027,443,allow,1544,1073,471,13,15,8,5
64699,53,61689,53,allow,338,110,228,2,30,1,1
55058,53,31545,53,allow,216,110,106,2,30,1,1
50504,53,41149,53,allow,168,86,82,2,30,1,1
57431,53,12535,53,allow,994,86,908,2,30,1,1
49620,53,32011,53,allow,198,110,88,2,30,1,1
49172,53,13814,53,allow,305,94,211,2,30,1,1
54959,53,28413,53,allow,211,110,101,2,30,1,1
50458,53,25707,53,allow,177,94,83,2,30,1,1
56375,53,25593,53,allow,216,110,106,2,30,1,1
55251,53,16099,53,allow,212,110,102,2,30,1,1
42025,443,50486,443,allow,70,70,0,1,5,1,0
39055,53,10136,53,allow,289,86,203,2,30,1,1
64384,53,46498,53,allow,350,94,256,2,30,1,1
64486,53,21384,53,allow,290,102,188,2,30,1,1
56272,53,41462,53,allow,193,102,91,2,30,1,1
49313,53,49710,53,allow,199,102,97,2,30,1,1
55251,53,49536,53,allow,212,110,102,2,30,1,1
56668,80,5597,80,allow,234,234,0,4,12,4,0
56771,53,50189,53,allow,166,86,80,2,30,1,1
64318,53,51027,53,allow,183,94,89,2,30,1,1
63081,53,24594,53,allow,304,86,218,2,30,1,1
63080,443,52084,443,allow,304,86,218,2,30,1,1
49293,53,34843,53,allow,382,95,287,4,48,2,2
49686,53,23134,53,allow,183,94,89,2,30,1,1
63088,443,45061,443,allow,512,166,346,2,30,1,1
60203,53,37285,53,allow,328,86,242,2,30,1,1
55230,53,3013,53,allow,183,94,89,2,30,1,1
64472,53,45709,53,allow,183,94,89,2,30,1,1
63078,53,5697,53,allow,304,86,218,2,30,1,1
56769,53,50586,53,allow,195,102,93,2,30,1,1
55942,53,36132,53,allow,197,102,95,2,30,1,1
49756,53,1585,53,allow,264,89,175,4,48,2,2
38358,80,53485,80,allow,409,289,120,5,15,3,2
54977,53,63603,53,allow,275,93,182,4,32,2,2
54977,53,36032,53,allow,275,93,182,4,31,2,2
51443,443,42123,443,allow,322,262,60,2,15,1,1
59405,443,1405,443,allow,276,70,206,5,26,2,3
56276,443,23651,443,allow,154,94,60,2,4,1,1
56803,53,3207,53,allow,429,93,336,4,44,2,2
55750,53,45785,53,allow,211,110,101,2,29,1,1
64787,53,58679,53,allow,179,94,85,2,29,1,1
55829,53,11417,53,allow,212,110,102,2,29,1,1
64318,53,45436,53,allow,183,94,89,2,30,1,1
50541,53,14016,53,allow,458,188,270,6,30,3,3
56771,53,26482,53,allow,166,86,80,2,30,1,1
63086,53,16338,53,allow,512,166,346,2,30,1,1
64804,53,12585,53,allow,383,97,286,4,58,2,2
57264,53,5808,53,allow,197,102,95,2,29,1,1
56109,53,49882,53,allow,177,94,83,2,29,1,1
55251,53,30492,53,allow,212,110,102,2,30,1,1
63085,53,50123,53,allow,448,166,282,2,30,1,1
64135,53,23762,53,allow,196,102,94,2,30,1,1
55669,53,4616,53,allow,784,94,690,2,30,1,1
65354,53,12903,53,allow,168,86,82,2,30,1,1
56333,53,17825,53,allow,199,102,97,2,30,1,1
64414,53,2206,53,allow,183,94,89,2,30,1,1
56078,53,23353,53,allow,168,86,82,2,30,1,1
55024,53,28341,53,allow,168,86,82,2,30,1,1
56550,53,42634,53,allow,166,86,80,2,30,1,1
55871,53,4127,53,allow,177,94,83,2,30,1,1
65386,53,26119,53,allow,1160,392,768,10,66,5,5
49313,53,45650,53,allow,199,102,97,2,30,1,1
56185,53,61715,53,allow,168,86,82,2,30,1,1
54959,53,14757,53,allow,211,110,101,2,30,1,1
56260,53,19443,53,allow,177,94,83,2,30,1,1
56769,53,26341,53,allow,195,102,93,2,30,1,1
50074,53,31884,53,allow,168,86,82,2,30,1,1
65506,53,16583,53,allow,197,102,95,2,30,1,1
64576,53,5234,53,allow,194,102,92,2,31,1,1
56762,53,42811,53,allow,168,86,82,2,30,1,1
55058,53,37390,53,allow,216,110,106,2,30,1,1
55965,53,4442,53,allow,184,94,90,2,30,1,1
50074,53,48010,53,allow,168,86,82,2,30,1,1
63084,443,51859,443,allow,571,166,405,2,30,1,1
56272,53,7235,53,allow,193,102,91,2,30,1,1
63077,53,21461,53,allow,304,86,218,2,30,1,1
64746,53,28024,53,allow,193,102,91,2,31,1,1
56862,80,27370,80,allow,2058,589,1469,10,45,6,4
49756,53,28013,53,allow,264,89,175,4,47,2,2
65237,53,38520,53,allow,733,86,647,2,30,1,1
56960,53,36561,53,allow,196,102,94,2,30,1,1
57375,53,58111,53,allow,247,102,145,2,30,1,1
56810,53,28804,53,allow,177,94,83,2,30,1,1
49313,53,30091,53,allow,199,102,97,2,30,1,1
64472,53,42723,53,allow,183,94,89,2,30,1,1
64273,53,36287,53,allow,239,94,145,2,30,1,1
50462,53,31547,53,allow,299,94,205,2,30,1,1
55230,53,6138,53,allow,183,94,89,2,30,1,1
65225,53,58694,53,allow,199,102,97,2,30,1,1
56561,53,15305,53,allow,216,110,106,2,30,1,1
55711,53,17367,53,allow,177,94,83,2,30,1,1
49855,53,34570,53,allow,177,94,83,2,30,1,1
56522,53,55041,53,allow,177,94,83,2,30,1,1
49286,53,40231,53,allow,184,94,90,2,31,1,1
56522,53,65076,53,allow,177,94,83,2,31,1,1
37263,53,37263,53,allow,220,90,130,2,30,1,1
52533,53,8262,53,allow,242,78,164,2,30,1,1
64135,53,37160,53,allow,196,102,94,2,30,1,1
56160,53,39836,53,allow,195,102,93,2,30,1,1
49246,53,41120,53,allow,172,94,78,2,30,1,1
55194,53,9824,53,allow,195,102,93,2,31,1,1
64926,53,21011,53,allow,166,86,80,2,31,1,1
65428,53,31541,53,allow,195,102,93,2,31,1,1
63952,53,14655,53,allow,211,110,101,2,30,1,1
55965,53,49770,53,allow,184,94,90,2,30,1,1
55945,53,48545,53,allow,177,94,83,2,30,1,1
56910,53,3209,53,allow,199,102,97,2,30,1,1
56810,53,31641,53,allow,177,94,83,2,30,1,1
49954,53,59869,53,allow,753,94,659,2,30,1,1
56561,53,31365,53,allow,216,110,106,2,31,1,1
49246,53,51289,53,allow,164,86,78,2,31,1,1
65006,53,63104,53,allow,994,86,908,2,30,1,1
56963,53,8410,53,allow,199,102,97,2,31,1,1
54977,53,39208,53,allow,275,93,182,4,31,2,2
49717,53,48239,53,allow,444,96,348,4,44,2,2
63963,53,7667,53,allow,262,86,176,4,46,2,2
63963,53,46328,53,allow,262,86,176,4,46,2,2
63952,53,42119,53,allow,358,105,253,4,44,2,2
63016,445,0,0,drop,70,70,0,1,0,1,0
51417,445,0,0,drop,70,70,0,1,0,1,0
51416,445,0,0,drop,70,70,0,1,0,1,0
51414,445,0,0,drop,70,70,0,1,0,1,0
63015,445,0,0,drop,70,70,0,1,0,1,0
63186,445,0,0,drop,66,66,0,1,0,1,0
51410,445,0,0,drop,70,70,0,1,0,1,0
63181,445,0,0,drop,66,66,0,1,0,1,0
63013,445,0,0,drop,70,70,0,1,0,1,0
63180,445,0,0,drop,66,66,0,1,0,1,0
63178,445,0,0,drop,66,66,0,1,0,1,0
45424,23,0,0,deny,60,60,0,1,0,1,0
63176,445,0,0,drop,66,66,0,1,0,1,0
51404,445,0,0,drop,70,70,0,1,0,1,0
63006,445,0,0,drop,70,70,0,1,0,1,0
51401,445,0,0,drop,70,70,0,1,0,1,0
51394,445,0,0,drop,70,70,0,1,0,1,0
63004,445,0,0,drop,70,70,0,1,0,1,0
63166,445,0,0,drop,66,66,0,1,0,1,0
63003,445,0,0,drop,70,70,0,1,0,1,0
63002,445,0,0,drop,70,70,0,1,0,1,0
63001,445,0,0,drop,70,70,0,1,0,1,0
62995,445,0,0,drop,70,70,0,1,0,1,0
62996,445,0,0,drop,70,70,0,1,0,1,0
63158,445,0,0,drop,66,66,0,1,0,1,0
51383,445,0,0,drop,70,70,0,1,0,1,0
62983,445,0,0,drop,70,70,0,1,0,1,0
62981,445,0,0,drop,70,70,0,1,0,1,0
62980,445,0,0,drop,70,70,0,1,0,1,0
62973,445,0,0,drop,70,70,0,1,0,1,0
62972,445,0,0,drop,70,70,0,1,0,1,0
63156,445,0,0,drop,66,66,0,1,0,1,0
63149,445,0,0,drop,66,66,0,1,0,1,0
63146,445,0,0,drop,66,66,0,1,0,1,0
62961,445,0,0,drop,70,70,0,1,0,1,0
60269,443,14941,443,allow,499,425,74,4,0,3,1
51374,445,0,0,drop,70,70,0,1,0,1,0
51372,445,0,0,drop,70,70,0,1,0,1,0
51370,445,0,0,drop,70,70,0,1,0,1,0
63133,445,0,0,drop,66,66,0,1,0,1,0
63131,445,0,0,drop,66,66,0,1,0,1,0
63127,445,0,0,drop,66,66,0,1,0,1,0
63128,445,0,0,drop,66,66,0,1,0,1,0
63126,445,0,0,drop,66,66,0,1,0,1,0
63130,445,0,0,drop,66,66,0,1,0,1,0
63125,445,0,0,drop,66,66,0,1,0,1,0
63129,445,0,0,drop,66,66,0,1,0,1,0
62957,445,0,0,drop,70,70,0,1,0,1,0
62948,445,0,0,drop,70,70,0,1,0,1,0
62945,445,0,0,drop,70,70,0,1,0,1,0
62946,445,0,0,drop,70,70,0,1,0,1,0
62944,445,0,0,drop,70,70,0,1,0,1,0
62940,445,0,0,drop,70,70,0,1,0,1,0
51367,445,0,0,drop,70,70,0,1,0,1,0
51365,445,0,0,drop,70,70,0,1,0,1,0
51354,445,0,0,drop,70,70,0,1,0,1,0
51353,445,0,0,drop,70,70,0,1,0,1,0
63113,445,0,0,drop,66,66,0,1,0,1,0
63111,445,0,0,drop,66,66,0,1,0,1,0
63112,445,0,0,drop,66,66,0,1,0,1,0
62934,445,0,0,drop,70,70,0,1,0,1,0
44889,23,0,0,deny,60,60,0,1,0,1,0
51351,445,0,0,drop,70,70,0,1,0,1,0
51344,445,0,0,drop,70,70,0,1,0,1,0
51341,445,0,0,drop,70,70,0,1,0,1,0
51339,445,0,0,drop,70,70,0,1,0,1,0
62927,445,0,0,drop,70,70,0,1,0,1,0
62926,445,0,0,drop,70,70,0,1,0,1,0
62920,445,0,0,drop,70,70,0,1,0,1,0
62919,445,0,0,drop,70,70,0,1,0,1,0
51332,445,0,0,drop,70,70,0,1,0,1,0
51329,445,0,0,drop,70,70,0,1,0,1,0
51327,445,0,0,drop,70,70,0,1,0,1,0
63101,445,0,0,drop,66,66,0,1,0,1,0
62915,445,0,0,drop,70,70,0,1,0,1,0
62913,445,0,0,drop,70,70,0,1,0,1,0
51325,445,0,0,drop,70,70,0,1,0,1,0
51320,445,0,0,drop,70,70,0,1,0,1,0
62909,445,0,0,drop,70,70,0,1,0,1,0
50951,53,0,0,allow,82,82,0,1,30,1,0
56522,53,28369,53,allow,170,87,83,2,30,1,1
64249,53,29634,53,allow,178,91,87,2,30,1,1
45406,80,51652,80,allow,573,499,74,6,15,5,1
55945,53,36008,53,allow,760,97,663,2,30,1,1
63963,53,56258,53,allow,262,86,176,4,46,2,2
55024,53,61199,53,allow,174,89,85,2,30,1,1
49449,53,12310,53,allow,216,110,106,2,30,1,1
55487,53,4696,53,allow,732,89,643,2,30,1,1
64576,53,33878,53,allow,188,96,92,2,31,1,1
56192,53,15421,53,allow,170,87,83,2,30,1,1
52529,80,44880,80,allow,1056,682,374,10,15,6,4
45404,80,36835,80,allow,574,500,74,6,15,5,1
58881,443,10013,443,allow,1413,876,537,12,26,6,6
64340,53,64340,53,allow,847,110,737,2,30,1,1
57417,53,14881,53,allow,295,101,194,4,31,2,2
45400,80,25751,80,allow,574,500,74,6,15,5,1
49733,443,61095,443,allow,204,70,134,4,26,2,2
46617,53,46617,53,allow,213,87,126,2,30,1,1
45402,80,27119,80,allow,573,499,74,6,15,5,1
37542,53,41860,53,allow,240,76,164,2,30,1,1
65248,53,20664,53,allow,208,106,102,2,30,1,1
41672,53,20887,53,allow,240,76,164,2,30,1,1
49855,53,31460,53,allow,170,87,83,2,30,1,1
50443,53,37606,53,allow,788,108,680,2,31,1,1
56963,53,56853,53,allow,198,101,97,2,31,1,1
56091,53,8508,53,allow,771,101,670,2,31,1,1
57322,53,27268,53,allow,192,98,94,2,31,1,1
56340,53,14544,53,allow,196,100,96,2,31,1,1
49484,53,47845,53,allow,742,88,654,2,31,1,1
56603,53,59539,53,allow,168,86,82,2,31,1,1
64106,53,59908,53,allow,190,97,93,2,31,1,1
65279,53,56734,53,allow,182,93,89,2,31,1,1
65428,53,32499,53,allow,190,97,93,2,31,1,1
65099,53,63994,53,allow,198,101,97,2,31,1,1
64146,53,41885,53,allow,194,99,95,2,31,1,1
49891,53,42483,53,allow,164,84,80,2,31,1,1
63085,445,0,0,drop,66,66,0,1,0,1,0
63083,445,0,0,drop,66,66,0,1,0,1,0
51315,445,0,0,drop,70,70,0,1,0,1,0
57442,66,38674,66,allow,70,70,0,1,5,1,0
49449,53,15422,53,allow,216,110,106,2,30,1,1
59032,53,50252,53,allow,295,86,209,2,30,1,1
56912,53,3525,53,allow,199,102,97,2,30,1,1
63952,53,32922,53,allow,211,110,101,2,29,1,1
56912,53,5094,53,allow,199,102,97,2,29,1,1
55965,53,59955,53,allow,184,94,90,2,29,1,1
64318,53,41262,53,allow,499,183,316,6,57,3,3
49302,53,61464,53,allow,234,94,140,2,30,1,1
55194,53,43998,53,allow,195,102,93,2,30,1,1
62293,443,17682,443,allow,598,598,0,8,40,8,0
64414,53,13029,53,allow,183,94,89,2,29,1,1
55194,53,21353,53,allow,195,102,93,2,29,1,1
52541,53,60922,53,allow,242,78,164,2,29,1,1
49363,53,56997,53,allow,309,94,215,2,29,1,1
55871,53,54584,53,allow,177,94,83,2,29,1,1
49286,53,40508,53,allow,184,94,90,2,29,1,1
64414,53,36942,53,allow,183,94,89,2,29,1,1
65248,53,6844,53,allow,446,106,340,4,47,2,2
55699,53,3858,53,allow,271,103,168,4,59,2,2
51531,443,29173,443,allow,898,460,438,12,39,5,7
45374,80,46773,80,allow,806,463,343,9,15,6,3
64146,53,31528,53,allow,197,102,95,2,30,1,1
55024,53,59987,53,allow,179,94,85,2,30,1,1
56336,53,29646,53,allow,178,94,84,2,30,1,1
55024,53,16229,53,allow,179,94,85,2,30,1,1
36998,80,39862,80,allow,130,70,60,2,15,1,1
64140,53,22655,53,allow,306,94,212,4,33,2,2
49286,53,14433,53,allow,184,94,90,2,30,1,1
65116,53,63214,53,allow,200,94,106,2,30,1,1
49631,53,56350,53,allow,198,102,96,2,30,1,1
65011,53,59179,53,allow,168,86,82,2,30,1,1
50609,53,13488,53,allow,766,102,664,2,30,1,1
65245,53,31425,53,allow,184,102,82,2,30,1,1
56603,53,39210,53,allow,168,86,82,2,30,1,1
56522,53,51170,53,allow,177,94,83,2,30,1,1
64746,53,23146,53,allow,193,102,91,2,30,1,1
49855,53,65525,53,allow,177,94,83,2,30,1,1
55699,53,30470,53,allow,271,103,168,4,59,2,2
39785,53,39785,53,allow,229,98,131,2,30,1,1
55942,53,15569,53,allow,197,102,95,2,30,1,1
55786,53,31916,53,allow,102,102,0,1,30,1,0
50644,80,26132,80,allow,314,192,122,6,25,4,2
63963,53,20929,53,allow,262,86,176,4,46,2,2
64935,53,16580,53,allow,765,102,663,2,30,1,1
50520,53,48841,53,allow,183,94,89,2,30,1,1
65011,53,42934,53,allow,168,86,82,2,30,1,1
58681,123,50487,123,allow,184,94,90,2,30,1,1
64249,53,32881,53,allow,181,94,87,2,30,1,1
57221,53,53360,53,allow,184,102,82,2,30,1,1
43827,443,64958,443,allow,130,70,60,2,14,1,1
50646,80,29942,80,allow,1328,917,411,10,25,6,4
56125,80,62901,80,allow,2091,799,1292,10,15,6,4
56333,53,9058,53,allow,822,102,720,2,29,1,1
65248,53,43627,53,allow,212,110,102,2,29,1,1
55829,53,27683,53,allow,177,94,83,2,29,1,1
56762,53,10015,53,allow,168,86,82,2,29,1,1
64357,53,31050,53,allow,183,94,89,2,29,1,1
52261,53,10393,53,allow,195,94,101,2,29,1,1
64477,53,60345,53,allow,211,102,109,2,29,1,1
44157,53,44157,53,allow,216,90,126,2,29,1,1
56550,53,19597,53,allow,166,86,80,2,29,1,1
49620,53,16282,53,allow,198,110,88,2,29,1,1
49855,53,48096,53,allow,177,94,83,2,30,1,1
56192,53,47862,53,allow,177,94,83,2,30,1,1
55711,53,26039,53,allow,177,94,83,2,29,1,1
56912,53,8353,53,allow,199,102,97,2,30,1,1
62306,53,46053,53,allow,387,94,293,2,30,1,1
56910,53,22546,53,allow,199,102,97,2,29,1,1
56497,53,16693,53,allow,177,94,83,2,30,1,1
49332,53,35822,53,allow,276,118,158,2,30,1,1
56078,53,11255,53,allow,168,86,82,2,30,1,1
50520,53,8153,53,allow,183,94,89,2,30,1,1
55751,53,8390,53,allow,216,94,122,2,30,1,1
51001,53,26424,53,allow,183,86,97,2,30,1,1
64245,53,16068,53,allow,344,94,250,2,30,1,1
53833,53,46684,53,allow,211,78,133,2,30,1,1
56500,53,38812,53,allow,164,86,78,2,30,1,1
65064,53,46432,53,allow,198,102,96,2,30,1,1
63972,53,46168,53,allow,193,102,91,2,30,1,1
65279,53,28048,53,allow,183,94,89,2,31,1,1
64287,53,27313,53,allow,497,90,407,4,33,2,2
60970,80,26224,80,allow,912,472,440,8,15,3,5
56281,53,56281,53,allow,851,114,737,2,30,1,1
64894,53,8238,53,allow,195,102,93,2,30,1,1
64926,53,24382,53,allow,166,86,80,2,30,1,1
64894,53,19330,53,allow,195,102,93,2,30,1,1
56192,53,30886,53,allow,177,94,83,2,30,1,1
65245,53,21925,53,allow,184,102,82,2,30,1,1
49304,53,30791,53,allow,214,102,112,2,30,1,1
55786,53,13962,53,allow,193,102,91,2,30,1,1
49776,443,33796,443,allow,214,140,74,4,15,3,1
58883,443,51515,443,allow,1115,591,524,12,25,6,6
49449,53,11737,53,allow,216,110,106,2,30,1,1
60711,53,53816,53,allow,211,78,133,2,30,1,1
55211,53,36249,53,allow,183,94,89,2,30,1,1
49637,53,0,0,allow,86,86,0,1,30,1,0
56752,53,41172,53,allow,183,94,89,2,30,1,1
56740,80,35362,80,allow,1462,703,759,8,17,5,3
55211,53,32834,53,allow,183,94,89,2,30,1,1
56497,53,37841,53,allow,177,94,83,2,30,1,1
60580,53,20280,53,allow,181,86,95,2,30,1,1
64573,53,37433,53,allow,757,102,655,2,30,1,1
56121,53,26656,53,allow,338,110,228,2,30,1,1
65036,53,4183,53,allow,199,102,97,2,30,1,1
56500,53,54568,53,allow,164,86,78,2,30,1,1
49226,53,3367,53,allow,194,102,92,2,30,1,1
55024,53,31814,53,allow,179,94,85,2,30,1,1
64829,53,40836,53,allow,213,102,111,2,30,1,1
51689,53,34111,53,allow,198,86,112,2,30,1,1
49804,53,30225,53,allow,209,102,107,2,30,1,1
56497,53,27099,53,allow,177,94,83,2,30,1,1
55865,53,64490,53,allow,168,86,82,2,30,1,1
49180,53,27807,53,allow,359,118,241,2,30,1,1
50559,53,4402,53,allow,216,110,106,2,31,1,1
55591,53,39527,53,allow,195,102,93,2,31,1,1
64106,53,27158,53,allow,195,102,93,2,31,1,1
64576,53,63457,53,allow,194,102,92,2,31,1,1
56100,53,57045,53,allow,216,110,106,2,31,1,1
56752,53,15313,53,allow,183,94,89,2,31,1,1
56019,53,28168,53,allow,194,102,92,2,31,1,1
65099,53,22746,53,allow,199,102,97,2,31,1,1
57331,53,47400,53,allow,178,94,84,2,31,1,1
55069,53,13593,53,allow,195,102,93,2,31,1,1
64051,53,51013,53,allow,430,172,258,6,61,3,3
54592,80,24898,80,allow,1113,534,579,12,16,7,5
53198,53,24028,53,allow,365,86,279,2,30,1,1
63972,53,35839,53,allow,193,102,91,2,30,1,1
56192,53,42935,53,allow,177,94,83,2,30,1,1
64146,53,63495,53,allow,197,102,95,2,30,1,1
64188,53,45023,53,allow,194,94,100,2,30,1,1
57322,53,63683,53,allow,196,102,94,2,31,1,1
55865,53,56298,53,allow,168,86,82,2,30,1,1
63103,53,6941,53,allow,222,86,136,2,30,1,1
64535,53,33577,53,allow,734,86,648,2,31,1,1
51314,445,0,0,drop,70,70,0,1,0,1,0
51308,445,0,0,drop,70,70,0,1,0,1,0
51307,445,0,0,drop,70,70,0,1,0,1,0
63079,445,0,0,drop,66,66,0,1,0,1,0
62896,445,0,0,drop,70,70,0,1,0,1,0
63067,445,0,0,drop,66,66,0,1,0,1,0
63069,445,0,0,drop,66,66,0,1,0,1,0
63068,445,0,0,drop,66,66,0,1,0,1,0
63072,445,0,0,drop,66,66,0,1,0,1,0
63066,445,0,0,drop,66,66,0,1,0,1,0
63065,445,0,0,drop,66,66,0,1,0,1,0
63063,445,0,0,drop,66,66,0,1,0,1,0
51298,445,0,0,drop,70,70,0,1,0,1,0
62893,445,0,0,drop,70,70,0,1,0,1,0
51292,445,0,0,drop,70,70,0,1,0,1,0
51295,445,0,0,drop,70,70,0,1,0,1,0
51291,445,0,0,drop,70,70,0,1,0,1,0
62888,445,0,0,drop,70,70,0,1,0,1,0
62887,445,0,0,drop,70,70,0,1,0,1,0
51289,445,0,0,drop,70,70,0,1,0,1,0
51287,445,0,0,drop,70,70,0,1,0,1,0
51286,445,0,0,drop,70,70,0,1,0,1,0
62885,445,0,0,drop,70,70,0,1,0,1,0
63057,445,0,0,drop,66,66,0,1,0,1,0
51282,445,0,0,drop,70,70,0,1,0,1,0
56306,1,0,0,deny,146,146,0,1,0,1,0
63053,445,0,0,drop,66,66,0,1,0,1,0
63051,445,0,0,drop,66,66,0,1,0,1,0
63050,445,0,0,drop,66,66,0,1,0,1,0
63048,445,0,0,drop,66,66,0,1,0,1,0
62878,445,0,0,drop,70,70,0,1,0,1,0
51281,445,0,0,drop,70,70,0,1,0,1,0
62876,445,0,0,drop,70,70,0,1,0,1,0
51267,445,0,0,drop,70,70,0,1,0,1,0
51265,445,0,0,drop,70,70,0,1,0,1,0
62875,445,0,0,drop,70,70,0,1,0,1,0
62874,445,0,0,drop,70,70,0,1,0,1,0
62873,445,0,0,drop,70,70,0,1,0,1,0
62867,445,0,0,drop,70,70,0,1,0,1,0
62870,445,0,0,drop,70,70,0,1,0,1,0
63037,445,0,0,drop,66,66,0,1,0,1,0
62855,445,0,0,drop,70,70,0,1,0,1,0
62854,445,0,0,drop,70,70,0,1,0,1,0
62852,445,0,0,drop,70,70,0,1,0,1,0
63030,445,0,0,drop,66,66,0,1,0,1,0
51255,445,0,0,drop,70,70,0,1,0,1,0
62844,445,0,0,drop,70,70,0,1,0,1,0
62845,445,0,0,drop,70,70,0,1,0,1,0
55385,53,61909,53,allow,710,89,621,2,0,1,1
55643,53,39402,53,allow,182,93,89,2,0,1,1
63027,445,0,0,drop,66,66,0,1,0,1,0
63019,445,0,0,drop,66,66,0,1,0,1,0
62833,445,0,0,drop,70,70,0,1,0,1,0
63017,445,0,0,drop,66,66,0,1,0,1,0
56424,53,24013,53,allow,711,87,624,2,0,1,1
62828,445,0,0,drop,70,70,0,1,0,1,0
51246,445,0,0,drop,70,70,0,1,0,1,0
51242,445,0,0,drop,70,70,0,1,0,1,0
51243,445,0,0,drop,70,70,0,1,0,1,0
63004,445,0,0,drop,66,66,0,1,0,1,0
63005,445,0,0,drop,66,66,0,1,0,1,0
63003,445,0,0,drop,66,66,0,1,0,1,0
63002,445,0,0,drop,66,66,0,1,0,1,0
63001,445,0,0,drop,66,66,0,1,0,1,0
63000,445,0,0,drop,66,66,0,1,0,1,0
62999,445,0,0,drop,66,66,0,1,0,1,0
62997,445,0,0,drop,66,66,0,1,0,1,0
62820,445,0,0,drop,70,70,0,1,0,1,0
62819,445,0,0,drop,70,70,0,1,0,1,0
62818,445,0,0,drop,70,70,0,1,0,1,0
62815,445,0,0,drop,70,70,0,1,0,1,0
62812,445,0,0,drop,70,70,0,1,0,1,0
51238,445,0,0,drop,70,70,0,1,0,1,0
51233,445,0,0,drop,70,70,0,1,0,1,0
51236,445,0,0,drop,70,70,0,1,0,1,0
51226,445,0,0,drop,70,70,0,1,0,1,0
62982,445,0,0,drop,66,66,0,1,0,1,0
62984,445,0,0,drop,66,66,0,1,0,1,0
62983,445,0,0,drop,66,66,0,1,0,1,0
62806,445,0,0,drop,70,70,0,1,0,1,0
51222,445,0,0,drop,70,70,0,1,0,1,0
51218,445,0,0,drop,70,70,0,1,0,1,0
51216,445,0,0,drop,70,70,0,1,0,1,0
51213,445,0,0,drop,70,70,0,1,0,1,0
62799,445,0,0,drop,70,70,0,1,0,1,0
62797,445,0,0,drop,70,70,0,1,0,1,0
62793,445,0,0,drop,70,70,0,1,0,1,0
62791,445,0,0,drop,70,70,0,1,0,1,0
51205,445,0,0,drop,70,70,0,1,0,1,0
51204,445,0,0,drop,70,70,0,1,0,1,0
51203,445,0,0,drop,70,70,0,1,0,1,0
62787,445,0,0,drop,70,70,0,1,0,1,0
62972,445,0,0,drop,66,66,0,1,0,1,0
64739,53,44159,53,allow,172,88,84,2,30,1,1
38766,53,38766,53,allow,371,237,134,3,32,2,1
56761,53,40671,53,allow,788,108,680,2,30,1,1
57357,443,47242,443,allow,126,60,66,3,11,2,1
49341,80,65147,80,allow,1969,463,1506,13,55,7,6
55069,53,8912,53,allow,190,97,93,2,31,1,1
56703,53,61350,53,allow,198,101,97,2,31,1,1
56134,53,39668,53,allow,93,93,0,1,30,1,0
55944,53,48983,53,allow,762,98,664,2,30,1,1
55591,53,58697,53,allow,190,97,93,2,31,1,1
56633,53,42067,53,allow,164,84,80,2,31,1,1
55879,53,24811,53,allow,749,94,655,2,30,1,1
64051,53,14293,53,allow,430,172,258,6,60,3,3
56752,53,57000,53,allow,182,93,89,2,30,1,1
50116,22,50116,22,allow,146,60,86,2,9,1,1
56308,53,17371,53,allow,814,110,704,2,30,1,1
57168,53,20859,53,allow,760,96,664,2,30,1,1
55896,53,31620,53,allow,168,86,82,2,30,1,1
57331,53,59568,53,allow,172,88,84,2,30,1,1
63972,53,23173,53,allow,186,95,91,2,30,1,1
37151,80,11771,80,allow,130,70,60,2,15,1,1
59933,80,6671,80,allow,582,138,444,9,25,3,6
56336,53,24893,53,allow,172,88,84,2,30,1,1
60581,53,60581,53,allow,197,76,121,2,30,1,1
56040,53,54233,53,allow,761,100,661,2,30,1,1
56231,53,34438,53,allow,757,98,659,2,30,1,1
49797,53,55138,53,allow,767,102,665,2,31,1,1
56677,53,31185,53,allow,767,102,665,2,31,1,1
55940,53,33630,53,allow,742,88,654,2,30,1,1
57341,53,29078,53,allow,184,94,90,2,31,1,1
35981,53,35981,53,allow,227,89,138,2,31,1,1
57200,53,22685,53,allow,770,102,668,2,31,1,1
52040,53,52040,53,allow,251,98,153,2,31,1,1
65048,53,54954,53,allow,754,94,660,2,31,1,1
49944,53,20178,53,allow,192,98,94,2,31,1,1
55735,53,13880,53,allow,198,101,97,2,31,1,1
49885,53,17170,53,allow,760,97,663,2,31,1,1
55323,53,14352,53,allow,172,88,84,2,31,1,1
64679,53,50625,53,allow,172,88,84,2,31,1,1
56490,53,61381,53,allow,744,89,655,2,31,1,1
56377,53,45673,53,allow,793,101,692,2,31,1,1
56940,53,36969,53,allow,200,102,98,2,31,1,1
56349,53,17487,53,allow,216,110,106,2,31,1,1
49823,53,45548,53,allow,202,103,99,2,31,1,1
55920,53,34293,53,allow,810,108,702,2,31,1,1
55468,53,52823,53,allow,754,94,660,2,31,1,1
64068,53,56393,53,allow,168,86,82,2,31,1,1
55624,53,14345,53,allow,198,101,97,2,31,1,1
55419,53,50922,53,allow,760,97,663,2,31,1,1
55520,53,33643,53,allow,188,96,92,2,31,1,1
56852,53,36624,53,allow,762,101,661,2,31,1,1
62786,445,0,0,drop,70,70,0,1,0,1,0
51197,445,0,0,drop,70,70,0,1,0,1,0
50145,53,7031,53,allow,184,94,90,2,30,1,1
51194,445,0,0,drop,70,70,0,1,0,1,0
62781,445,0,0,drop,70,70,0,1,0,1,0
62956,445,0,0,drop,66,66,0,1,0,1,0
62953,445,0,0,drop,66,66,0,1,0,1,0
55210,53,63664,53,allow,969,86,883,2,30,1,1
65275,53,12888,53,allow,370,126,244,2,30,1,1
56019,53,13898,53,allow,194,102,92,2,30,1,1
64739,53,17167,53,allow,178,94,84,2,30,1,1
49514,53,53009,53,allow,749,94,655,2,30,1,1
56336,53,15481,53,allow,489,88,401,4,46,2,2
49762,53,30143,53,allow,819,102,717,2,29,1,1
59833,53,30174,53,allow,377,86,291,2,29,1,1
54981,53,59429,53,allow,757,102,655,2,29,1,1
56202,53,55288,53,allow,819,102,717,2,29,1,1
65283,53,11652,53,allow,333,102,231,2,29,1,1
57322,53,53567,53,allow,196,102,94,2,29,1,1
64806,53,37126,53,allow,211,102,109,2,29,1,1
50035,53,20021,53,allow,308,102,206,2,29,1,1
53609,53,21780,53,allow,385,94,291,2,30,1,1
57417,53,39419,53,allow,199,102,97,2,30,1,1
49341,53,21121,53,allow,392,86,306,2,29,1,1
64106,53,52132,53,allow,195,102,93,2,29,1,1
64790,53,60024,53,allow,178,94,84,2,29,1,1
49746,53,29622,53,allow,185,102,83,2,30,1,1
49203,53,4131,53,allow,403,99,304,4,32,2,2
55786,53,64576,53,allow,193,102,91,2,29,1,1
49762,53,6291,53,allow,196,102,94,2,29,1,1
49449,53,37523,53,allow,216,110,106,2,29,1,1
63972,53,24077,53,allow,193,102,91,2,29,1,1
57221,53,46489,53,allow,184,102,82,2,29,1,1
49226,53,7327,53,allow,194,102,92,2,29,1,1
64065,53,56733,53,allow,264,94,170,2,29,1,1
56336,53,34970,53,allow,178,94,84,2,29,1,1
57331,53,50054,53,allow,178,94,84,2,30,1,1
50286,53,44602,53,allow,766,102,664,2,30,1,1
49673,53,51744,53,allow,421,88,333,4,39,2,2
65261,53,11148,53,allow,313,97,216,4,56,2,2
56560,53,3085,53,allow,199,102,97,2,30,1,1
65279,53,39619,53,allow,183,94,89,2,30,1,1
57339,53,52334,53,allow,196,94,102,2,30,1,1
55896,53,34756,53,allow,168,86,82,2,30,1,1
64068,53,31141,53,allow,168,86,82,2,30,1,1
49746,53,23888,53,allow,177,94,83,2,30,1,1
56100,53,6720,53,allow,216,110,106,2,30,1,1
64068,53,47417,53,allow,168,86,82,2,31,1,1
56667,80,26674,80,allow,234,234,0,4,12,4,0
49604,53,29008,53,allow,969,86,883,2,30,1,1
50145,53,3618,53,allow,807,94,713,2,30,1,1
49782,80,45830,80,allow,130,70,60,2,15,1,1
56560,53,4551,53,allow,199,102,97,2,30,1,1
65106,53,10929,53,allow,193,102,91,2,30,1,1
50234,53,13512,53,allow,242,78,164,2,30,1,1
64715,53,60767,53,allow,315,98,217,4,58,2,2
49910,53,38613,53,allow,218,94,124,2,30,1,1
65279,53,57423,53,allow,183,94,89,2,30,1,1
57417,53,7685,53,allow,199,102,97,2,30,1,1
49652,53,26066,53,allow,229,110,119,2,30,1,1
65111,53,19274,53,allow,355,96,259,4,38,2,2
55989,53,12782,53,allow,821,102,719,2,30,1,1
50559,53,61943,53,allow,216,110,106,2,30,1,1
65099,53,58455,53,allow,199,102,97,2,30,1,1
65174,53,57194,53,allow,214,110,104,2,30,1,1
58322,53,41674,53,allow,352,78,274,2,30,1,1
50829,53,16960,53,allow,168,78,90,2,30,1,1
49965,53,5956,53,allow,257,110,147,2,30,1,1
55896,53,64776,53,allow,168,86,82,2,30,1,1
55591,53,22310,53,allow,195,102,93,2,30,1,1
64051,53,27383,53,allow,430,172,258,6,59,3,3
56108,53,60144,53,allow,298,92,206,4,41,2,2
55268,53,38039,53,allow,318,91,227,4,33,2,2
60166,80,1732,80,allow,186,64,122,4,28,2,2
49628,53,16334,53,allow,168,86,82,2,31,1,1
55830,443,44368,443,allow,62,62,0,1,5,1,0
65036,53,9458,53,allow,199,102,97,2,29,1,1
49426,53,14946,53,allow,492,91,401,4,56,2,2
49412,53,45661,53,allow,761,102,659,2,29,1,1
64853,53,57521,53,allow,814,110,704,2,29,1,1
57174,53,49887,53,allow,293,86,207,2,29,1,1
56963,53,37570,53,allow,199,102,97,2,29,1,1
49456,53,27659,53,allow,360,110,250,2,29,1,1
56603,53,47573,53,allow,168,86,82,2,29,1,1
65428,53,15132,53,allow,195,102,93,2,29,1,1
64791,53,19745,53,allow,763,102,661,2,29,1,1
65064,53,48752,53,allow,821,102,719,2,29,1,1
64790,53,14045,53,allow,178,94,84,2,29,1,1
65036,53,55693,53,allow,199,102,97,2,29,1,1
57331,53,57928,53,allow,178,94,84,2,29,1,1
65008,53,11411,53,allow,276,118,158,2,29,1,1
56560,53,17987,53,allow,199,102,97,2,30,1,1
65099,53,38778,53,allow,199,102,97,2,29,1,1
56340,53,44693,53,allow,198,102,96,2,30,1,1
64742,53,7062,53,allow,338,110,228,2,30,1,1
56202,53,15464,53,allow,196,102,94,2,29,1,1
50559,53,13725,53,allow,216,110,106,2,29,1,1
65518,53,57051,53,allow,198,94,104,2,30,1,1
49697,53,7185,53,allow,195,94,101,2,30,1,1
55069,53,50203,53,allow,195,102,93,2,30,1,1
49504,53,3816,53,allow,198,94,104,2,30,1,1
49823,53,39665,53,allow,209,110,99,2,31,1,1
56340,53,42393,53,allow,198,102,96,2,30,1,1
49238,53,61405,53,allow,274,94,180,2,30,1,1
65028,53,41163,53,allow,265,94,171,2,30,1,1
50045,53,44466,53,allow,168,86,82,2,31,1,1
56349,53,28965,53,allow,216,110,106,2,31,1,1
64627,53,12613,53,allow,184,102,82,2,31,1,1
64641,53,15849,53,allow,193,94,99,2,30,1,1
65106,53,42197,53,allow,193,102,91,2,30,1,1
57417,53,46711,53,allow,199,102,97,2,30,1,1
55896,53,48962,53,allow,168,86,82,2,30,1,1
54225,53,12389,53,allow,274,78,196,2,30,1,1
65406,53,43109,53,allow,273,102,171,2,30,1,1
49891,53,34490,53,allow,166,86,80,2,30,1,1
56703,53,53438,53,allow,199,102,97,2,30,1,1
56603,53,32862,53,allow,168,86,82,2,30,1,1
55684,53,8013,53,allow,214,110,104,2,30,1,1
55134,53,13756,53,allow,214,110,104,2,30,1,1
56703,53,19999,53,allow,199,102,97,2,30,1,1
55134,53,17370,53,allow,214,110,104,2,30,1,1
56772,53,46490,53,allow,185,102,83,2,31,1,1
56633,53,58541,53,allow,166,86,80,2,30,1,1
65499,53,27799,53,allow,167,86,81,2,30,1,1
49918,53,55343,53,allow,396,88,308,4,59,2,2
64934,53,9879,53,allow,216,94,122,2,30,1,1
44014,53,29782,53,allow,199,94,105,2,30,1,1
65248,53,32569,53,allow,779,86,693,2,30,1,1
65174,53,23443,53,allow,214,110,104,2,30,1,1
50346,53,1416,53,allow,168,78,90,2,30,1,1
54286,123,33034,123,allow,184,94,90,2,30,1,1
56100,53,20590,53,allow,216,110,106,2,30,1,1
56963,53,36385,53,allow,199,102,97,2,30,1,1
64393,53,12221,53,allow,183,94,89,2,31,1,1
50207,53,41164,53,allow,189,102,87,2,30,1,1
57316,53,57316,53,allow,216,82,134,2,32,1,1
55989,53,12123,53,allow,198,102,96,2,30,1,1
54167,53,8254,53,allow,210,94,116,2,30,1,1
55684,53,46714,53,allow,214,110,104,2,30,1,1
55551,53,53923,53,allow,180,94,86,2,30,1,1
56231,53,22476,53,allow,779,86,693,2,30,1,1
57322,53,59513,53,allow,196,102,94,2,30,1,1
49348,53,21322,53,allow,749,94,655,2,30,1,1
55624,53,50480,53,allow,199,102,97,2,30,1,1
49156,53,59173,53,allow,195,102,93,2,30,1,1
65428,53,61145,53,allow,195,102,93,2,30,1,1
56340,53,40288,53,allow,198,102,96,2,30,1,1
50218,53,36162,53,allow,165,86,79,2,31,1,1
49156,53,49438,53,allow,195,102,93,2,30,1,1
50267,53,48112,53,allow,734,94,640,2,31,1,1
65038,53,49241,53,allow,173,94,79,2,31,1,1
55591,53,62499,53,allow,195,102,93,2,31,1,1
56117,53,32150,53,allow,178,94,84,2,31,1,1
57341,53,25205,53,allow,184,94,90,2,30,1,1
64679,53,60915,53,allow,178,94,84,2,30,1,1
55323,53,20826,53,allow,178,94,84,2,30,1,1
49606,53,26399,53,allow,231,110,121,2,31,1,1
49944,53,39307,53,allow,196,102,94,2,31,1,1
55134,53,55976,53,allow,214,110,104,2,31,1,1
56272,53,59359,53,allow,167,86,81,2,31,1,1
65471,53,50193,53,allow,498,204,294,6,31,3,3
50207,53,12070,53,allow,189,102,87,2,31,1,1
55887,53,54286,53,allow,166,86,80,2,31,1,1
64979,53,62369,53,allow,754,94,660,2,30,1,1
64130,53,8273,53,allow,215,94,121,2,31,1,1
57341,53,32411,53,allow,184,94,90,2,31,1,1
49203,53,46082,53,allow,168,86,82,2,31,1,1
65187,53,58684,53,allow,199,102,97,2,31,1,1
55069,53,19618,53,allow,195,102,93,2,31,1,1
56703,53,34394,53,allow,199,102,97,2,31,1,1
59179,80,14130,80,allow,1399,762,637,10,76,6,4
64503,53,62802,53,allow,477,87,390,4,37,2,2
51184,445,0,0,drop,70,70,0,1,0,1,0
51177,445,0,0,drop,70,70,0,1,0,1,0
51176,445,0,0,drop,70,70,0,1,0,1,0
51175,445,0,0,drop,70,70,0,1,0,1,0
62951,445,0,0,drop,66,66,0,1,0,1,0
62768,445,0,0,drop,70,70,0,1,0,1,0
62941,445,0,0,drop,66,66,0,1,0,1,0
62939,445,0,0,drop,66,66,0,1,0,1,0
62944,445,0,0,drop,66,66,0,1,0,1,0
62945,445,0,0,drop,66,66,0,1,0,1,0
62940,445,0,0,drop,66,66,0,1,0,1,0
62937,445,0,0,drop,66,66,0,1,0,1,0
62935,445,0,0,drop,66,66,0,1,0,1,0
62765,445,0,0,drop,70,70,0,1,0,1,0
51171,445,0,0,drop,70,70,0,1,0,1,0
51167,445,0,0,drop,70,70,0,1,0,1,0
51164,445,0,0,drop,70,70,0,1,0,1,0
51163,445,0,0,drop,70,70,0,1,0,1,0
62760,445,0,0,drop,70,70,0,1,0,1,0
62759,445,0,0,drop,70,70,0,1,0,1,0
62757,445,0,0,drop,70,70,0,1,0,1,0
51160,445,0,0,drop,70,70,0,1,0,1,0
51159,445,0,0,drop,70,70,0,1,0,1,0
51158,445,0,0,drop,70,70,0,1,0,1,0
62929,445,0,0,drop,66,66,0,1,0,1,0
51154,445,0,0,drop,70,70,0,1,0,1,0
62926,445,0,0,drop,66,66,0,1,0,1,0
62923,445,0,0,drop,66,66,0,1,0,1,0
62922,445,0,0,drop,66,66,0,1,0,1,0
62921,445,0,0,drop,66,66,0,1,0,1,0
62750,445,0,0,drop,70,70,0,1,0,1,0
62748,445,0,0,drop,70,70,0,1,0,1,0
51149,445,0,0,drop,70,70,0,1,0,1,0
62747,445,0,0,drop,70,70,0,1,0,1,0
51145,445,0,0,drop,70,70,0,1,0,1,0
51143,445,0,0,drop,70,70,0,1,0,1,0
62746,445,0,0,drop,70,70,0,1,0,1,0
62745,445,0,0,drop,70,70,0,1,0,1,0
62743,445,0,0,drop,70,70,0,1,0,1,0
62739,445,0,0,drop,70,70,0,1,0,1,0
62909,445,0,0,drop,66,66,0,1,0,1,0
62727,445,0,0,drop,70,70,0,1,0,1,0
62725,445,0,0,drop,70,70,0,1,0,1,0
62723,445,0,0,drop,70,70,0,1,0,1,0
62717,445,0,0,drop,70,70,0,1,0,1,0
62716,445,0,0,drop,70,70,0,1,0,1,0
62902,445,0,0,drop,66,66,0,1,0,1,0
51126,445,0,0,drop,70,70,0,1,0,1,0
62900,445,0,0,drop,66,66,0,1,0,1,0
62705,445,0,0,drop,70,70,0,1,0,1,0
62893,445,0,0,drop,66,66,0,1,0,1,0
62889,445,0,0,drop,66,66,0,1,0,1,0
62701,445,0,0,drop,70,70,0,1,0,1,0
51118,445,0,0,drop,70,70,0,1,0,1,0
51116,445,0,0,drop,70,70,0,1,0,1,0
51114,445,0,0,drop,70,70,0,1,0,1,0
62690,445,0,0,drop,70,70,0,1,0,1,0
62872,445,0,0,drop,66,66,0,1,0,1,0
62691,445,0,0,drop,70,70,0,1,0,1,0
62876,445,0,0,drop,66,66,0,1,0,1,0
62875,445,0,0,drop,66,66,0,1,0,1,0
62692,445,0,0,drop,70,70,0,1,0,1,0
62870,445,0,0,drop,66,66,0,1,0,1,0
62877,445,0,0,drop,66,66,0,1,0,1,0
62871,445,0,0,drop,66,66,0,1,0,1,0
62869,445,0,0,drop,66,66,0,1,0,1,0
62874,445,0,0,drop,66,66,0,1,0,1,0
62687,445,0,0,drop,70,70,0,1,0,1,0
62684,445,0,0,drop,70,70,0,1,0,1,0
51111,445,0,0,drop,70,70,0,1,0,1,0
51108,445,0,0,drop,70,70,0,1,0,1,0
51097,445,0,0,drop,70,70,0,1,0,1,0
51098,445,0,0,drop,70,70,0,1,0,1,0
62679,445,0,0,drop,70,70,0,1,0,1,0
62857,445,0,0,drop,66,66,0,1,0,1,0
62856,445,0,0,drop,66,66,0,1,0,1,0
62854,445,0,0,drop,66,66,0,1,0,1,0
62671,445,0,0,drop,70,70,0,1,0,1,0
51095,445,0,0,drop,70,70,0,1,0,1,0
55443,53,49327,53,allow,188,96,92,2,30,1,1
64721,53,36880,53,allow,212,108,104,2,30,1,1
49156,53,9695,53,allow,190,97,93,2,30,1,1
55551,53,29205,53,allow,176,90,86,2,30,1,1
55070,80,64489,80,allow,246,120,126,5,16,3,2
55812,53,55812,53,allow,235,90,145,2,32,1,1
55782,53,37884,53,allow,728,96,632,2,30,1,1
49605,53,30084,53,allow,756,95,661,2,30,1,1
52240,443,52240,443,allow,1615,941,674,15,21,7,8
42607,443,22766,443,allow,167,107,60,2,5,1,1
46673,80,11851,80,allow,1151,711,440,10,15,5,5
55031,53,63225,53,allow,756,95,661,2,31,1,1
61099,443,1871,443,allow,82,82,0,1,5,1,0
49203,53,20527,53,allow,168,86,82,2,31,1,1
55690,53,56846,53,allow,182,93,89,2,30,1,1
55946,53,3113,53,allow,762,98,664,2,31,1,1
45051,53,45051,53,allow,404,259,145,3,32,2,1
65187,53,4197,53,allow,198,101,97,2,30,1,1
61196,53,61196,53,allow,213,79,134,2,32,1,1
50678,80,40361,80,allow,300,174,126,5,15,3,2
59951,80,3769,80,allow,1221,339,882,9,16,5,4
49570,443,54043,443,allow,1013,492,521,10,30,4,6
64393,53,49935,53,allow,182,93,89,2,31,1,1
55134,53,14594,53,allow,212,108,104,2,30,1,1
48206,53,48206,53,allow,253,99,154,2,30,1,1
50346,53,56767,53,allow,760,97,663,2,30,1,1
56756,53,42523,53,allow,760,97,663,2,30,1,1
56871,53,58198,53,allow,745,93,652,2,30,1,1
57196,53,22247,53,allow,754,94,660,2,31,1,1
56285,53,7225,53,allow,751,95,656,2,31,1,1
56266,53,14847,53,allow,186,95,91,2,31,1,1
55481,53,35011,53,allow,758,96,662,2,30,1,1
56045,53,39272,53,allow,731,91,640,2,30,1,1
55335,53,8773,53,allow,754,94,660,2,30,1,1
49415,53,54397,53,allow,188,96,92,2,31,1,1
56062,53,2393,53,allow,192,98,94,2,31,1,1
56847,53,17178,53,allow,761,100,661,2,31,1,1
64554,53,25900,53,allow,198,101,97,2,31,1,1
49650,53,49396,53,allow,776,102,674,2,31,1,1
55887,53,42850,53,allow,164,84,80,2,31,1,1
55972,53,38960,53,allow,756,95,661,2,31,1,1
65291,53,61483,53,allow,190,97,93,2,31,1,1
56117,53,31292,53,allow,172,88,84,2,31,1,1
55818,53,21143,53,allow,775,103,672,2,31,1,1
64782,53,40065,53,allow,758,93,665,2,31,1,1
64140,53,60265,53,allow,184,94,90,2,31,1,1
59117,53,0,0,allow,82,82,0,1,31,1,0
55889,53,49760,53,allow,198,101,97,2,31,1,1
56756,53,46487,53,allow,166,85,81,2,31,1,1
57023,53,64217,53,allow,174,89,85,2,31,1,1
56502,53,50256,53,allow,726,85,641,2,31,1,1
56127,53,8590,53,allow,166,85,81,2,31,1,1
56973,53,12553,53,allow,186,95,91,2,31,1,1
57382,53,8955,53,allow,184,94,90,2,31,1,1
56550,53,58694,53,allow,84,84,0,1,31,1,0
55541,53,53785,53,allow,772,100,672,2,31,1,1
62670,445,0,0,drop,70,70,0,1,0,1,0
51087,445,0,0,drop,70,70,0,1,0,1,0
51084,445,0,0,drop,70,70,0,1,0,1,0
51088,445,0,0,drop,70,70,0,1,0,1,0
62664,445,0,0,drop,70,70,0,1,0,1,0
62663,445,0,0,drop,70,70,0,1,0,1,0
49156,53,43723,53,allow,195,102,93,2,32,1,1
57331,53,27996,53,allow,164,86,78,2,30,1,1
62659,445,0,0,drop,70,70,0,1,0,1,0
51077,445,0,0,drop,70,70,0,1,0,1,0
51075,445,0,0,drop,70,70,0,1,0,1,0
51072,445,0,0,drop,70,70,0,1,0,1,0
62658,445,0,0,drop,70,70,0,1,0,1,0
62845,445,0,0,drop,66,66,0,1,0,1,0
62651,445,0,0,drop,70,70,0,1,0,1,0
51068,445,0,0,drop,70,70,0,1,0,1,0
51067,445,0,0,drop,70,70,0,1,0,1,0
62830,445,0,0,drop,66,66,0,1,0,1,0
62829,445,0,0,drop,66,66,0,1,0,1,0
51058,445,0,0,drop,70,70,0,1,0,1,0
51055,445,0,0,drop,70,70,0,1,0,1,0
51054,445,0,0,drop,70,70,0,1,0,1,0
62638,445,0,0,drop,70,70,0,1,0,1,0
62821,445,0,0,drop,66,66,0,1,0,1,0
56940,53,28824,53,allow,200,102,98,2,30,1,1
55690,53,37274,53,allow,183,94,89,2,30,1,1
56062,53,34305,53,allow,196,102,94,2,30,1,1
49284,53,21270,53,allow,177,94,83,2,30,1,1
64068,53,59683,53,allow,168,86,82,2,30,1,1
55922,53,5571,53,allow,807,94,713,2,29,1,1
50218,53,12883,53,allow,165,86,79,2,29,1,1
57651,80,10587,80,allow,1151,711,440,10,15,5,5
55443,53,14959,53,allow,194,102,92,2,30,1,1
56062,53,55511,53,allow,196,102,94,2,30,1,1
53722,443,10654,443,allow,70,70,0,2,7,2,0
65127,443,37615,443,allow,146,64,82,3,9,2,1
64146,53,50563,53,allow,308,99,209,4,39,2,2
55922,53,13122,53,allow,184,94,90,2,29,1,1
56349,53,42172,53,allow,216,110,106,2,29,1,1
64444,53,35858,53,allow,183,94,89,2,29,1,1
65187,53,35953,53,allow,199,102,97,2,29,1,1
65499,53,26043,53,allow,167,86,81,2,29,1,1
49823,53,8034,53,allow,209,110,99,2,29,1,1
56772,53,30219,53,allow,185,102,83,2,29,1,1
64051,53,30405,53,allow,1114,468,646,12,67,6,6
64679,53,2951,53,allow,178,94,84,2,30,1,1
55551,53,64054,53,allow,180,94,86,2,29,1,1
64858,53,43430,53,allow,211,102,109,2,30,1,1
49415,53,4512,53,allow,194,102,92,2,30,1,1
57374,53,58495,53,allow,216,102,114,2,30,1,1
56423,53,58524,53,allow,168,86,82,2,30,1,1
61060,53,35678,53,allow,311,94,217,2,30,1,1
64721,53,18309,53,allow,214,110,104,2,30,1,1
49284,53,55787,53,allow,185,102,83,2,30,1,1
60870,53,30144,53,allow,220,94,126,2,30,1,1
56272,53,1689,53,allow,167,86,81,2,30,1,1
55735,53,9793,53,allow,199,102,97,2,30,1,1
50045,53,13478,53,allow,168,86,82,2,30,1,1
64329,53,38742,53,allow,479,111,368,4,50,2,2
65089,53,28362,53,allow,199,102,97,2,30,1,1
56622,53,10987,53,allow,214,110,104,2,30,1,1
50377,53,41134,53,allow,214,110,104,2,30,1,1
55887,53,55834,53,allow,166,86,80,2,30,1,1
56323,53,21945,53,allow,168,94,74,2,30,1,1
65089,53,20611,53,allow,199,102,97,2,30,1,1
56215,53,9049,53,allow,165,86,79,2,30,1,1
49609,53,44822,53,allow,754,94,660,2,30,1,1
55443,53,18885,53,allow,194,102,92,2,30,1,1
64721,53,29674,53,allow,214,110,104,2,30,1,1
56323,53,5698,53,allow,152,78,74,2,30,1,1
56622,53,31873,53,allow,214,110,104,2,30,1,1
49710,53,33849,53,allow,183,102,81,2,30,1,1
65387,53,9016,53,allow,221,94,127,2,30,1,1
49342,53,10156,53,allow,443,182,261,6,30,3,3
64506,53,14791,53,allow,230,94,136,2,30,1,1
49710,53,1886,53,allow,183,102,81,2,30,1,1
55690,53,57021,53,allow,183,94,89,2,30,1,1
64792,53,60591,53,allow,166,86,80,2,30,1,1
56127,53,6171,53,allow,167,86,81,2,30,1,1
57319,53,4407,53,allow,189,102,87,2,30,1,1
63991,80,39490,80,allow,314,192,122,6,15,4,2
65119,53,47223,53,allow,568,188,380,6,60,3,3
64689,53,47457,53,allow,763,102,661,2,30,1,1
36013,53,23635,53,allow,86,86,0,1,30,1,0
49505,53,42199,53,allow,225,110,115,2,30,1,1
65187,53,40747,53,allow,345,101,244,4,53,2,2
57331,53,30032,53,allow,172,94,78,2,30,1,1
64493,53,17644,53,allow,280,97,183,4,60,2,2
55132,53,34901,53,allow,889,404,485,10,30,5,5
49741,53,35577,53,allow,766,102,664,2,30,1,1
49795,53,15978,53,allow,209,110,99,2,30,1,1
60710,53,32625,53,allow,211,78,133,2,30,1,1
50026,53,4265,53,allow,395,99,296,4,57,2,2
64297,53,43105,53,allow,364,94,270,4,49,2,2
54106,80,38158,80,allow,78,78,0,1,5,1,0
64512,53,2401,53,allow,524,91,433,4,34,2,2
56739,80,48782,80,allow,1462,703,759,8,16,5,3
49588,53,53938,53,allow,733,94,639,2,29,1,1
65134,53,52533,53,allow,812,110,702,2,29,1,1
64444,53,57791,53,allow,183,94,89,2,29,1,1
56752,53,3213,53,allow,183,94,89,2,29,1,1
64679,53,32723,53,allow,328,88,240,4,32,2,2
56047,443,45831,443,allow,126,60,66,3,4,2,1
50377,53,58981,53,allow,214,110,104,2,30,1,1
64309,53,55479,53,allow,549,188,361,6,57,3,3
49347,53,23678,53,allow,342,91,251,4,54,2,2
55520,53,61502,53,allow,194,102,92,2,30,1,1
55520,53,61056,53,allow,194,102,92,2,29,1,1
56254,53,3663,53,allow,498,204,294,6,30,3,3
64721,53,12160,53,allow,466,108,358,4,45,2,2
64748,53,3750,53,allow,168,94,74,2,29,1,1
64128,53,22207,53,allow,194,94,100,2,31,1,1
54519,443,46768,443,allow,70,70,0,1,5,1,0
64748,53,7421,53,allow,152,78,74,2,30,1,1
57319,53,9103,53,allow,189,102,87,2,30,1,1
55624,53,2352,53,allow,199,102,97,2,30,1,1
49527,53,33639,53,allow,173,94,79,2,30,1,1
56622,53,54285,53,allow,214,110,104,2,30,1,1
56134,53,5515,53,allow,183,94,89,2,29,1,1
64744,53,61506,53,allow,770,102,668,2,29,1,1
49614,53,25029,53,allow,380,110,270,2,29,1,1
56215,53,29779,53,allow,165,86,79,2,30,1,1
64657,53,3237,53,allow,193,102,91,2,30,1,1
55714,53,2036,53,allow,165,86,79,2,30,1,1
64060,53,33741,53,allow,258,110,148,2,30,1,1
56304,53,62384,53,allow,443,182,261,6,31,3,3
50228,53,44907,53,allow,173,94,79,2,30,1,1
55463,53,8245,53,allow,193,102,91,2,30,1,1
65142,53,52457,53,allow,167,86,81,2,30,1,1
56266,53,65060,53,allow,193,102,91,2,30,1,1
64140,53,44344,53,allow,184,94,90,2,31,1,1
49415,53,62672,53,allow,194,102,92,2,30,1,1
63139,53,20764,53,allow,234,234,0,4,47,4,0
49476,53,34696,53,allow,764,102,662,2,30,1,1
64052,53,55826,53,allow,232,102,130,2,30,1,1
56136,53,4435,53,allow,733,94,639,2,30,1,1
65056,53,56800,53,allow,270,94,176,2,30,1,1
49944,53,37550,53,allow,196,102,94,2,30,1,1
56388,53,30178,53,allow,165,86,79,2,30,1,1
64178,53,3511,53,allow,276,94,182,2,30,1,1
55735,53,16181,53,allow,199,102,97,2,30,1,1
49527,53,30173,53,allow,165,86,79,2,30,1,1
56349,53,21926,53,allow,216,110,106,2,30,1,1
65006,53,44331,53,allow,763,102,661,2,30,1,1
56738,80,55725,80,allow,1462,703,759,8,16,5,3
65038,53,25509,53,allow,165,86,79,2,30,1,1
49844,53,19437,53,allow,734,102,632,2,30,1,1
64627,53,26278,53,allow,168,86,82,2,30,1,1
56940,53,50066,53,allow,200,102,98,2,30,1,1
55979,53,24460,53,allow,168,86,82,2,30,1,1
56388,53,39602,53,allow,173,94,79,2,30,1,1
55551,53,65057,53,allow,180,94,86,2,30,1,1
53831,53,28587,53,allow,260,86,174,2,30,1,1
49636,53,12225,53,allow,180,94,86,2,30,1,1
54105,80,38446,80,allow,78,78,0,1,5,1,0
50377,53,60945,53,allow,214,110,104,2,30,1,1
55735,53,42351,53,allow,199,102,97,2,30,1,1
65220,53,61957,53,allow,811,94,717,2,30,1,1
65291,53,24701,53,allow,195,102,93,2,30,1,1
49203,53,46894,53,allow,168,86,82,2,30,1,1
64792,53,47254,53,allow,166,86,80,2,30,1,1
64554,53,41182,53,allow,199,102,97,2,30,1,1
56117,53,21155,53,allow,178,94,84,2,30,1,1
46851,53,12035,53,allow,168,78,90,2,30,1,1
55443,53,14783,53,allow,194,102,92,2,30,1,1
50228,53,36486,53,allow,173,94,79,2,30,1,1
64393,53,36156,53,allow,183,94,89,2,30,1,1
49388,53,27609,53,allow,215,102,113,2,30,1,1
41107,53,24186,53,allow,168,78,90,2,30,1,1
64376,53,46569,53,allow,247,94,153,2,30,1,1
64657,53,42843,53,allow,816,102,714,2,30,1,1
56423,53,27855,53,allow,184,102,82,2,30,1,1
50071,53,62204,53,allow,458,188,270,6,30,3,3
49415,53,16500,53,allow,194,102,92,2,30,1,1
55856,53,56508,53,allow,265,94,171,2,30,1,1
60709,53,36089,53,allow,260,86,174,2,30,1,1
49765,53,13036,53,allow,194,102,92,2,31,1,1
56379,53,59317,53,allow,166,86,80,2,30,1,1
49574,53,25202,53,allow,816,102,714,2,30,1,1
57334,53,42427,53,allow,184,94,90,2,30,1,1
55367,53,46146,53,allow,195,102,93,2,31,1,1
57053,53,53183,53,allow,173,94,79,2,31,1,1
57333,53,36710,53,allow,167,86,81,2,31,1,1
65417,53,49087,53,allow,402,118,284,2,30,1,1
55889,53,7647,53,allow,199,102,97,2,30,1,1
56379,53,29859,53,allow,166,86,80,2,31,1,1
57023,53,45929,53,allow,179,94,85,2,31,1,1
49966,53,36472,53,allow,182,102,80,2,30,1,1
56266,53,13342,53,allow,193,102,91,2,31,1,1
64393,53,13343,53,allow,183,94,89,2,31,1,1
57382,53,16095,53,allow,184,94,90,2,31,1,1
57323,53,24768,53,allow,194,102,92,2,31,1,1
55141,53,56040,53,allow,184,94,90,2,31,1,1
58934,53,32905,53,allow,205,86,119,2,30,1,1
49966,53,59809,53,allow,166,86,80,2,30,1,1
64140,53,48538,53,allow,184,94,90,2,30,1,1
56195,53,54925,53,allow,811,94,717,2,30,1,1
65139,53,1458,53,allow,216,110,106,2,30,1,1
55714,53,64632,53,allow,173,94,79,2,30,1,1
64853,53,20952,53,allow,199,102,97,2,31,1,1
55887,53,33560,53,allow,166,86,80,2,31,1,1
57430,53,3513,53,allow,200,102,98,2,31,1,1
65139,53,19988,53,allow,216,110,106,2,31,1,1
55816,53,60578,53,allow,214,110,104,2,31,1,1
57334,53,60234,53,allow,184,94,90,2,31,1,1
64344,53,48570,53,allow,286,102,184,4,46,2,2
49823,53,25346,53,allow,502,103,399,4,51,2,2
55624,53,59892,53,allow,308,101,207,4,53,2,2
56975,53,16815,53,allow,413,170,243,6,31,3,3
49636,53,15924,53,allow,180,94,86,2,31,1,1
56819,53,17305,53,allow,209,110,99,2,31,1,1
55841,53,16397,53,allow,458,188,270,6,31,3,3
50079,23,0,0,deny,60,60,0,1,0,1,0
62816,445,0,0,drop,66,66,0,1,0,1,0
62810,445,0,0,drop,66,66,0,1,0,1,0
62812,445,0,0,drop,66,66,0,1,0,1,0
62817,445,0,0,drop,66,66,0,1,0,1,0
62813,445,0,0,drop,66,66,0,1,0,1,0
62818,445,0,0,drop,66,66,0,1,0,1,0
62811,445,0,0,drop,66,66,0,1,0,1,0
51042,445,0,0,drop,70,70,0,1,0,1,0
51035,445,0,0,drop,70,70,0,1,0,1,0
51038,445,0,0,drop,70,70,0,1,0,1,0
62630,445,0,0,drop,70,70,0,1,0,1,0
62629,445,0,0,drop,70,70,0,1,0,1,0
62627,445,0,0,drop,70,70,0,1,0,1,0
51031,445,0,0,drop,70,70,0,1,0,1,0
51028,445,0,0,drop,70,70,0,1,0,1,0
62802,445,0,0,drop,66,66,0,1,0,1,0
51026,445,0,0,drop,70,70,0,1,0,1,0
62798,445,0,0,drop,66,66,0,1,0,1,0
58880,443,32825,443,allow,1413,876,537,12,11,6,6
62795,445,0,0,drop,66,66,0,1,0,1,0
62794,445,0,0,drop,66,66,0,1,0,1,0
62620,445,0,0,drop,70,70,0,1,0,1,0
62792,445,0,0,drop,66,66,0,1,0,1,0
62618,445,0,0,drop,70,70,0,1,0,1,0
62617,445,0,0,drop,70,70,0,1,0,1,0
62616,445,0,0,drop,70,70,0,1,0,1,0
62615,445,0,0,drop,70,70,0,1,0,1,0
62609,445,0,0,drop,70,70,0,1,0,1,0
62610,445,0,0,drop,70,70,0,1,0,1,0
51009,445,0,0,drop,70,70,0,1,0,1,0
62781,445,0,0,drop,66,66,0,1,0,1,0
62597,445,0,0,drop,70,70,0,1,0,1,0
62595,445,0,0,drop,70,70,0,1,0,1,0
62591,445,0,0,drop,70,70,0,1,0,1,0
62587,445,0,0,drop,70,70,0,1,0,1,0
62586,445,0,0,drop,70,70,0,1,0,1,0
62774,445,0,0,drop,66,66,0,1,0,1,0
62772,445,0,0,drop,66,66,0,1,0,1,0
62575,445,0,0,drop,70,70,0,1,0,1,0
62765,445,0,0,drop,66,66,0,1,0,1,0
62760,445,0,0,drop,66,66,0,1,0,1,0
62571,445,0,0,drop,70,70,0,1,0,1,0
62560,445,0,0,drop,70,70,0,1,0,1,0
62562,445,0,0,drop,70,70,0,1,0,1,0
62559,445,0,0,drop,70,70,0,1,0,1,0
62557,445,0,0,drop,70,70,0,1,0,1,0
50991,445,0,0,drop,70,70,0,1,0,1,0
50987,445,0,0,drop,70,70,0,1,0,1,0
50986,445,0,0,drop,70,70,0,1,0,1,0
62554,445,0,0,drop,70,70,0,1,0,1,0
62743,445,0,0,drop,66,66,0,1,0,1,0
62748,445,0,0,drop,66,66,0,1,0,1,0
62747,445,0,0,drop,66,66,0,1,0,1,0
62746,445,0,0,drop,66,66,0,1,0,1,0
62744,445,0,0,drop,66,66,0,1,0,1,0
62745,445,0,0,drop,66,66,0,1,0,1,0
62742,445,0,0,drop,66,66,0,1,0,1,0
62741,445,0,0,drop,66,66,0,1,0,1,0
64493,53,24989,53,allow,280,97,183,4,59,2,2
55367,53,8311,53,allow,190,97,93,2,31,1,1
56790,53,40538,53,allow,758,93,665,2,30,1,1
52621,443,59205,443,allow,190,70,120,4,15,2,2
57968,53,57968,53,allow,371,237,134,3,32,2,1
49407,53,35774,53,allow,774,101,673,2,30,1,1
56313,53,15835,53,allow,196,100,96,2,30,1,1
55816,53,28988,53,allow,212,108,104,2,30,1,1
65274,53,19286,53,allow,295,101,194,4,32,2,2
65180,53,33252,53,allow,751,95,656,2,30,1,1
57314,53,61726,53,allow,190,97,93,2,31,1,1
57334,53,10038,53,allow,184,94,90,2,30,1,1
65139,53,15314,53,allow,216,110,106,2,30,1,1
55147,53,40257,53,allow,776,102,674,2,30,1,1
57430,53,32678,53,allow,200,102,98,2,30,1,1
61356,53,61356,53,allow,235,90,145,2,32,1,1
55305,53,52264,53,allow,1448,103,1345,4,54,2,2
52159,80,40700,80,allow,1278,731,547,10,15,6,4
65344,53,21017,53,allow,90,90,0,1,30,1,0
42974,53,0,0,allow,82,82,0,1,30,1,0
57323,53,18058,53,allow,188,96,92,2,31,1,1
56431,53,36582,53,allow,778,103,675,2,31,1,1
49765,53,55763,53,allow,188,96,92,2,31,1,1
39858,443,36124,443,allow,167,107,60,2,5,1,1
64344,53,46040,53,allow,286,102,184,4,45,2,2
63116,53,14772,53,allow,578,286,292,9,15,5,4
47281,443,8413,443,allow,190,70,120,4,15,2,2
56439,53,22467,53,allow,751,95,656,2,30,1,1
41432,53,63040,53,allow,202,83,119,2,30,1,1
65437,53,48894,53,allow,1386,85,1301,4,53,2,2
49253,53,20812,53,allow,198,101,97,2,30,1,1
54973,53,46622,53,allow,178,91,87,2,31,1,1
55127,53,55127,53,allow,220,100,120,2,31,1,1
57340,53,3053,53,allow,747,92,655,2,31,1,1
55141,53,13525,53,allow,184,94,90,2,31,1,1
55268,53,37193,53,allow,186,95,91,2,31,1,1
56964,53,11967,53,allow,774,101,673,2,31,1,1
65204,53,50970,53,allow,182,93,89,2,31,1,1
57351,53,37431,53,allow,184,94,90,2,31,1,1
55056,53,12643,53,allow,202,103,99,2,31,1,1
55220,53,9691,53,allow,186,95,91,2,31,1,1
56711,53,31656,53,allow,202,103,99,2,31,1,1
56126,53,16372,53,allow,774,101,673,2,31,1,1
57416,53,37012,53,allow,771,101,670,2,31,1,1
56819,53,59960,53,allow,202,103,99,2,31,1,1
64020,53,44407,53,allow,192,98,94,2,31,1,1
64896,53,10637,53,allow,716,95,621,2,31,1,1
49636,53,21781,53,allow,176,90,86,2,31,1,1
56857,53,63903,53,allow,190,97,93,2,31,1,1
59899,53,59899,53,allow,194,87,107,2,31,1,1
55415,53,34000,53,allow,182,93,89,2,31,1,1
65132,53,11821,53,allow,166,85,81,2,31,1,1
55123,53,64230,53,allow,196,100,96,2,31,1,1
55577,53,45509,53,allow,198,101,97,2,31,1,1
55688,53,29259,53,allow,184,94,90,2,31,1,1
65505,53,12322,53,allow,164,84,80,2,31,1,1
49628,53,48622,53,allow,168,86,82,2,31,1,1
55003,53,14075,53,allow,192,98,94,2,31,1,1
64816,53,1997,53,allow,164,84,80,2,31,1,1
64853,53,19289,53,allow,198,101,97,2,31,1,1
65495,53,9784,53,allow,202,103,99,2,31,1,1
53144,53,53144,53,allow,231,90,141,2,31,1,1
55224,53,59301,53,allow,180,92,88,2,31,1,1
59919,53,59919,53,allow,231,90,141,2,31,1,1
57386,53,9687,53,allow,186,95,91,2,31,1,1
56532,53,51264,53,allow,186,95,91,2,31,1,1
56543,53,0,0,allow,82,82,0,1,31,1,0
49466,53,56538,53,allow,202,103,99,2,31,1,1
56912,53,37939,53,allow,753,96,657,2,31,1,1
62548,445,0,0,drop,70,70,0,1,0,1,0
50984,445,0,0,drop,70,70,0,1,0,1,0
50973,445,0,0,drop,70,70,0,1,0,1,0
50968,445,0,0,drop,70,70,0,1,0,1,0
62729,445,0,0,drop,66,66,0,1,0,1,0
62728,445,0,0,drop,66,66,0,1,0,1,0
62726,445,0,0,drop,66,66,0,1,0,1,0
62541,445,0,0,drop,70,70,0,1,0,1,0
57323,53,27696,53,allow,194,102,92,2,30,1,1
62540,445,0,0,drop,70,70,0,1,0,1,0
50967,445,0,0,drop,70,70,0,1,0,1,0
50965,445,0,0,drop,70,70,0,1,0,1,0
50964,445,0,0,drop,70,70,0,1,0,1,0
62535,445,0,0,drop,70,70,0,1,0,1,0
62533,445,0,0,drop,70,70,0,1,0,1,0
62529,445,0,0,drop,70,70,0,1,0,1,0
62527,445,0,0,drop,70,70,0,1,0,1,0
50949,445,0,0,drop,70,70,0,1,0,1,0
50947,445,0,0,drop,70,70,0,1,0,1,0
50944,445,0,0,drop,70,70,0,1,0,1,0
62717,445,0,0,drop,66,66,0,1,0,1,0
62523,445,0,0,drop,70,70,0,1,0,1,0
50940,445,0,0,drop,70,70,0,1,0,1,0
50938,445,0,0,drop,70,70,0,1,0,1,0
64585,53,5921,53,allow,198,102,96,2,30,1,1
49448,53,48392,53,allow,210,102,108,2,30,1,1
64585,53,62482,53,allow,821,102,719,2,30,1,1
51644,53,17659,53,allow,195,78,117,2,30,1,1
49241,53,22091,53,allow,785,110,675,2,30,1,1
55180,53,29558,53,allow,209,110,99,2,30,1,1
65274,53,10401,53,allow,295,101,194,4,32,2,2
55979,53,16779,53,allow,184,102,82,2,29,1,1
57023,53,46258,53,allow,179,94,85,2,29,1,1
57430,53,55125,53,allow,185,102,83,2,29,1,1
56127,53,58620,53,allow,167,86,81,2,29,1,1
55520,53,58665,53,allow,194,102,92,2,29,1,1
49580,53,43364,53,allow,782,110,672,2,30,1,1
49723,53,26637,53,allow,209,110,99,2,30,1,1
49990,53,43468,53,allow,198,102,96,2,30,1,1
64344,53,51510,53,allow,286,102,184,4,45,2,2
53762,53,52593,53,allow,168,78,90,2,30,1,1
46834,53,46834,53,allow,235,90,145,2,32,1,1
50679,80,31597,80,allow,62,62,0,1,4,1,0
63984,53,63454,53,allow,264,110,154,2,30,1,1
50651,80,37006,80,allow,1555,1103,452,9,21,5,4
59473,80,31869,80,allow,1052,612,440,10,15,5,5
64344,53,14813,53,allow,568,192,376,6,71,3,3
54969,53,12796,53,allow,199,102,97,2,29,1,1
55816,53,14968,53,allow,214,110,104,2,29,1,1
49599,53,2987,53,allow,732,86,646,2,29,1,1
49291,53,35462,53,allow,212,102,110,2,29,1,1
57382,53,23125,53,allow,184,94,90,2,29,1,1
57053,53,14057,53,allow,173,94,79,2,29,1,1
55889,53,50897,53,allow,199,102,97,2,29,1,1
55690,53,21416,53,allow,183,94,89,2,29,1,1
49723,53,9926,53,allow,209,110,99,2,30,1,1
65477,53,50858,53,allow,209,110,99,2,30,1,1
55628,53,3702,53,allow,198,102,96,2,30,1,1
56313,53,27206,53,allow,198,102,96,2,30,1,1
49446,53,1735,53,allow,403,142,261,2,30,1,1
56247,53,6224,53,allow,215,102,113,2,30,1,1
64231,53,19664,53,allow,196,94,102,2,30,1,1
43154,53,41451,53,allow,168,78,90,2,30,1,1
55141,53,55990,53,allow,184,94,90,2,30,1,1
64020,53,34722,53,allow,196,102,94,2,30,1,1
56756,53,38135,53,allow,167,86,81,2,30,1,1
64307,53,12624,53,allow,463,90,373,4,34,2,2
57139,53,12753,53,allow,816,102,714,2,30,1,1
64853,53,20032,53,allow,199,102,97,2,30,1,1
38643,443,11641,443,allow,1468,893,575,15,62,8,7
65477,53,46159,53,allow,209,110,99,2,30,1,1
55855,53,27713,53,allow,182,102,80,2,30,1,1
56756,53,60834,53,allow,167,86,81,2,30,1,1
41269,443,34077,443,allow,234,234,0,4,12,4,0
57314,53,53459,53,allow,195,102,93,2,30,1,1
56973,53,50381,53,allow,193,102,91,2,30,1,1
55180,53,4513,53,allow,209,110,99,2,30,1,1
38432,53,33848,53,allow,336,231,105,3,30,2,1
65501,53,61730,53,allow,774,102,672,2,30,1,1
65228,53,28840,53,allow,200,102,98,2,30,1,1
49713,53,34138,53,allow,198,94,104,2,30,1,1
49693,53,65326,53,allow,209,110,99,2,30,1,1
56117,53,20260,53,allow,178,94,84,2,30,1,1
53739,53,43732,53,allow,168,78,90,2,30,1,1
65204,53,43316,53,allow,183,94,89,2,30,1,1
49213,53,0,0,allow,333,102,231,2,30,1,1
56226,53,33247,53,allow,200,102,98,2,30,1,1
64748,53,54501,53,allow,183,94,89,2,30,1,1
38621,443,27614,443,allow,1593,946,647,15,64,8,7
60948,53,22265,53,allow,168,78,90,2,30,1,1
45932,53,57917,53,allow,199,94,105,2,30,1,1
56313,53,23049,53,allow,198,102,96,2,30,1,1
56062,53,55161,53,allow,537,98,439,4,40,2,2
56756,53,14084,53,allow,167,86,81,2,30,1,1
50010,53,37943,53,allow,205,86,119,2,30,1,1
36936,53,30039,53,allow,78,78,0,1,30,1,0
60211,53,51487,53,allow,205,86,119,2,30,1,1
65316,53,39745,53,allow,225,110,115,2,30,1,1
54973,53,20292,53,allow,181,94,87,2,30,1,1
64748,53,6781,53,allow,183,94,89,2,30,1,1
65228,53,28438,53,allow,200,102,98,2,30,1,1
49765,53,11309,53,allow,194,102,92,2,30,1,1
56266,53,11208,53,allow,193,102,91,2,30,1,1
56468,53,49469,53,allow,209,110,99,2,30,1,1
64493,53,56892,53,allow,280,97,183,4,58,2,2
49909,53,17902,53,allow,1410,95,1315,4,57,2,2
56163,53,14069,53,allow,265,85,180,4,42,2,2
37614,80,61486,80,allow,1399,406,993,15,43,5,10
65274,53,29709,53,allow,295,101,194,4,31,2,2
57259,53,43490,53,allow,167,86,81,2,29,1,1
53832,53,28034,53,allow,211,78,133,2,29,1,1
49476,53,24497,53,allow,402,118,284,2,29,1,1
65010,53,7971,53,allow,758,102,656,2,29,1,1
49574,53,41987,53,allow,193,102,91,2,29,1,1
54969,53,41747,53,allow,199,102,97,2,29,1,1
57430,53,65274,53,allow,177,94,83,2,30,1,1
57139,53,30822,53,allow,193,102,91,2,30,1,1
65291,53,57485,53,allow,195,102,93,2,29,1,1
57314,53,31776,53,allow,195,102,93,2,30,1,1
55463,53,39462,53,allow,816,102,714,2,29,1,1
57259,53,28924,53,allow,167,86,81,2,29,1,1
65142,53,52775,53,allow,167,86,81,2,29,1,1
57430,53,14392,53,allow,200,102,98,2,29,1,1
64554,53,13352,53,allow,199,102,97,2,29,1,1
55367,53,40346,53,allow,195,102,93,2,30,1,1
64097,53,23639,53,allow,308,91,217,4,56,2,2
55889,53,44791,53,allow,199,102,97,2,30,1,1
56973,53,45728,53,allow,193,102,91,2,30,1,1
64658,53,30936,53,allow,785,110,675,2,30,1,1
64661,53,48759,53,allow,216,102,114,2,30,1,1
64816,53,50725,53,allow,166,86,80,2,30,1,1
57023,53,56230,53,allow,179,94,85,2,30,1,1
55220,53,13554,53,allow,193,102,91,2,30,1,1
57314,53,2474,53,allow,195,102,93,2,31,1,1
54973,53,16224,53,allow,181,94,87,2,31,1,1
65132,53,27212,53,allow,167,86,81,2,30,1,1
64205,53,1901,53,allow,178,94,84,2,30,1,1
49324,53,24551,53,allow,258,94,164,2,30,1,1
56973,53,9162,53,allow,193,102,91,2,30,1,1
65495,53,16317,53,allow,209,110,99,2,30,1,1
55056,53,39813,53,allow,209,110,99,2,30,1,1
65204,53,23706,53,allow,183,94,89,2,30,1,1
64493,53,34209,53,allow,280,97,183,4,59,2,2
49253,53,32297,53,allow,593,188,405,6,59,3,3
55628,53,5942,53,allow,821,102,719,2,30,1,1
49693,53,49502,53,allow,209,110,99,2,30,1,1
55268,53,2485,53,allow,193,102,91,2,30,1,1
55003,53,31448,53,allow,196,102,94,2,30,1,1
64724,53,45753,53,allow,336,110,226,2,30,1,1
49253,53,44015,53,allow,199,102,97,2,30,1,1
55855,53,25503,53,allow,182,102,80,2,30,1,1
57351,53,34146,53,allow,184,94,90,2,30,1,1
64816,53,25047,53,allow,166,86,80,2,30,1,1
56127,53,41688,53,allow,167,86,81,2,30,1,1
64554,53,27674,53,allow,199,102,97,2,30,1,1
54973,53,14051,53,allow,181,94,87,2,30,1,1
55046,53,35740,53,allow,198,102,96,2,30,1,1
38642,443,33643,443,allow,1468,893,575,15,62,8,7
57333,53,60768,53,allow,167,86,81,2,30,1,1
64569,53,4728,53,allow,413,170,243,6,30,3,3
49253,53,58276,53,allow,199,102,97,2,30,1,1
49990,53,60528,53,allow,198,102,96,2,30,1,1
56819,53,1488,53,allow,209,110,99,2,30,1,1
56468,53,56108,53,allow,209,110,99,2,30,1,1
55245,53,36514,53,allow,209,110,99,2,30,1,1
55367,53,11900,53,allow,195,102,93,2,30,1,1
55688,53,25850,53,allow,184,94,90,2,31,1,1
55816,53,3790,53,allow,214,110,104,2,31,1,1
65132,53,40938,53,allow,167,86,81,2,31,1,1
55577,53,15503,53,allow,199,102,97,2,31,1,1
65020,53,14135,53,allow,184,94,90,2,31,1,1
55688,53,51379,53,allow,184,94,90,2,30,1,1
64810,53,57933,53,allow,199,102,97,2,30,1,1
55056,53,20306,53,allow,209,110,99,2,30,1,1
49206,53,3418,53,allow,448,184,264,6,30,3,3
49656,53,55066,53,allow,193,102,91,2,30,1,1
57244,53,57244,53,allow,240,98,142,2,30,1,1
60346,53,60346,53,allow,241,98,143,2,30,1,1
57323,53,38814,53,allow,194,102,92,2,31,1,1
49628,53,6846,53,allow,168,86,82,2,31,1,1
55415,53,31153,53,allow,183,94,89,2,31,1,1
65241,53,22089,53,allow,200,102,98,2,31,1,1
55220,53,48038,53,allow,193,102,91,2,31,1,1
55003,53,40085,53,allow,196,102,94,2,30,1,1
65229,53,50750,53,allow,193,102,91,2,31,1,1
49656,53,53430,53,allow,193,102,91,2,30,1,1
55415,53,7035,53,allow,183,94,89,2,30,1,1
49374,53,42809,53,allow,197,94,103,2,30,1,1
57386,53,13419,53,allow,193,102,91,2,31,1,1
49765,53,24395,53,allow,194,102,92,2,31,1,1
56711,53,61949,53,allow,209,110,99,2,31,1,1
55123,53,57840,53,allow,198,102,96,2,31,1,1
65495,53,62386,53,allow,209,110,99,2,31,1,1
64205,53,47320,53,allow,178,94,84,2,31,1,1
56637,53,33997,53,allow,199,102,97,2,31,1,1
55159,53,6565,53,allow,200,102,98,2,30,1,1
56821,53,60054,53,allow,199,102,97,2,30,1,1
65505,53,15527,53,allow,166,86,80,2,31,1,1
63932,53,16188,53,allow,179,94,85,2,31,1,1
64520,53,30136,53,allow,198,102,96,2,31,1,1
63949,53,18113,53,allow,195,102,93,2,31,1,1
65291,53,60855,53,allow,335,97,238,4,31,2,2
49247,53,4260,53,allow,194,102,92,2,31,1,1
65274,53,37017,53,allow,295,101,194,4,31,2,2
64053,53,8111,53,allow,276,94,182,4,56,2,2
56665,80,42041,80,allow,234,234,0,4,12,4,0
51957,80,56020,80,allow,486,300,186,9,27,6,3
58858,443,41294,443,allow,318,192,126,6,26,4,2
60171,443,39238,443,allow,1059,556,503,12,25,6,6
51951,80,50498,80,allow,366,240,126,7,28,5,2
56561,53,57177,53,allow,183,94,89,2,30,1,1
65040,53,64754,53,allow,749,94,655,2,30,1,1
65241,53,55089,53,allow,200,102,98,2,31,1,1
63949,53,30252,53,allow,195,102,93,2,31,1,1
56226,53,49033,53,allow,200,102,98,2,30,1,1
44611,23,0,0,deny,60,60,0,1,0,1,0
62699,445,0,0,drop,66,66,0,1,0,1,0
62698,445,0,0,drop,66,66,0,1,0,1,0
62510,445,0,0,drop,70,70,0,1,0,1,0
50927,445,0,0,drop,70,70,0,1,0,1,0
50925,445,0,0,drop,70,70,0,1,0,1,0
50919,445,0,0,drop,70,70,0,1,0,1,0
62507,445,0,0,drop,70,70,0,1,0,1,0
62694,445,0,0,drop,66,66,0,1,0,1,0
62690,445,0,0,drop,66,66,0,1,0,1,0
62684,445,0,0,drop,66,66,0,1,0,1,0
62687,445,0,0,drop,66,66,0,1,0,1,0
62681,445,0,0,drop,66,66,0,1,0,1,0
62683,445,0,0,drop,66,66,0,1,0,1,0
62682,445,0,0,drop,66,66,0,1,0,1,0
62688,445,0,0,drop,66,66,0,1,0,1,0
50916,445,0,0,drop,70,70,0,1,0,1,0
62502,445,0,0,drop,70,70,0,1,0,1,0
50911,445,0,0,drop,70,70,0,1,0,1,0
50910,445,0,0,drop,70,70,0,1,0,1,0
62501,445,0,0,drop,70,70,0,1,0,1,0
62499,445,0,0,drop,70,70,0,1,0,1,0
50905,445,0,0,drop,70,70,0,1,0,1,0
50903,445,0,0,drop,70,70,0,1,0,1,0
62671,445,0,0,drop,66,66,0,1,0,1,0
50898,445,0,0,drop,70,70,0,1,0,1,0
62492,445,0,0,drop,70,70,0,1,0,1,0
62670,445,0,0,drop,66,66,0,1,0,1,0
62668,445,0,0,drop,66,66,0,1,0,1,0
62666,445,0,0,drop,66,66,0,1,0,1,0
62490,445,0,0,drop,70,70,0,1,0,1,0
62665,445,0,0,drop,66,66,0,1,0,1,0
62489,445,0,0,drop,70,70,0,1,0,1,0
62488,445,0,0,drop,70,70,0,1,0,1,0
62487,445,0,0,drop,70,70,0,1,0,1,0
62485,445,0,0,drop,70,70,0,1,0,1,0
62483,445,0,0,drop,70,70,0,1,0,1,0
50893,445,0,0,drop,70,70,0,1,0,1,0
50888,445,0,0,drop,70,70,0,1,0,1,0
62469,445,0,0,drop,70,70,0,1,0,1,0
62468,445,0,0,drop,70,70,0,1,0,1,0
62465,445,0,0,drop,70,70,0,1,0,1,0
62458,445,0,0,drop,70,70,0,1,0,1,0
62459,445,0,0,drop,70,70,0,1,0,1,0
62653,445,0,0,drop,66,66,0,1,0,1,0
62646,445,0,0,drop,66,66,0,1,0,1,0
50870,445,0,0,drop,70,70,0,1,0,1,0
62447,445,0,0,drop,70,70,0,1,0,1,0
62643,445,0,0,drop,66,66,0,1,0,1,0
62635,445,0,0,drop,66,66,0,1,0,1,0
62630,445,0,0,drop,66,66,0,1,0,1,0
62443,445,0,0,drop,70,70,0,1,0,1,0
35894,17,0,0,deny,60,60,0,1,0,1,0
51934,443,29764,443,allow,550,310,240,10,35,6,4
51390,53,51390,53,allow,398,255,143,3,31,2,1
65241,53,18449,53,allow,200,102,98,2,31,1,1
54968,53,43880,53,allow,198,101,97,2,30,1,1
63949,53,59282,53,allow,190,97,93,2,31,1,1
63932,53,54885,53,allow,174,89,85,2,31,1,1
55152,53,27991,53,allow,176,90,86,2,30,1,1
65472,53,63288,53,allow,202,103,99,2,31,1,1
63968,53,37221,53,allow,200,102,98,2,30,1,1
65133,53,56873,53,allow,196,100,96,2,31,1,1
64205,53,12061,53,allow,172,88,84,2,30,1,1
65229,53,55495,53,allow,186,95,91,2,30,1,1
64053,53,64602,53,allow,276,94,182,4,55,2,2
48326,53,48326,53,allow,398,255,143,3,33,2,1
49526,53,35749,53,allow,272,97,175,4,58,2,2
64959,53,64959,53,allow,398,255,143,3,33,2,1
65363,53,30865,53,allow,178,91,87,2,31,1,1
49532,53,4849,53,allow,190,97,93,2,31,1,1
49521,53,26950,53,allow,182,93,89,2,30,1,1
56163,53,47516,53,allow,265,85,180,4,41,2,2
57035,53,11215,53,allow,1414,95,1319,4,41,2,2
46744,53,46744,53,allow,404,259,145,3,32,2,1
56740,53,17032,53,allow,716,95,621,2,30,1,1
47357,443,6177,443,allow,153,93,60,2,5,1,1
55159,53,29512,53,allow,200,102,98,2,30,1,1
49533,53,65286,53,allow,771,101,670,2,30,1,1
50534,53,50534,53,allow,216,88,128,2,30,1,1
50263,53,61533,53,allow,753,96,657,2,30,1,1
64520,53,59126,53,allow,196,100,96,2,30,1,1
65020,53,8823,53,allow,184,94,90,2,31,1,1
55384,53,37937,53,allow,188,96,92,2,31,1,1
49862,53,25145,53,allow,176,90,86,2,30,1,1
56625,53,59531,53,allow,186,95,91,2,31,1,1
57212,53,19775,53,allow,780,104,676,2,31,1,1
64567,53,31447,53,allow,186,95,91,2,31,1,1
64780,53,55734,53,allow,186,95,91,2,31,1,1
64833,53,14951,53,allow,166,85,81,2,31,1,1
65376,53,45808,53,allow,184,94,90,2,31,1,1
57792,53,57792,53,allow,215,87,128,2,31,1,1
63992,53,33581,53,allow,198,101,97,2,31,1,1
49290,53,14935,53,allow,184,94,90,2,31,1,1
57397,53,42252,53,allow,735,88,647,2,31,1,1
55547,53,9428,53,allow,774,101,673,2,31,1,1
63991,53,7704,53,allow,186,95,91,2,31,1,1
62432,445,0,0,drop,70,70,0,1,0,1,0
62431,445,0,0,drop,70,70,0,1,0,1,0
62433,445,0,0,drop,70,70,0,1,0,1,0
62429,445,0,0,drop,70,70,0,1,0,1,0
62427,445,0,0,drop,70,70,0,1,0,1,0
50858,445,0,0,drop,70,70,0,1,0,1,0
50859,445,0,0,drop,70,70,0,1,0,1,0
62614,445,0,0,drop,66,66,0,1,0,1,0
62620,445,0,0,drop,66,66,0,1,0,1,0
62619,445,0,0,drop,66,66,0,1,0,1,0
62616,445,0,0,drop,66,66,0,1,0,1,0
62618,445,0,0,drop,66,66,0,1,0,1,0
62621,445,0,0,drop,66,66,0,1,0,1,0
62617,445,0,0,drop,66,66,0,1,0,1,0
62613,445,0,0,drop,66,66,0,1,0,1,0
49290,53,62128,53,allow,184,94,90,2,30,1,1
56163,53,45369,53,allow,265,85,180,4,41,2,2
64947,53,61833,53,allow,275,96,179,4,41,2,2
45547,53,15973,53,allow,199,94,105,2,30,1,1
55056,53,51122,53,allow,209,110,99,2,30,1,1
65277,53,40732,53,allow,199,102,97,2,30,1,1
57363,53,63578,53,allow,193,102,91,2,30,1,1
55123,53,56989,53,allow,198,102,96,2,30,1,1
40226,53,63320,53,allow,258,78,180,4,30,2,2
56637,53,46210,53,allow,199,102,97,2,30,1,1
65495,53,27520,53,allow,209,110,99,2,30,1,1
64816,53,50363,53,allow,166,86,80,2,30,1,1
64520,53,48129,53,allow,198,102,96,2,30,1,1
65363,53,10698,53,allow,181,94,87,2,30,1,1
49862,53,40662,53,allow,180,94,86,2,30,1,1
38269,80,33887,80,allow,190,70,120,4,14,2,2
57737,53,57737,53,allow,374,240,134,3,32,2,1
57386,53,23091,53,allow,193,102,91,2,29,1,1
64284,53,55514,53,allow,229,110,119,2,30,1,1
56625,53,47756,53,allow,193,102,91,2,30,1,1
56161,53,4993,53,allow,817,102,715,2,30,1,1
49532,53,13697,53,allow,195,102,93,2,30,1,1
49247,53,61621,53,allow,817,102,715,2,30,1,1
51943,80,43908,80,allow,306,120,186,6,27,3,3
51940,80,37296,80,allow,366,240,126,7,27,5,2
57061,53,39332,53,allow,1780,674,1106,18,68,9,9
64810,53,23866,53,allow,199,102,97,2,29,1,1
47652,443,53871,443,allow,1058,571,487,10,24,6,4
55046,53,11757,53,allow,198,102,96,2,29,1,1
55451,53,40344,53,allow,816,102,714,2,29,1,1
56550,53,53287,53,allow,166,86,80,2,29,1,1
56271,53,27532,53,allow,195,102,93,2,29,1,1
57351,53,48672,53,allow,184,94,90,2,29,1,1
49276,53,39804,53,allow,199,102,97,2,29,1,1
56561,53,8736,53,allow,183,94,89,2,29,1,1
57430,53,16018,53,allow,200,102,98,2,29,1,1
64308,53,11059,53,allow,258,102,156,2,29,1,1
56819,53,44720,53,allow,209,110,99,2,29,1,1
55688,53,8374,53,allow,184,94,90,2,30,1,1
49532,53,40570,53,allow,195,102,93,2,30,1,1
56161,53,2092,53,allow,194,102,92,2,30,1,1
51036,80,2227,80,allow,1514,480,1034,11,16,6,5
55224,53,48169,53,allow,182,94,88,2,30,1,1
65133,53,55111,53,allow,198,102,96,2,30,1,1
65472,53,43093,53,allow,209,110,99,2,30,1,1
65229,53,46914,53,allow,193,102,91,2,30,1,1
54968,53,59501,53,allow,199,102,97,2,30,1,1
64020,53,53035,53,allow,196,102,94,2,30,1,1
49591,80,27431,80,allow,314,128,186,6,27,3,3
54805,80,8562,80,allow,448,78,370,6,24,1,5
57386,53,39494,53,allow,193,102,91,2,30,1,1
46410,80,31458,80,allow,1163,705,458,10,15,6,4
57398,443,53104,443,allow,1056,569,487,10,24,6,4
56857,53,15955,53,allow,195,102,93,2,30,1,1
55245,53,25152,53,allow,193,102,91,2,30,1,1
56532,53,25649,53,allow,193,102,91,2,30,1,1
49654,53,46255,53,allow,775,102,673,2,30,1,1
60684,53,9516,53,allow,199,94,105,2,30,1,1
56857,53,39377,53,allow,195,102,93,2,30,1,1
55729,53,3509,53,allow,199,102,97,2,30,1,1
55159,53,29350,53,allow,200,102,98,2,30,1,1
49521,53,40316,53,allow,183,94,89,2,30,1,1
55308,53,65535,53,allow,194,94,100,2,30,1,1
65277,53,48607,53,allow,199,102,97,2,30,1,1
65133,53,34896,53,allow,198,102,96,2,30,1,1
49205,53,3818,53,allow,720,94,626,2,30,1,1
49792,53,55353,53,allow,755,202,553,6,61,3,3
49268,53,9594,53,allow,200,94,106,2,30,1,1
37683,53,37683,53,allow,240,98,142,2,30,1,1
56857,53,28297,53,allow,195,102,93,2,30,1,1
57363,53,3624,53,allow,193,102,91,2,30,1,1
55003,53,61767,53,allow,196,102,94,2,30,1,1
55224,53,43043,53,allow,182,94,88,2,30,1,1
61435,443,45257,443,allow,1401,940,461,11,29,7,4
55224,53,2332,53,allow,182,94,88,2,30,1,1
55317,53,30681,53,allow,216,102,114,2,30,1,1
49466,53,24088,53,allow,209,110,99,2,30,1,1
55141,53,24444,53,allow,184,94,90,2,30,1,1
56625,53,55820,53,allow,193,102,91,2,30,1,1
65020,53,48553,53,allow,184,94,90,2,30,1,1
49776,53,42364,53,allow,182,94,88,2,30,1,1
49526,53,12720,53,allow,272,97,175,4,58,2,2
65136,53,56323,53,allow,458,104,354,4,57,2,2
57396,443,55887,443,allow,1054,567,487,10,24,6,4
61436,443,20457,443,allow,1401,940,461,11,29,7,4
47650,443,28162,443,allow,1056,569,487,10,24,6,4
51947,80,31823,80,allow,1582,866,716,11,27,7,4
50639,80,20616,80,allow,318,192,126,6,25,4,2
50309,53,29176,53,allow,193,102,91,2,29,1,1
51955,80,57774,80,allow,366,240,126,7,27,5,2
55159,53,20403,53,allow,200,102,98,2,29,1,1
64020,53,31935,53,allow,196,102,94,2,29,1,1
57334,53,51470,53,allow,184,94,90,2,29,1,1
55123,53,29393,53,allow,198,102,96,2,29,1,1
55245,53,15511,53,allow,193,102,91,2,30,1,1
55268,53,12955,53,allow,193,102,91,2,29,1,1
50309,53,52592,53,allow,816,102,714,2,29,1,1
57061,53,28599,53,allow,1780,674,1106,18,68,9,9
65091,53,53299,53,allow,212,102,110,2,29,1,1
49276,53,23238,53,allow,199,102,97,2,29,1,1
55245,53,61157,53,allow,209,110,99,2,29,1,1
65139,53,18725,53,allow,216,110,106,2,29,1,1
55451,53,24181,53,allow,193,102,91,2,29,1,1
57382,53,10173,53,allow,184,94,90,2,29,1,1
56821,53,37054,53,allow,199,102,97,2,29,1,1
54960,53,7818,53,allow,448,184,264,6,30,3,3
56271,53,40470,53,allow,195,102,93,2,30,1,1
65204,53,50425,53,allow,183,94,89,2,29,1,1
56313,53,7170,53,allow,198,102,96,2,29,1,1
55325,53,53505,53,allow,199,102,97,2,30,1,1
64985,53,53017,53,allow,196,102,94,2,30,1,1
65132,53,29079,53,allow,167,86,81,2,30,1,1
65023,53,44980,53,allow,761,102,659,2,30,1,1
64489,53,32733,53,allow,215,102,113,2,30,1,1
65363,53,10206,53,allow,181,94,87,2,30,1,1
49636,53,23682,53,allow,180,94,86,2,30,1,1
55577,53,20988,53,allow,199,102,97,2,30,1,1
65376,53,60931,53,allow,184,94,90,2,30,1,1
55384,53,24803,53,allow,194,102,92,2,30,1,1
49628,53,54412,53,allow,168,86,82,2,30,1,1
64853,53,39005,53,allow,199,102,97,2,30,1,1
64695,53,7882,53,allow,275,118,157,2,30,1,1
49290,53,50836,53,allow,184,94,90,2,30,1,1
60840,53,50587,53,allow,255,86,169,2,31,1,1
55384,53,49003,53,allow,194,102,92,2,31,1,1
55729,53,33239,53,allow,199,102,97,2,30,1,1
56532,53,39559,53,allow,193,102,91,2,30,1,1
63968,53,26432,53,allow,200,102,98,2,30,1,1
49466,53,47860,53,allow,209,110,99,2,30,1,1
63932,53,27137,53,allow,179,94,85,2,30,1,1
63968,53,62729,53,allow,200,102,98,2,30,1,1
64053,53,64715,53,allow,276,94,182,4,55,2,2
55577,53,26571,53,allow,199,102,97,2,30,1,1
54968,53,43253,53,allow,199,102,97,2,30,1,1
57351,53,35105,53,allow,184,94,90,2,30,1,1
56711,53,25495,53,allow,209,110,99,2,30,1,1
54968,53,59116,53,allow,199,102,97,2,30,1,1
55388,53,5023,53,allow,720,94,626,2,30,1,1
65472,53,51115,53,allow,209,110,99,2,30,1,1
40140,53,40140,53,allow,404,259,145,3,32,2,1
36368,80,58408,80,allow,78,78,0,1,5,1,0
49526,53,27945,53,allow,272,97,175,4,57,2,2
56711,53,8899,53,allow,209,110,99,2,30,1,1
57707,53,34372,53,allow,70,70,0,1,30,1,0
65505,53,13490,53,allow,166,86,80,2,30,1,1
55415,53,9661,53,allow,183,94,89,2,30,1,1
49521,53,3193,53,allow,183,94,89,2,30,1,1
49452,53,60984,53,allow,244,110,134,2,30,1,1
55220,53,22108,53,allow,193,102,91,2,30,1,1
65229,53,52095,53,allow,193,102,91,2,30,1,1
49521,53,30278,53,allow,183,94,89,2,30,1,1
65472,53,45041,53,allow,209,110,99,2,30,1,1
64833,53,41021,53,allow,167,86,81,2,31,1,1
63999,53,20780,53,allow,193,102,91,2,31,1,1
64985,53,7448,53,allow,196,102,94,2,31,1,1
64449,53,34818,53,allow,255,102,153,2,31,1,1
64780,53,40708,53,allow,193,102,91,2,31,1,1
65026,53,29362,53,allow,193,102,91,2,31,1,1
63932,53,25694,53,allow,179,94,85,2,31,1,1
65363,53,1138,53,allow,181,94,87,2,31,1,1
63991,53,25716,53,allow,193,102,91,2,31,1,1
65020,53,24466,53,allow,290,94,196,4,55,2,2
49466,53,63958,53,allow,324,103,221,4,46,2,2
63949,53,2589,53,allow,338,97,241,4,43,2,2
65241,53,13968,53,allow,484,102,382,4,36,2,2
49526,53,6376,53,allow,272,97,175,4,58,2,2
64205,53,39534,53,allow,327,88,239,4,52,2,2
51813,443,18719,443,allow,130,70,60,3,5,2,1
49265,53,25625,53,allow,211,102,109,2,30,1,1
64567,53,64760,53,allow,193,102,91,2,30,1,1
62421,445,0,0,drop,70,70,0,1,0,1,0
50853,445,0,0,drop,70,70,0,1,0,1,0
50852,445,0,0,drop,70,70,0,1,0,1,0
50850,445,0,0,drop,70,70,0,1,0,1,0
50842,445,0,0,drop,70,70,0,1,0,1,0
62413,445,0,0,drop,70,70,0,1,0,1,0
62600,445,0,0,drop,66,66,0,1,0,1,0
62598,445,0,0,drop,66,66,0,1,0,1,0
62599,445,0,0,drop,66,66,0,1,0,1,0
50839,445,0,0,drop,70,70,0,1,0,1,0
62407,445,0,0,drop,70,70,0,1,0,1,0
50830,445,0,0,drop,70,70,0,1,0,1,0
50828,445,0,0,drop,70,70,0,1,0,1,0
62405,445,0,0,drop,70,70,0,1,0,1,0
62401,445,0,0,drop,70,70,0,1,0,1,0
62400,445,0,0,drop,70,70,0,1,0,1,0
50821,445,0,0,drop,70,70,0,1,0,1,0
50817,445,0,0,drop,70,70,0,1,0,1,0
50815,445,0,0,drop,70,70,0,1,0,1,0
62586,445,0,0,drop,66,66,0,1,0,1,0
62395,445,0,0,drop,70,70,0,1,0,1,0
52232,53,0,0,deny,71,71,0,1,0,1,0
50812,445,0,0,drop,70,70,0,1,0,1,0
55987,53,22591,53,allow,733,85,648,2,0,1,1
35812,1,0,0,deny,146,146,0,1,0,1,0
62571,445,0,0,drop,66,66,0,1,0,1,0
62382,445,0,0,drop,70,70,0,1,0,1,0
62379,445,0,0,drop,70,70,0,1,0,1,0
50803,445,0,0,drop,70,70,0,1,0,1,0
50799,445,0,0,drop,70,70,0,1,0,1,0
50798,445,0,0,drop,70,70,0,1,0,1,0
50791,445,0,0,drop,70,70,0,1,0,1,0
62566,445,0,0,drop,66,66,0,1,0,1,0
62554,445,0,0,drop,66,66,0,1,0,1,0
62557,445,0,0,drop,66,66,0,1,0,1,0
62558,445,0,0,drop,66,66,0,1,0,1,0
62562,445,0,0,drop,66,66,0,1,0,1,0
62556,445,0,0,drop,66,66,0,1,0,1,0
62553,445,0,0,drop,66,66,0,1,0,1,0
62551,445,0,0,drop,66,66,0,1,0,1,0
62374,445,0,0,drop,70,70,0,1,0,1,0
50786,445,0,0,drop,70,70,0,1,0,1,0
62373,445,0,0,drop,70,70,0,1,0,1,0
50782,445,0,0,drop,70,70,0,1,0,1,0
50783,445,0,0,drop,70,70,0,1,0,1,0
62371,445,0,0,drop,70,70,0,1,0,1,0
50777,445,0,0,drop,70,70,0,1,0,1,0
50773,445,0,0,drop,70,70,0,1,0,1,0
50772,445,0,0,drop,70,70,0,1,0,1,0
62364,445,0,0,drop,70,70,0,1,0,1,0
64955,53,11149,53,allow,761,100,661,2,0,1,1
62544,445,0,0,drop,66,66,0,1,0,1,0
50770,445,0,0,drop,70,70,0,1,0,1,0
62362,445,0,0,drop,70,70,0,1,0,1,0
62541,445,0,0,drop,66,66,0,1,0,1,0
62539,445,0,0,drop,66,66,0,1,0,1,0
62538,445,0,0,drop,66,66,0,1,0,1,0
62361,445,0,0,drop,70,70,0,1,0,1,0
62536,445,0,0,drop,66,66,0,1,0,1,0
62360,445,0,0,drop,70,70,0,1,0,1,0
62359,445,0,0,drop,70,70,0,1,0,1,0
62356,445,0,0,drop,70,70,0,1,0,1,0
62353,445,0,0,drop,70,70,0,1,0,1,0
50764,445,0,0,drop,70,70,0,1,0,1,0
50755,445,0,0,drop,70,70,0,1,0,1,0
50751,445,0,0,drop,70,70,0,1,0,1,0
62341,445,0,0,drop,70,70,0,1,0,1,0
62340,445,0,0,drop,70,70,0,1,0,1,0
62337,445,0,0,drop,70,70,0,1,0,1,0
62331,445,0,0,drop,70,70,0,1,0,1,0
62330,445,0,0,drop,70,70,0,1,0,1,0
62525,445,0,0,drop,66,66,0,1,0,1,0
47513,23,0,0,deny,60,60,0,1,0,1,0
62792,53,0,0,deny,88,88,0,1,0,1,0
62518,445,0,0,drop,66,66,0,1,0,1,0
50742,445,0,0,drop,70,70,0,1,0,1,0
62319,445,0,0,drop,70,70,0,1,0,1,0
39704,53,39704,53,allow,398,255,143,3,33,2,1
63999,53,43877,53,allow,186,95,91,2,30,1,1
64985,53,36411,53,allow,192,98,94,2,30,1,1
53917,80,62681,80,allow,1829,755,1074,10,15,6,4
48908,53,48908,53,allow,398,255,143,3,32,2,1
42488,53,42488,53,allow,235,90,145,2,32,1,1
49705,22,49705,22,allow,1108,66,1042,3,15,2,1
55325,53,48577,53,allow,198,101,97,2,30,1,1
49182,53,44027,53,allow,198,101,97,2,30,1,1
49595,53,17154,53,allow,176,90,86,2,30,1,1
50381,443,49531,443,allow,316,136,180,6,6,3,3
49317,53,41699,53,allow,168,78,90,2,30,1,1
65026,53,32654,53,allow,186,95,91,2,30,1,1
64444,53,59792,53,allow,93,93,0,1,30,1,0
64947,53,18048,53,allow,275,96,179,4,41,2,2
48020,53,48020,53,allow,404,259,145,3,33,2,1
62964,53,62964,53,allow,404,259,145,3,33,2,1
49165,53,64334,53,allow,780,104,676,2,30,1,1
64790,53,58871,53,allow,88,88,0,1,30,1,0
50370,443,23415,443,allow,316,136,180,6,6,3,3
39861,80,23505,80,allow,1056,682,374,10,15,6,4
56410,53,65347,53,allow,757,98,659,2,30,1,1
49776,53,56083,53,allow,180,92,88,2,30,1,1
49558,53,30601,53,allow,184,94,90,2,30,1,1
56433,53,16233,53,allow,204,104,100,2,30,1,1
65487,53,62751,53,allow,204,104,100,2,31,1,1
56327,53,49632,53,allow,172,88,84,2,31,1,1
64034,53,21913,53,allow,188,96,92,2,31,1,1
49380,53,50592,53,allow,377,110,267,2,31,1,1
56927,53,19352,53,allow,182,93,89,2,31,1,1
49916,53,52400,53,allow,395,111,284,2,31,1,1
55693,53,60577,53,allow,748,95,653,2,31,1,1
49969,53,49918,53,allow,198,101,97,2,31,1,1
64290,53,55058,53,allow,192,98,94,2,31,1,1
62516,445,0,0,drop,66,66,0,1,0,1,0
62315,445,0,0,drop,70,70,0,1,0,1,0
62509,445,0,0,drop,66,66,0,1,0,1,0
62506,445,0,0,drop,66,66,0,1,0,1,0
62306,445,0,0,drop,70,70,0,1,0,1,0
62303,445,0,0,drop,70,70,0,1,0,1,0
62305,445,0,0,drop,70,70,0,1,0,1,0
62301,445,0,0,drop,70,70,0,1,0,1,0
62299,445,0,0,drop,70,70,0,1,0,1,0
50730,445,0,0,drop,70,70,0,1,0,1,0
62488,445,0,0,drop,66,66,0,1,0,1,0
62492,445,0,0,drop,66,66,0,1,0,1,0
62493,445,0,0,drop,66,66,0,1,0,1,0
62491,445,0,0,drop,66,66,0,1,0,1,0
62486,445,0,0,drop,66,66,0,1,0,1,0
62489,445,0,0,drop,66,66,0,1,0,1,0
62487,445,0,0,drop,66,66,0,1,0,1,0
62485,445,0,0,drop,66,66,0,1,0,1,0
62292,445,0,0,drop,70,70,0,1,0,1,0
44903,80,37166,80,allow,918,461,457,9,16,6,3
55384,53,51117,53,allow,194,102,92,2,30,1,1
57252,53,26443,53,allow,229,102,127,2,30,1,1
44911,80,9577,80,allow,1492,1050,442,7,15,5,2
49590,80,22848,80,allow,314,128,186,6,26,3,3
43016,53,43016,53,allow,235,90,145,2,32,1,1
64672,53,41499,53,allow,576,195,381,6,51,3,3
65220,53,7032,53,allow,371,97,274,4,53,2,2
49182,53,41433,53,allow,199,102,97,2,29,1,1
49776,53,43757,53,allow,182,94,88,2,29,1,1
49558,53,61450,53,allow,184,94,90,2,29,1,1
64053,53,32861,53,allow,276,94,182,4,54,2,2
49947,53,36871,53,allow,264,102,162,2,30,1,1
58068,443,17873,443,allow,543,303,240,8,5,4,4
49320,53,42245,53,allow,331,90,241,4,38,2,2
55325,53,47399,53,allow,199,102,97,2,29,1,1
56625,53,48390,53,allow,193,102,91,2,29,1,1
55152,53,21399,53,allow,180,94,86,2,29,1,1
65505,53,17210,53,allow,166,86,80,2,29,1,1
49233,53,56407,53,allow,196,102,94,2,29,1,1
64520,53,16253,53,allow,198,102,96,2,29,1,1
64790,53,41901,53,allow,178,94,84,2,29,1,1
55236,53,27697,53,allow,196,102,94,2,29,1,1
65026,53,34108,53,allow,193,102,91,2,29,1,1
64011,53,28636,53,allow,288,94,194,2,29,1,1
65376,53,47204,53,allow,184,94,90,2,29,1,1
64567,53,8117,53,allow,193,102,91,2,29,1,1
65167,53,26450,53,allow,212,102,110,2,29,1,1
50535,53,14934,53,allow,210,110,100,2,29,1,1
55236,53,12241,53,allow,819,102,717,2,29,1,1
65376,53,8405,53,allow,184,94,90,2,30,1,1
64833,53,62978,53,allow,167,86,81,2,30,1,1
49595,53,9542,53,allow,180,94,86,2,30,1,1
63992,53,39861,53,allow,199,102,97,2,30,1,1
49489,53,23234,53,allow,241,118,123,2,30,1,1
57536,443,25705,443,allow,232,172,60,3,5,2,1
59999,443,10266,443,allow,1571,660,911,13,18,7,6
49182,53,13161,53,allow,199,102,97,2,30,1,1
55684,80,48603,80,allow,70,70,0,1,5,1,0
49534,53,17481,53,allow,315,84,231,4,40,2,2
64312,53,41455,53,allow,225,110,115,2,30,1,1
59996,443,60855,443,allow,1641,730,911,14,18,8,6
49903,53,41942,53,allow,194,94,100,2,30,1,1
65507,53,44287,53,allow,199,102,97,2,30,1,1
36575,443,29496,443,allow,412,140,272,7,25,3,4
65216,53,8359,53,allow,775,102,673,2,30,1,1
49248,53,1565,53,allow,301,90,211,4,46,2,2
56433,53,47561,53,allow,210,110,100,2,30,1,1
56453,53,58094,53,allow,243,94,149,2,30,1,1
56288,53,63412,53,allow,210,110,100,2,30,1,1
63992,53,62838,53,allow,199,102,97,2,30,1,1
57514,53,51498,53,allow,168,78,90,2,30,1,1
50359,80,14465,80,allow,1770,961,809,10,15,5,5
60000,443,63999,443,allow,1641,730,911,14,18,8,6
63988,53,50282,53,allow,559,193,366,6,67,3,3
56288,53,18039,53,allow,210,110,100,2,30,1,1
64833,53,29927,53,allow,167,86,81,2,30,1,1
44119,53,25337,53,allow,168,78,90,2,30,1,1
65507,53,53628,53,allow,199,102,97,2,30,1,1
49595,53,47380,53,allow,180,94,86,2,30,1,1
65133,53,1707,53,allow,339,100,239,4,51,2,2
37663,80,36231,80,allow,974,481,493,8,15,5,3
44907,80,29624,80,allow,1514,962,552,7,16,5,2
49589,80,33481,80,allow,314,128,186,6,26,3,3
64947,53,23514,53,allow,275,96,179,4,41,2,2
56163,53,10376,53,allow,624,188,436,6,60,3,3
43807,80,36292,80,allow,138,78,60,2,4,1,1
64947,53,11296,53,allow,275,96,179,4,41,2,2
59997,443,42772,443,allow,1571,660,911,13,18,7,6
50357,80,43010,80,allow,764,698,66,6,15,5,1
49558,53,47394,53,allow,184,94,90,2,30,1,1
63999,53,37511,53,allow,193,102,91,2,29,1,1
49233,53,6991,53,allow,819,102,717,2,29,1,1
64780,53,50803,53,allow,193,102,91,2,29,1,1
49277,53,5788,53,allow,199,86,113,2,29,1,1
49570,53,16357,53,allow,196,94,102,2,29,1,1
64497,53,35440,53,allow,232,110,122,2,29,1,1
63991,53,55633,53,allow,193,102,91,2,29,1,1
49182,53,3761,53,allow,199,102,97,2,29,1,1
55325,53,5383,53,allow,199,102,97,2,30,1,1
50535,53,65134,53,allow,210,110,100,2,29,1,1
51939,53,4042,53,allow,222,94,128,2,30,1,1
65403,53,26978,53,allow,178,94,84,2,30,1,1
65026,53,30024,53,allow,193,102,91,2,30,1,1
49942,53,17734,53,allow,741,94,647,2,30,1,1
64271,53,22789,53,allow,198,94,104,2,30,1,1
49290,53,29478,53,allow,184,94,90,2,30,1,1
57537,443,24448,443,allow,130,70,60,3,5,2,1
49939,53,35576,53,allow,229,102,127,2,30,1,1
64444,53,10743,53,allow,183,94,89,2,30,1,1
50723,80,33475,80,allow,1546,1109,437,7,15,5,2
56433,53,24075,53,allow,210,110,100,2,30,1,1
63991,53,7605,53,allow,193,102,91,2,30,1,1
65403,53,51244,53,allow,178,94,84,2,30,1,1
40428,53,46586,53,allow,168,78,90,2,30,1,1
56462,53,3765,53,allow,168,78,90,2,30,1,1
56327,53,4067,53,allow,178,94,84,2,30,1,1
63992,53,19496,53,allow,199,102,97,2,30,1,1
55273,53,2212,53,allow,168,78,90,2,30,1,1
64567,53,13390,53,allow,193,102,91,2,30,1,1
48694,123,37842,123,allow,184,94,90,2,30,1,1
49595,53,24473,53,allow,180,94,86,2,30,1,1
64396,53,16886,53,allow,231,102,129,2,30,1,1
55387,53,41194,53,allow,164,86,78,2,30,1,1
64290,53,18678,53,allow,196,102,94,2,31,1,1
50038,53,4648,53,allow,281,78,203,2,31,1,1
57291,53,29680,53,allow,178,94,84,2,30,1,1
65293,53,30071,53,allow,349,110,239,2,30,1,1
56938,53,56411,53,allow,199,102,97,2,31,1,1
49776,53,15280,53,allow,289,92,197,4,31,2,2
64034,53,39969,53,allow,194,102,92,2,31,1,1
45720,443,24721,443,allow,1625,1038,587,14,26,8,6
44885,443,54078,443,allow,1849,1130,719,17,38,9,8
36403,443,54491,443,allow,1149,709,440,13,39,8,5
51667,443,62904,443,allow,1203,703,500,14,42,8,6
57291,53,9525,53,allow,178,94,84,2,30,1,1
50265,23,0,0,deny,60,60,0,1,0,1,0
50729,445,0,0,drop,70,70,0,1,0,1,0
50725,445,0,0,drop,70,70,0,1,0,1,0
50712,445,0,0,drop,70,70,0,1,0,1,0
50714,445,0,0,drop,70,70,0,1,0,1,0
62285,445,0,0,drop,70,70,0,1,0,1,0
62282,445,0,0,drop,70,70,0,1,0,1,0
62471,445,0,0,drop,66,66,0,1,0,1,0
62473,445,0,0,drop,66,66,0,1,0,1,0
62470,445,0,0,drop,66,66,0,1,0,1,0
62278,445,0,0,drop,70,70,0,1,0,1,0
62277,445,0,0,drop,70,70,0,1,0,1,0
50711,445,0,0,drop,70,70,0,1,0,1,0
50707,445,0,0,drop,70,70,0,1,0,1,0
50706,445,0,0,drop,70,70,0,1,0,1,0
50700,445,0,0,drop,70,70,0,1,0,1,0
62273,445,0,0,drop,70,70,0,1,0,1,0
62272,445,0,0,drop,70,70,0,1,0,1,0
50692,445,0,0,drop,70,70,0,1,0,1,0
50690,445,0,0,drop,70,70,0,1,0,1,0
50687,445,0,0,drop,70,70,0,1,0,1,0
62267,445,0,0,drop,70,70,0,1,0,1,0
62459,445,0,0,drop,66,66,0,1,0,1,0
56052,53,55355,53,allow,1392,85,1307,4,12,2,2
62254,445,0,0,drop,70,70,0,1,0,1,0
62446,445,0,0,drop,66,66,0,1,0,1,0
62442,445,0,0,drop,66,66,0,1,0,1,0
62251,445,0,0,drop,70,70,0,1,0,1,0
50673,445,0,0,drop,70,70,0,1,0,1,0
50674,445,0,0,drop,70,70,0,1,0,1,0
50672,445,0,0,deny,70,70,0,1,0,1,0
50663,445,0,0,drop,70,70,0,1,0,1,0
62440,445,0,0,drop,66,66,0,1,0,1,0
62247,445,0,0,drop,70,70,0,1,0,1,0
62245,445,0,0,drop,70,70,0,1,0,1,0
62433,445,0,0,drop,66,66,0,1,0,1,0
62423,445,0,0,drop,66,66,0,1,0,1,0
62434,445,0,0,drop,66,66,0,1,0,1,0
62431,445,0,0,drop,66,66,0,1,0,1,0
62425,445,0,0,drop,66,66,0,1,0,1,0
62424,445,0,0,drop,66,66,0,1,0,1,0
62243,445,0,0,drop,70,70,0,1,0,1,0
50659,445,0,0,drop,70,70,0,1,0,1,0
50655,445,0,0,drop,70,70,0,1,0,1,0
50651,445,0,0,drop,70,70,0,1,0,1,0
62236,445,0,0,drop,70,70,0,1,0,1,0
62234,445,0,0,drop,70,70,0,1,0,1,0
50648,445,0,0,drop,70,70,0,1,0,1,0
50647,445,0,0,drop,70,70,0,1,0,1,0
50645,445,0,0,drop,70,70,0,1,0,1,0
62418,445,0,0,drop,66,66,0,1,0,1,0
50642,445,0,0,drop,70,70,0,1,0,1,0
62413,445,0,0,drop,66,66,0,1,0,1,0
62233,445,0,0,drop,70,70,0,1,0,1,0
62232,445,0,0,drop,70,70,0,1,0,1,0
62411,445,0,0,drop,66,66,0,1,0,1,0
62410,445,0,0,drop,66,66,0,1,0,1,0
62231,445,0,0,drop,70,70,0,1,0,1,0
62225,445,0,0,drop,70,70,0,1,0,1,0
62229,445,0,0,drop,70,70,0,1,0,1,0
62409,445,0,0,drop,66,66,0,1,0,1,0
62213,445,0,0,drop,70,70,0,1,0,1,0
62212,445,0,0,drop,70,70,0,1,0,1,0
50637,445,0,0,drop,70,70,0,1,0,1,0
62210,445,0,0,drop,70,70,0,1,0,1,0
62202,445,0,0,drop,70,70,0,1,0,1,0
62203,445,0,0,drop,70,70,0,1,0,1,0
54828,53,54828,53,allow,404,259,145,3,33,2,1
39966,53,39966,53,allow,235,90,145,2,32,1,1
57125,53,40271,53,allow,745,93,652,2,30,1,1
46423,443,25968,443,allow,1340,760,580,14,39,8,6
46424,443,29456,443,allow,1340,760,580,14,39,8,6
61816,80,7127,80,allow,2058,589,1469,10,45,6,4
56938,53,41054,53,allow,198,101,97,2,30,1,1
64798,53,2925,53,allow,172,88,84,2,30,1,1
51594,53,0,0,allow,206,95,111,2,31,1,1
62397,445,0,0,drop,66,66,0,1,0,1,0
62191,445,0,0,drop,70,70,0,1,0,1,0
62390,445,0,0,drop,66,66,0,1,0,1,0
59324,17,0,0,deny,60,60,0,1,0,1,0
62388,445,0,0,drop,66,66,0,1,0,1,0
62187,445,0,0,drop,70,70,0,1,0,1,0
62381,445,0,0,drop,66,66,0,1,0,1,0
62373,445,0,0,drop,66,66,0,1,0,1,0
62175,445,0,0,drop,70,70,0,1,0,1,0
62177,445,0,0,drop,70,70,0,1,0,1,0
62178,445,0,0,drop,70,70,0,1,0,1,0
62173,445,0,0,drop,70,70,0,1,0,1,0
64137,53,46613,53,allow,276,126,150,2,30,1,1
51535,443,24359,443,allow,322,262,60,2,4,1,1
55159,53,49513,53,allow,199,102,97,2,29,1,1
56927,53,35589,53,allow,183,94,89,2,30,1,1
56936,53,1448,53,allow,244,94,150,2,30,1,1
36405,443,39201,443,allow,1149,709,440,13,38,8,5
48936,443,24863,443,allow,494,280,214,8,49,5,3
45721,443,58682,443,allow,1925,1120,805,16,25,9,7
51671,443,38152,443,allow,1143,703,440,13,38,8,5
42804,80,7713,80,allow,1115,534,581,12,15,7,5
56664,80,50394,80,allow,234,234,0,4,11,4,0
56433,53,33860,53,allow,210,110,100,2,29,1,1
64034,53,38664,53,allow,194,102,92,2,29,1,1
65487,53,2041,53,allow,210,110,100,2,29,1,1
64238,53,7198,53,allow,211,102,109,2,29,1,1
55159,53,25315,53,allow,199,102,97,2,29,1,1
56327,53,21642,53,allow,178,94,84,2,29,1,1
56240,53,1263,53,allow,226,94,132,2,29,1,1
55387,53,44046,53,allow,172,94,78,2,29,1,1
65487,53,41710,53,allow,210,110,100,2,29,1,1
56534,53,33541,53,allow,276,94,182,2,30,1,1
56938,53,31467,53,allow,452,101,351,4,36,2,2
57442,66,49848,66,allow,70,70,0,2,8,2,0
50351,80,28696,80,allow,1083,653,430,8,15,5,3
64331,53,13624,53,allow,226,110,116,2,30,1,1
64874,53,59017,53,allow,323,110,213,2,30,1,1
49541,53,16544,53,allow,745,215,530,6,51,3,3
49969,53,31598,53,allow,199,102,97,2,30,1,1
64404,53,27516,53,allow,250,102,148,2,30,1,1
55543,53,20770,53,allow,402,118,284,2,30,1,1
56327,53,13541,53,allow,178,94,84,2,30,1,1
59595,53,23581,53,allow,164,78,86,2,30,1,1
65344,53,52002,53,allow,190,90,100,3,60,2,1
55875,53,25979,53,allow,296,110,186,2,30,1,1
59948,80,1436,80,allow,1756,414,1342,12,15,6,6
55374,25,55374,25,allow,130,66,64,2,5,1,1
65487,53,56832,53,allow,210,110,100,2,30,1,1
64798,53,7114,53,allow,178,94,84,2,30,1,1
51670,443,38480,443,allow,1203,703,500,14,38,8,6
36406,443,50079,443,allow,1149,709,440,13,38,8,5
36407,443,52772,443,allow,1149,709,440,13,38,8,5
43726,443,52371,443,allow,1201,707,494,12,35,7,5
63999,53,50492,53,allow,193,102,91,2,29,1,1
50990,53,51984,53,allow,232,94,138,2,29,1,1
56938,53,8399,53,allow,199,102,97,2,29,1,1
50717,80,28545,80,allow,1649,963,686,7,15,5,2
62322,80,60035,80,allow,384,384,0,7,34,7,0
64290,53,4027,53,allow,302,98,204,4,47,2,2
56927,53,57127,53,allow,183,94,89,2,30,1,1
64798,53,14494,53,allow,178,94,84,2,30,1,1
64034,53,27312,53,allow,194,102,92,2,30,1,1
49969,53,27742,53,allow,199,102,97,2,30,1,1
49700,443,48800,443,allow,64,64,0,2,5,2,0
59931,80,27664,80,allow,1272,786,486,8,31,5,3
64290,53,4374,53,allow,196,102,94,2,30,1,1
65065,53,58024,53,allow,209,110,99,2,30,1,1
61546,443,4493,443,allow,208,60,148,4,13,2,2
62311,443,64602,443,allow,598,598,0,8,41,8,0
49690,53,46468,53,allow,198,94,104,2,30,1,1
62170,445,0,0,drop,70,70,0,1,0,1,0
50605,445,0,0,drop,70,70,0,1,0,1,0
50603,445,0,0,drop,70,70,0,1,0,1,0
62365,445,0,0,drop,66,66,0,1,0,1,0
62363,445,0,0,drop,66,66,0,1,0,1,0
62361,445,0,0,drop,66,66,0,1,0,1,0
62362,445,0,0,drop,66,66,0,1,0,1,0
62360,445,0,0,drop,66,66,0,1,0,1,0
62364,445,0,0,drop,66,66,0,1,0,1,0
62359,445,0,0,drop,66,66,0,1,0,1,0
62358,445,0,0,drop,66,66,0,1,0,1,0
62164,445,0,0,drop,70,70,0,1,0,1,0
62157,445,0,0,drop,70,70,0,1,0,1,0
62156,445,0,0,drop,70,70,0,1,0,1,0
50596,445,0,0,drop,70,70,0,1,0,1,0
50597,445,0,0,drop,70,70,0,1,0,1,0
50589,445,0,0,drop,70,70,0,1,0,1,0
50584,445,0,0,drop,70,70,0,1,0,1,0
62345,445,0,0,drop,66,66,0,1,0,1,0
62344,445,0,0,drop,66,66,0,1,0,1,0
62342,445,0,0,deny,66,66,0,1,0,1,0
62150,445,0,0,drop,70,70,0,1,0,1,0
62149,445,0,0,drop,70,70,0,1,0,1,0
50574,445,0,0,drop,70,70,0,1,0,1,0
50573,445,0,0,drop,70,70,0,1,0,1,0
50572,445,0,0,drop,70,70,0,1,0,1,0
62145,445,0,0,drop,70,70,0,1,0,1,0
62144,445,0,0,drop,70,70,0,1,0,1,0
62139,445,0,0,drop,70,70,0,1,0,1,0
50563,445,0,0,drop,70,70,0,1,0,1,0
50561,445,0,0,drop,70,70,0,1,0,1,0
50559,445,0,0,drop,70,70,0,1,0,1,0
62331,445,0,0,drop,66,66,0,1,0,1,0
62126,445,0,0,drop,70,70,0,1,0,1,0
62316,445,0,0,drop,66,66,0,1,0,1,0
62315,445,0,0,drop,66,66,0,1,0,1,0
62123,445,0,0,drop,70,70,0,1,0,1,0
50547,445,0,0,drop,70,70,0,1,0,1,0
50543,445,0,0,drop,70,70,0,1,0,1,0
62309,445,0,0,drop,66,66,0,1,0,1,0
62117,445,0,0,drop,70,70,0,1,0,1,0
62115,445,0,0,drop,70,70,0,1,0,1,0
62306,445,0,0,drop,66,66,0,1,0,1,0
62304,445,0,0,drop,66,66,0,1,0,1,0
62303,445,0,0,drop,66,66,0,1,0,1,0
62298,445,0,0,drop,66,66,0,1,0,1,0
62295,445,0,0,drop,66,66,0,1,0,1,0
62297,445,0,0,drop,66,66,0,1,0,1,0
62296,445,0,0,drop,66,66,0,1,0,1,0
50527,445,0,0,drop,70,70,0,1,0,1,0
50525,445,0,0,drop,70,70,0,1,0,1,0
62108,445,0,0,drop,70,70,0,1,0,1,0
62106,445,0,0,drop,70,70,0,1,0,1,0
62919,993,20862,993,allow,134,60,74,3,11,2,1
56425,53,0,0,allow,82,82,0,1,30,1,0
58992,53,0,0,allow,273,86,187,2,30,1,1
59945,80,11723,80,allow,1197,419,778,9,16,5,4
65379,53,64746,53,allow,376,126,250,2,30,1,1
36889,80,51153,80,allow,1584,1130,454,15,39,10,5
51594,53,0,0,allow,206,95,111,2,30,1,1
50341,80,19405,80,allow,306,180,126,6,41,4,2
49647,53,49647,53,allow,404,259,145,3,32,2,1
50521,445,0,0,drop,70,70,0,1,0,1,0
50517,445,0,0,drop,70,70,0,1,0,1,0
50516,445,0,0,drop,70,70,0,1,0,1,0
62105,445,0,0,drop,70,70,0,1,0,1,0
62288,445,0,0,drop,66,66,0,1,0,1,0
50514,445,0,0,drop,70,70,0,1,0,1,0
62104,445,0,0,drop,70,70,0,1,0,1,0
62103,445,0,0,drop,70,70,0,1,0,1,0
62101,445,0,0,drop,70,70,0,1,0,1,0
62099,445,0,0,drop,70,70,0,1,0,1,0
62286,445,0,0,drop,66,66,0,1,0,1,0
62283,445,0,0,drop,66,66,0,1,0,1,0
62282,445,0,0,drop,66,66,0,1,0,1,0
62281,445,0,0,drop,66,66,0,1,0,1,0
62085,445,0,0,drop,70,70,0,1,0,1,0
62084,445,0,0,drop,70,70,0,1,0,1,0
62082,445,0,0,drop,70,70,0,1,0,1,0
62075,445,0,0,drop,70,70,0,1,0,1,0
62074,445,0,0,drop,70,70,0,1,0,1,0
50511,445,0,0,drop,70,70,0,1,0,1,0
50500,445,0,0,drop,70,70,0,1,0,1,0
50497,445,0,0,drop,70,70,0,1,0,1,0
62269,445,0,0,drop,66,66,0,1,0,1,0
63974,80,35530,80,allow,314,192,122,6,15,4,2
50587,80,50587,80,allow,1711,1011,700,11,21,6,5
53365,80,32049,80,allow,405,285,120,5,15,3,2
50346,80,22819,80,allow,502,250,252,9,41,5,4
64798,53,32594,53,allow,303,88,215,4,40,2,2
56927,53,28530,53,allow,183,94,89,2,29,1,1
49578,53,60840,53,allow,212,102,110,2,29,1,1
57103,53,61295,53,allow,193,102,91,2,29,1,1
49508,53,61449,53,allow,370,102,268,2,30,1,1
57089,53,62761,53,allow,226,110,116,2,30,1,1
46831,53,55820,53,allow,391,102,289,2,30,1,1
53222,53,43522,53,allow,165,78,87,2,30,1,1
53223,53,33950,53,allow,165,78,87,2,30,1,1
64698,53,59784,53,allow,430,106,324,4,58,2,2
49444,53,22362,53,allow,212,102,110,2,30,1,1
57339,443,47908,443,allow,1495,768,727,16,26,9,7
50343,80,37536,80,allow,1192,658,534,11,41,6,5
50339,80,14820,80,allow,306,180,126,6,41,4,2
62061,445,0,0,drop,70,70,0,1,0,1,0
57346,443,34868,443,allow,1547,960,587,14,22,8,6
57599,80,28045,80,allow,808,485,323,8,75,5,3
57103,53,56809,53,allow,193,102,91,2,30,1,1
53537,53,1672,53,allow,391,102,289,2,29,1,1
56903,53,50850,53,allow,232,94,138,2,30,1,1
49515,53,21422,53,allow,226,110,116,2,29,1,1
50589,80,50589,80,allow,1714,1014,700,11,21,6,5
55901,53,32764,53,allow,226,110,116,2,30,1,1
57344,53,44764,53,allow,228,110,118,2,30,1,1
57398,53,47898,53,allow,232,110,122,2,30,1,1
49598,80,65095,80,allow,400,70,330,6,24,1,5
62481,80,55007,80,allow,890,440,450,10,33,6,4
42732,53,10027,53,allow,86,86,0,1,30,1,0
65048,53,24505,53,allow,396,84,312,4,54,2,2
63965,53,50907,53,allow,306,94,212,2,30,1,1
65353,53,55498,53,allow,351,105,246,4,57,2,2
44864,25,44864,25,allow,130,66,64,2,5,1,1
62262,445,0,0,drop,66,66,0,1,0,1,0
62260,445,0,0,drop,66,66,0,1,0,1,0
62057,445,0,0,drop,70,70,0,1,0,1,0
62045,445,0,0,drop,70,70,0,1,0,1,0
62048,445,0,0,drop,70,70,0,1,0,1,0
62253,445,0,0,drop,66,66,0,1,0,1,0
62044,445,0,0,drop,70,70,0,1,0,1,0
62041,445,0,0,drop,70,70,0,1,0,1,0
62245,445,0,0,drop,66,66,0,1,0,1,0
50474,445,0,0,drop,70,70,0,1,0,1,0
50475,445,0,0,drop,70,70,0,1,0,1,0
62035,445,0,0,drop,70,70,0,1,0,1,0
62237,445,0,0,drop,66,66,0,1,0,1,0
62230,445,0,0,drop,66,66,0,1,0,1,0
62234,445,0,0,drop,66,66,0,1,0,1,0
62233,445,0,0,drop,66,66,0,1,0,1,0
62235,445,0,0,drop,66,66,0,1,0,1,0
62236,445,0,0,drop,66,66,0,1,0,1,0
62229,445,0,0,drop,66,66,0,1,0,1,0
62231,445,0,0,drop,66,66,0,1,0,1,0
62027,445,0,0,drop,70,70,0,1,0,1,0
62025,445,0,0,drop,70,70,0,1,0,1,0
50465,445,0,0,drop,70,70,0,1,0,1,0
50458,445,0,0,drop,70,70,0,1,0,1,0
50456,445,0,0,drop,70,70,0,1,0,1,0
62020,445,0,0,drop,70,70,0,1,0,1,0
62019,445,0,0,drop,70,70,0,1,0,1,0
62217,445,0,0,drop,66,66,0,1,0,1,0
62215,445,0,0,drop,66,66,0,1,0,1,0
62214,445,0,0,drop,66,66,0,1,0,1,0
62015,445,0,0,drop,70,70,0,1,0,1,0
50455,445,0,0,drop,70,70,0,1,0,1,0
50446,445,0,0,drop,70,70,0,1,0,1,0
50445,445,0,0,drop,70,70,0,1,0,1,0
50444,445,0,0,drop,70,70,0,1,0,1,0
62014,445,0,0,drop,70,70,0,1,0,1,0
62009,445,0,0,drop,70,70,0,1,0,1,0
50432,445,0,0,drop,70,70,0,1,0,1,0
50434,445,0,0,drop,70,70,0,1,0,1,0
50431,445,0,0,drop,70,70,0,1,0,1,0
62203,445,0,0,drop,66,66,0,1,0,1,0
61996,445,0,0,drop,70,70,0,1,0,1,0
50428,445,0,0,drop,70,70,0,1,0,1,0
61993,445,0,0,drop,70,70,0,1,0,1,0
62186,445,0,0,drop,66,66,0,1,0,1,0
50413,445,0,0,drop,70,70,0,1,0,1,0
50412,445,0,0,drop,70,70,0,1,0,1,0
61989,445,0,0,drop,70,70,0,1,0,1,0
61987,445,0,0,drop,70,70,0,1,0,1,0
62184,445,0,0,drop,66,66,0,1,0,1,0
61985,445,0,0,drop,70,70,0,1,0,1,0
62172,445,0,0,drop,66,66,0,1,0,1,0
62176,445,0,0,drop,66,66,0,1,0,1,0
62177,445,0,0,drop,66,66,0,1,0,1,0
62178,445,0,0,drop,66,66,0,1,0,1,0
62173,445,0,0,drop,66,66,0,1,0,1,0
62171,445,0,0,drop,66,66,0,1,0,1,0
62167,445,0,0,drop,66,66,0,1,0,1,0
59944,80,51806,80,allow,1186,390,796,9,16,5,4
53589,53,45469,53,allow,578,286,292,9,15,5,4
54902,80,36045,80,allow,1107,630,477,10,16,6,4
60055,53,0,0,allow,82,82,0,1,30,1,0
50404,445,0,0,drop,70,70,0,1,0,1,0
50399,445,0,0,drop,70,70,0,1,0,1,0
50398,445,0,0,drop,70,70,0,1,0,1,0
50395,445,0,0,drop,70,70,0,1,0,1,0
61978,445,0,0,drop,70,70,0,1,0,1,0
61976,445,0,0,drop,70,70,0,1,0,1,0
61975,445,0,0,drop,70,70,0,1,0,1,0
61974,445,0,0,drop,70,70,0,1,0,1,0
61973,445,0,0,drop,70,70,0,1,0,1,0
50392,445,0,0,drop,70,70,0,1,0,1,0
50391,445,0,0,drop,70,70,0,1,0,1,0
50389,445,0,0,drop,70,70,0,1,0,1,0
61968,445,0,0,drop,70,70,0,1,0,1,0
61967,445,0,0,drop,70,70,0,1,0,1,0
62160,445,0,0,drop,66,66,0,1,0,1,0
50386,445,0,0,drop,70,70,0,1,0,1,0
62157,445,0,0,drop,66,66,0,1,0,1,0
62155,445,0,0,drop,66,66,0,1,0,1,0
62156,445,0,0,drop,66,66,0,1,0,1,0
62153,445,0,0,drop,66,66,0,1,0,1,0
61955,445,0,0,drop,70,70,0,1,0,1,0
61954,445,0,0,drop,70,70,0,1,0,1,0
61950,445,0,0,drop,70,70,0,1,0,1,0
61945,445,0,0,drop,70,70,0,1,0,1,0
61944,445,0,0,drop,70,70,0,1,0,1,0
50381,445,0,0,drop,70,70,0,1,0,1,0
50376,445,0,0,drop,70,70,0,1,0,1,0
50370,445,0,0,drop,70,70,0,1,0,1,0
62141,445,0,0,drop,66,66,0,1,0,1,0
61933,445,0,0,drop,70,70,0,1,0,1,0
63346,53,0,0,deny,75,75,0,1,0,1,0
53624,53,53624,53,allow,832,106,726,2,29,1,1
56445,53,19322,53,allow,374,94,280,2,30,1,1
49282,53,18906,53,allow,197,94,103,2,30,1,1
64088,53,9032,53,allow,434,108,326,4,51,2,2
55722,53,10365,53,allow,229,110,119,2,30,1,1
56809,53,8718,53,allow,232,94,138,2,30,1,1
56663,80,6268,80,allow,234,234,0,4,12,4,0
64157,53,10043,53,allow,323,90,233,4,48,2,2
58171,80,42934,80,allow,1651,550,1101,13,15,7,6
50700,80,27825,80,allow,142,142,0,1,5,1,0
48111,443,2939,443,allow,214,140,74,4,15,3,1
60265,53,3375,53,allow,215,86,129,2,30,1,1
64941,53,51178,53,allow,216,94,122,2,30,1,1
65191,53,55910,53,allow,294,102,192,2,30,1,1
46592,53,27919,53,allow,168,78,90,2,30,1,1
59676,53,12870,53,allow,195,94,101,2,30,1,1
50116,22,50116,22,allow,152,66,86,2,9,1,1
49356,53,31614,53,allow,209,102,107,2,30,1,1
58914,53,2441,53,allow,244,86,158,2,30,1,1
64812,53,57206,53,allow,347,91,256,4,56,2,2
50688,53,22980,53,allow,78,78,0,1,30,1,0
56713,53,30137,53,allow,226,110,116,2,30,1,1
65265,53,48964,53,allow,207,86,121,2,30,1,1
50345,53,44210,53,allow,193,102,91,2,30,1,1
64463,53,25750,53,allow,183,94,89,2,31,1,1
50679,80,21512,80,allow,132,132,0,2,8,2,0
64617,53,10590,53,allow,301,102,199,2,30,1,1
62134,445,0,0,drop,66,66,0,1,0,1,0
50358,445,0,0,drop,70,70,0,1,0,1,0
61929,445,0,0,drop,70,70,0,1,0,1,0
62132,445,0,0,drop,66,66,0,1,0,1,0
61917,445,0,0,drop,70,70,0,1,0,1,0
61919,445,0,0,drop,70,70,0,1,0,1,0
61920,445,0,0,drop,70,70,0,1,0,1,0
61915,445,0,0,drop,70,70,0,1,0,1,0
61913,445,0,0,drop,70,70,0,1,0,1,0
62125,445,0,0,drop,66,66,0,1,0,1,0
62122,445,0,0,drop,66,66,0,1,0,1,0
37617,443,47875,443,allow,499,425,74,4,0,3,1
49482,22,0,0,deny,60,60,0,1,0,1,0
61906,445,0,0,drop,70,70,0,1,0,1,0
50350,445,0,0,drop,70,70,0,1,0,1,0
62109,445,0,0,drop,66,66,0,1,0,1,0
62102,445,0,0,drop,66,66,0,1,0,1,0
62105,445,0,0,drop,66,66,0,1,0,1,0
62107,445,0,0,drop,66,66,0,1,0,1,0
62101,445,0,0,drop,66,66,0,1,0,1,0
62103,445,0,0,drop,66,66,0,1,0,1,0
62108,445,0,0,drop,66,66,0,1,0,1,0
62106,445,0,0,drop,66,66,0,1,0,1,0
61899,445,0,0,drop,70,70,0,1,0,1,0
61898,445,0,0,drop,70,70,0,1,0,1,0
61892,445,0,0,drop,70,70,0,1,0,1,0
50344,445,0,0,drop,70,70,0,1,0,1,0
50339,445,0,0,drop,70,70,0,1,0,1,0
50330,445,0,0,drop,70,70,0,1,0,1,0
50328,445,0,0,drop,70,70,0,1,0,1,0
61891,445,0,0,drop,70,70,0,1,0,1,0
62088,445,0,0,drop,66,66,0,1,0,1,0
62089,445,0,0,drop,66,66,0,1,0,1,0
62086,445,0,0,drop,66,66,0,1,0,1,0
61887,445,0,0,drop,70,70,0,1,0,1,0
50327,445,0,0,drop,70,70,0,1,0,1,0
61886,445,0,0,drop,70,70,0,1,0,1,0
50318,445,0,0,drop,70,70,0,1,0,1,0
50322,445,0,0,drop,70,70,0,1,0,1,0
50317,445,0,0,drop,70,70,0,1,0,1,0
61881,445,0,0,drop,70,70,0,1,0,1,0
50309,445,0,0,drop,70,70,0,1,0,1,0
50304,445,0,0,drop,70,70,0,1,0,1,0
62077,445,0,0,drop,66,66,0,1,0,1,0
61868,445,0,0,drop,70,70,0,1,0,1,0
61865,445,0,0,drop,70,70,0,1,0,1,0
54278,53,0,0,allow,82,82,0,1,30,1,0
49994,443,12654,443,allow,378,82,296,5,17,1,4
63062,53,6744,53,allow,303,85,218,2,30,1,1
63063,443,23701,443,allow,303,85,218,2,30,1,1
40803,443,57775,443,allow,1093,662,431,10,46,6,4
54031,443,8430,443,allow,350,210,140,6,25,4,2
63961,53,35480,53,allow,184,86,98,2,30,1,1
64827,53,64827,53,allow,288,83,205,2,30,1,1
63071,443,65203,443,allow,569,164,405,2,30,1,1
63070,53,63583,53,allow,446,164,282,2,30,1,1
62061,445,0,0,drop,66,66,0,1,0,1,0
62057,445,0,0,drop,66,66,0,1,0,1,0
61861,445,0,0,drop,70,70,0,1,0,1,0
61859,445,0,0,drop,70,70,0,1,0,1,0
50289,445,0,0,drop,70,70,0,1,0,1,0
50283,445,0,0,drop,70,70,0,1,0,1,0
50282,445,0,0,drop,70,70,0,1,0,1,0
61857,445,0,0,drop,70,70,0,1,0,1,0
62053,445,0,0,drop,66,66,0,1,0,1,0
49591,53,54188,53,allow,408,86,322,4,31,2,2
63056,443,24879,443,allow,304,86,218,2,30,1,1
63068,443,50738,443,allow,571,166,405,2,30,1,1
50632,80,1606,80,allow,1559,1107,452,9,22,5,4
60438,53,27899,53,allow,154,154,0,3,46,3,0
61691,53,19669,53,allow,256,94,162,2,30,1,1
50995,53,51013,53,allow,168,78,90,2,30,1,1
38100,53,30457,53,allow,168,78,90,2,30,1,1
52618,80,60049,80,allow,1141,529,612,10,18,6,4
54136,443,42387,443,allow,1053,566,487,10,16,6,4
50374,53,63648,53,allow,755,102,653,2,29,1,1
63075,53,54531,53,allow,571,166,405,2,29,1,1
63074,443,53301,443,allow,384,166,218,2,29,1,1
58726,53,60102,53,allow,247,102,145,2,30,1,1
50345,53,41743,53,allow,193,102,91,2,30,1,1
63059,53,39205,53,allow,304,86,218,2,30,1,1
64406,53,46788,53,allow,204,204,0,3,46,3,0
64124,53,32205,53,allow,236,86,150,2,30,1,1
63069,53,35959,53,allow,384,166,218,2,30,1,1
63058,443,54083,443,allow,304,86,218,2,30,1,1
60946,443,58938,443,allow,1373,712,661,14,18,8,6
49634,53,43147,53,allow,344,126,218,2,30,1,1
40603,80,57176,80,allow,1104,475,629,10,15,6,4
65064,53,44516,53,allow,338,110,228,2,30,1,1
60949,443,41744,443,allow,1598,794,804,16,18,9,7
56654,53,7518,53,allow,306,306,0,4,47,4,0
59813,53,1465,53,allow,355,118,237,2,30,1,1
54699,53,18510,53,allow,236,86,150,2,30,1,1
44136,53,62801,53,allow,220,78,142,2,30,1,1
61637,53,50085,53,allow,246,246,0,4,47,4,0
59779,443,38576,443,allow,142,142,0,1,5,1,0
45511,443,41466,443,allow,130,70,60,2,15,1,1
55445,53,39762,53,allow,192,192,0,3,46,3,0
53434,53,32877,53,allow,261,261,0,4,47,4,0
63067,53,20594,53,allow,384,166,218,2,30,1,1
63060,53,7236,53,allow,304,86,218,2,30,1,1
55305,53,27046,53,allow,176,176,0,3,46,3,0
60945,443,60187,443,allow,1373,712,661,14,18,8,6
46683,443,6885,443,allow,234,234,0,4,12,4,0
42574,443,64198,443,allow,130,70,60,3,5,2,1
64828,53,47016,53,allow,881,243,638,6,39,3,3
62995,53,20908,53,allow,202,202,0,3,46,3,0
55348,53,14185,53,allow,332,94,238,2,29,1,1
63073,53,51318,53,allow,304,86,218,2,30,1,1
54553,53,62342,53,allow,202,202,0,3,46,3,0
65501,53,1213,53,allow,226,94,132,2,29,1,1
63072,443,30970,443,allow,304,86,218,2,30,1,1
63066,443,9445,443,allow,448,166,282,2,30,1,1
60580,53,24695,53,allow,229,94,135,2,30,1,1
63064,443,8160,443,allow,448,166,282,2,30,1,1
49897,53,22937,53,allow,384,94,290,2,30,1,1
63057,53,17577,53,allow,304,86,218,2,30,1,1
46404,53,18296,53,allow,240,86,154,2,30,1,1
63061,443,64217,443,allow,304,86,218,2,30,1,1
60958,443,2953,443,allow,1547,960,587,14,17,8,6
60947,443,46012,443,allow,1373,712,661,14,18,8,6
45510,443,22832,443,allow,130,70,60,2,15,1,1
52989,53,36046,53,allow,406,94,312,2,30,1,1
60948,443,3715,443,allow,1373,712,661,14,18,8,6
50116,22,50116,22,allow,66,66,0,1,5,1,0
62074,443,56208,443,allow,350,210,140,6,15,4,2
53791,53,58724,53,allow,204,204,0,3,46,3,0
61072,53,60652,53,allow,1139,878,261,2,30,1,1
63065,53,14429,53,allow,448,166,282,2,30,1,1
64463,53,17671,53,allow,183,94,89,2,30,1,1
55427,53,42725,53,allow,442,110,332,4,44,2,2
65071,53,49896,53,allow,93,93,0,2,60,2,0
52178,443,8092,443,allow,414,140,274,7,26,3,4
59489,53,5531,53,allow,168,78,90,2,30,1,1
62048,445,0,0,drop,66,66,0,1,0,1,0
62047,445,0,0,drop,66,66,0,1,0,1,0
62042,445,0,0,drop,66,66,0,1,0,1,0
62050,445,0,0,drop,66,66,0,1,0,1,0
62049,445,0,0,drop,66,66,0,1,0,1,0
62044,445,0,0,drop,66,66,0,1,0,1,0
62038,445,0,0,drop,66,66,0,1,0,1,0
50271,445,0,0,drop,70,70,0,1,0,1,0
50267,445,0,0,drop,70,70,0,1,0,1,0
61850,445,0,0,drop,70,70,0,1,0,1,0
61848,445,0,0,drop,70,70,0,1,0,1,0
61847,445,0,0,drop,70,70,0,1,0,1,0
61846,445,0,0,drop,70,70,0,1,0,1,0
61845,445,0,0,drop,70,70,0,1,0,1,0
61843,445,0,0,drop,70,70,0,1,0,1,0
61841,445,0,0,drop,70,70,0,1,0,1,0
50263,445,0,0,drop,70,70,0,1,0,1,0
50261,445,0,0,drop,70,70,0,1,0,1,0
62033,445,0,0,drop,66,66,0,1,0,1,0
39873,23,0,0,deny,60,60,0,1,0,1,0
50258,445,0,0,drop,70,70,0,1,0,1,0
62029,445,0,0,drop,66,66,0,1,0,1,0
61827,445,0,0,drop,70,70,0,1,0,1,0
61826,445,0,0,drop,70,70,0,1,0,1,0
61820,445,0,0,drop,70,70,0,1,0,1,0
62027,445,0,0,drop,66,66,0,1,0,1,0
62026,445,0,0,drop,66,66,0,1,0,1,0
61816,445,0,0,drop,70,70,0,1,0,1,0
61817,445,0,0,drop,70,70,0,1,0,1,0
62025,445,0,0,drop,66,66,0,1,0,1,0
50255,445,0,0,drop,70,70,0,1,0,1,0
50240,445,0,0,drop,70,70,0,1,0,1,0
50242,445,0,0,drop,70,70,0,1,0,1,0
61805,445,0,0,drop,70,70,0,1,0,1,0
62013,445,0,0,drop,66,66,0,1,0,1,0
62006,445,0,0,drop,66,66,0,1,0,1,0
61801,445,0,0,drop,70,70,0,1,0,1,0
50233,445,0,0,deny,70,70,0,1,0,1,0
61792,445,0,0,drop,70,70,0,1,0,1,0
61791,445,0,0,drop,70,70,0,1,0,1,0
61790,445,0,0,drop,70,70,0,1,0,1,0
62003,445,0,0,drop,66,66,0,1,0,1,0
61788,445,0,0,drop,70,70,0,1,0,1,0
61784,445,0,0,drop,70,70,0,1,0,1,0
61997,445,0,0,drop,66,66,0,1,0,1,0
61993,445,0,0,drop,66,66,0,1,0,1,0
61779,445,0,0,drop,70,70,0,1,0,1,0
43332,81,0,0,deny,60,60,0,1,0,1,0
50222,445,0,0,drop,70,70,0,1,0,1,0
50218,445,0,0,drop,70,70,0,1,0,1,0
61979,445,0,0,drop,66,66,0,1,0,1,0
61981,445,0,0,drop,66,66,0,1,0,1,0
61977,445,0,0,drop,66,66,0,1,0,1,0
61976,445,0,0,drop,66,66,0,1,0,1,0
61978,445,0,0,drop,66,66,0,1,0,1,0
61975,445,0,0,drop,66,66,0,1,0,1,0
61974,445,0,0,drop,66,66,0,1,0,1,0
61973,445,0,0,drop,66,66,0,1,0,1,0
61771,445,0,0,drop,70,70,0,1,0,1,0
61770,445,0,0,drop,70,70,0,1,0,1,0
61764,445,0,0,drop,70,70,0,1,0,1,0
61763,445,0,0,drop,70,70,0,1,0,1,0
50211,445,0,0,drop,70,70,0,1,0,1,0
50209,445,0,0,drop,70,70,0,1,0,1,0
50201,445,0,0,drop,70,70,0,1,0,1,0
50199,445,0,0,drop,70,70,0,1,0,1,0
61959,445,0,0,drop,66,66,0,1,0,1,0
61960,445,0,0,drop,66,66,0,1,0,1,0
61961,445,0,0,drop,66,66,0,1,0,1,0
61759,445,0,0,drop,70,70,0,1,0,1,0
61758,445,0,0,drop,70,70,0,1,0,1,0
50197,445,0,0,drop,70,70,0,1,0,1,0
50192,445,0,0,drop,70,70,0,1,0,1,0
50191,445,0,0,drop,70,70,0,1,0,1,0
50187,445,0,0,drop,70,70,0,1,0,1,0
61753,445,0,0,drop,70,70,0,1,0,1,0
50180,445,0,0,drop,70,70,0,1,0,1,0
50178,445,0,0,drop,70,70,0,1,0,1,0
50176,445,0,0,drop,70,70,0,1,0,1,0
61948,445,0,0,drop,66,66,0,1,0,1,0
61740,445,0,0,drop,70,70,0,1,0,1,0
42749,53,42749,53,allow,847,110,737,2,30,1,1
64612,53,64612,53,allow,213,87,126,2,30,1,1
51463,53,0,0,allow,82,82,0,1,30,1,0
48013,53,0,0,allow,82,82,0,1,30,1,0
50649,80,63151,80,allow,1366,865,501,8,15,5,3
61099,443,33626,443,allow,492,492,0,7,15,7,0
49566,80,12827,80,allow,1268,703,565,11,23,6,5
64891,53,61433,53,allow,320,97,223,4,34,2,2
52179,443,47721,443,allow,414,140,274,7,25,3,4
65245,53,10432,53,allow,479,98,381,4,57,2,2
64063,53,31532,53,allow,339,110,229,2,29,1,1
49997,53,41448,53,allow,284,94,190,2,29,1,1
49581,80,58944,80,allow,2339,1107,1232,11,21,6,5
65469,53,60792,53,allow,327,110,217,2,30,1,1
36803,53,44440,53,allow,243,86,157,2,30,1,1
49319,53,53546,53,allow,260,102,158,2,30,1,1
48717,443,44246,443,allow,232,172,60,3,5,2,1
50169,53,35420,53,allow,223,78,145,2,30,1,1
64214,53,1437,53,allow,337,106,231,4,43,2,2
46405,80,41634,80,allow,1213,755,458,10,15,6,4
37833,80,26930,80,allow,2087,729,1358,10,15,5,5
55310,53,40255,53,allow,168,78,90,2,29,1,1
65134,53,41256,53,allow,273,102,171,2,30,1,1
39442,123,6602,123,allow,184,94,90,2,30,1,1
64463,53,2430,53,allow,183,94,89,2,29,1,1
49380,53,7490,53,allow,110,110,0,1,30,1,0
38886,53,39118,53,allow,223,78,145,2,30,1,1
64494,53,62617,53,allow,402,118,284,2,30,1,1
51487,443,12254,443,allow,828,390,438,11,60,4,7
61100,80,15206,80,allow,1516,481,1035,11,15,6,5
56662,80,65360,80,allow,234,234,0,4,12,4,0
49986,53,37815,53,allow,312,93,219,4,37,2,2
47282,443,1990,443,allow,130,70,60,2,15,1,1
61737,445,0,0,drop,70,70,0,1,0,1,0
50172,445,0,0,drop,70,70,0,1,0,1,0
49916,53,53241,53,allow,118,118,0,1,30,1,0
64711,53,30437,53,allow,179,86,93,2,30,1,1
64906,53,18657,53,allow,209,110,99,2,30,1,1
64921,53,46383,53,allow,238,102,136,2,31,1,1
49546,443,43053,443,allow,1346,918,428,10,23,6,4
49547,443,35951,443,allow,1346,918,428,10,23,6,4
55653,23,0,0,deny,60,60,0,1,0,1,0
61933,445,0,0,drop,66,66,0,1,0,1,0
61931,445,0,0,drop,66,66,0,1,0,1,0
61733,445,0,0,drop,70,70,0,1,0,1,0
61731,445,0,0,drop,70,70,0,1,0,1,0
61729,445,0,0,drop,70,70,0,1,0,1,0
50159,445,0,0,drop,70,70,0,1,0,1,0
50160,445,0,0,drop,70,70,0,1,0,1,0
50154,445,0,0,drop,70,70,0,1,0,1,0
50152,445,0,0,drop,70,70,0,1,0,1,0
61927,445,0,0,drop,66,66,0,1,0,1,0
61918,445,0,0,drop,66,66,0,1,0,1,0
61911,445,0,0,drop,66,66,0,1,0,1,0
61917,445,0,0,drop,66,66,0,1,0,1,0
61916,445,0,0,drop,66,66,0,1,0,1,0
61912,445,0,0,drop,66,66,0,1,0,1,0
61910,445,0,0,drop,66,66,0,1,0,1,0
61722,445,0,0,drop,70,70,0,1,0,1,0
50145,445,0,0,drop,70,70,0,1,0,1,0
50142,445,0,0,drop,70,70,0,1,0,1,0
50140,445,0,0,drop,70,70,0,1,0,1,0
53883,443,37691,443,allow,495,421,74,4,0,3,1
53879,443,22578,443,allow,499,425,74,4,1,3,1
53874,443,50535,443,allow,499,425,74,4,1,3,1
53877,443,42282,443,allow,499,425,74,4,1,3,1
53875,443,27415,443,allow,499,425,74,4,1,3,1
53872,443,24185,443,allow,499,425,74,4,1,3,1
50138,445,0,0,drop,70,70,0,1,0,1,0
61720,445,0,0,drop,70,70,0,1,0,1,0
61719,445,0,0,drop,70,70,0,1,0,1,0
61718,445,0,0,drop,70,70,0,1,0,1,0
61717,445,0,0,drop,70,70,0,1,0,1,0
61714,445,0,0,drop,70,70,0,1,0,1,0
61711,445,0,0,drop,70,70,0,1,0,1,0
50133,445,0,0,drop,70,70,0,1,0,1,0
50132,445,0,0,drop,70,70,0,1,0,1,0
61903,445,0,0,drop,66,66,0,1,0,1,0
61699,445,0,0,drop,70,70,0,1,0,1,0
61698,445,0,0,drop,70,70,0,1,0,1,0
50129,445,0,0,drop,70,70,0,1,0,1,0
61692,445,0,0,drop,70,70,0,1,0,1,0
61902,445,0,0,drop,66,66,0,1,0,1,0
61689,445,0,0,drop,70,70,0,1,0,1,0
61688,445,0,0,drop,70,70,0,1,0,1,0
61899,445,0,0,drop,66,66,0,1,0,1,0
61898,445,0,0,drop,66,66,0,1,0,1,0
61897,445,0,0,drop,66,66,0,1,0,1,0
53873,443,46663,443,allow,499,425,74,4,1,3,1
53878,443,30400,443,allow,499,425,74,4,1,3,1
53876,443,64698,443,allow,499,425,74,4,1,3,1
53868,443,61364,443,allow,499,425,74,4,1,3,1
53871,443,16922,443,allow,499,425,74,4,1,3,1
53863,443,62778,443,allow,499,425,74,4,1,3,1
53869,443,21669,443,allow,499,425,74,4,1,3,1
53865,443,28083,443,allow,499,425,74,4,1,3,1
53862,443,35996,443,allow,499,425,74,4,1,3,1
53870,443,3316,443,allow,499,425,74,4,1,3,1
53864,443,39351,443,allow,499,425,74,4,1,3,1
53861,443,51732,443,allow,499,425,74,4,1,3,1
53867,443,58511,443,allow,499,425,74,4,1,3,1
53860,443,61776,443,allow,499,425,74,4,1,3,1
53858,443,59816,443,allow,499,425,74,4,1,3,1
53866,443,56444,443,allow,499,425,74,4,1,3,1
53857,443,11803,443,allow,499,425,74,4,1,3,1
53859,443,52772,443,allow,499,425,74,4,1,3,1
50123,445,0,0,drop,70,70,0,1,0,1,0
61677,445,0,0,drop,70,70,0,1,0,1,0
51490,1,0,0,deny,100,100,0,1,0,1,0
50112,445,0,0,drop,70,70,0,1,0,1,0
61885,445,0,0,drop,66,66,0,1,0,1,0
61673,445,0,0,drop,70,70,0,1,0,1,0
61878,445,0,0,drop,66,66,0,1,0,1,0
50106,445,0,0,drop,70,70,0,1,0,1,0
61661,445,0,0,drop,70,70,0,1,0,1,0
61664,445,0,0,drop,70,70,0,1,0,1,0
61662,445,0,0,drop,70,70,0,1,0,1,0
61659,445,0,0,drop,70,70,0,1,0,1,0
61657,445,0,0,drop,70,70,0,1,0,1,0
61875,445,0,0,drop,66,66,0,1,0,1,0
61869,445,0,0,drop,66,66,0,1,0,1,0
61865,445,0,0,drop,66,66,0,1,0,1,0
61650,445,0,0,drop,70,70,0,1,0,1,0
61643,445,0,0,drop,70,70,0,1,0,1,0
50093,445,0,0,drop,70,70,0,1,0,1,0
50090,445,0,0,drop,70,70,0,1,0,1,0
61642,445,0,0,drop,70,70,0,1,0,1,0
61848,445,0,0,drop,66,66,0,1,0,1,0
61852,445,0,0,drop,66,66,0,1,0,1,0
61851,445,0,0,drop,66,66,0,1,0,1,0
61850,445,0,0,drop,66,66,0,1,0,1,0
61853,445,0,0,drop,66,66,0,1,0,1,0
61849,445,0,0,drop,66,66,0,1,0,1,0
61846,445,0,0,drop,66,66,0,1,0,1,0
61635,445,0,0,drop,70,70,0,1,0,1,0
50082,445,0,0,drop,70,70,0,1,0,1,0
50080,445,0,0,drop,70,70,0,1,0,1,0
50073,445,0,0,drop,70,70,0,1,0,1,0
50071,445,0,0,drop,70,70,0,1,0,1,0
61631,445,0,0,drop,70,70,0,1,0,1,0
61833,445,0,0,drop,66,66,0,1,0,1,0
61832,445,0,0,drop,66,66,0,1,0,1,0
61831,445,0,0,drop,66,66,0,1,0,1,0
61630,445,0,0,drop,70,70,0,1,0,1,0
50069,445,0,0,drop,70,70,0,1,0,1,0
50068,445,0,0,drop,70,70,0,1,0,1,0
50064,445,0,0,drop,70,70,0,1,0,1,0
50059,445,0,0,drop,70,70,0,1,0,1,0
59813,53,59813,53,allow,228,97,131,2,30,1,1
37382,80,11429,80,allow,1221,781,440,11,16,6,5
64771,53,46292,53,allow,793,101,692,2,30,1,1
49680,80,4197,80,allow,1548,847,701,10,16,5,5
56415,53,16835,53,allow,740,93,647,2,30,1,1
37244,53,37244,53,allow,172,76,96,2,30,1,1
61289,53,61289,53,allow,197,76,121,2,30,1,1
58818,443,11066,443,allow,1413,876,537,12,25,6,6
58817,443,7616,443,allow,1413,876,537,12,25,6,6
49901,53,49901,53,allow,194,87,107,2,30,1,1
59319,53,47365,53,allow,285,106,179,2,31,1,1
59247,53,59247,53,allow,825,99,726,2,31,1,1
60505,53,0,0,allow,340,90,250,2,31,1,1
55269,53,20584,53,allow,186,95,91,2,31,1,1
58279,53,58279,53,allow,847,110,737,2,31,1,1
41499,23,0,0,deny,60,60,0,1,0,1,0
61625,445,0,0,drop,70,70,0,1,0,1,0
38077,80,35599,80,allow,1484,601,883,9,44,6,3
60132,443,39833,443,allow,350,210,140,6,25,4,2
64327,53,59589,53,allow,214,102,112,2,29,1,1
64782,53,60235,53,allow,212,102,110,2,29,1,1
64160,53,55275,53,allow,258,110,148,2,30,1,1
64451,53,26294,53,allow,363,92,271,4,31,2,2
41593,53,64892,53,allow,243,86,157,2,29,1,1
64394,53,6864,53,allow,226,102,124,2,30,1,1
52002,53,64717,53,allow,289,86,203,2,30,1,1
56059,80,49532,80,allow,1151,711,440,10,15,5,5
64515,53,64413,53,allow,231,86,145,2,30,1,1
55269,53,18249,53,allow,102,102,0,1,30,1,0
56695,53,7335,53,allow,183,94,89,2,30,1,1
48542,80,42394,80,allow,811,671,140,6,32,4,2
48550,80,64861,80,allow,811,671,140,6,22,4,2
37097,80,49884,80,allow,1114,534,580,12,15,7,5
50353,443,5439,443,allow,130,70,60,3,4,2,1
49548,443,37968,443,allow,1346,918,428,10,22,6,4
65127,443,61568,443,allow,648,648,0,7,15,7,0
49725,53,18742,53,allow,211,102,109,2,29,1,1
64359,53,13819,53,allow,230,102,128,2,30,1,1
50590,53,53774,53,allow,889,404,485,10,30,5,5
65281,53,27234,53,allow,216,94,122,2,30,1,1
49642,53,3732,53,allow,302,110,192,2,30,1,1
57157,53,58237,53,allow,458,188,270,6,30,3,3
56695,53,47655,53,allow,183,94,89,2,30,1,1
64683,53,6623,53,allow,168,78,90,2,30,1,1
65129,53,16453,53,allow,324,110,214,2,30,1,1
55684,80,6722,80,allow,70,70,0,2,8,2,0
64152,53,18184,53,allow,232,110,122,2,30,1,1
55269,53,51344,53,allow,193,102,91,2,30,1,1
65080,53,46581,53,allow,741,94,647,2,30,1,1
49416,80,5310,80,allow,318,192,126,6,28,4,2
50619,80,32397,80,allow,499,192,307,6,26,4,2
57117,53,8258,53,allow,209,102,107,2,31,1,1
50051,445,0,0,drop,70,70,0,1,0,1,0
50049,445,0,0,drop,70,70,0,1,0,1,0
61612,445,0,0,drop,70,70,0,1,0,1,0
61819,445,0,0,drop,66,66,0,1,0,1,0
61609,445,0,0,drop,70,70,0,1,0,1,0
50044,445,0,0,drop,70,70,0,1,0,1,0
50036,445,0,0,drop,70,70,0,1,0,1,0
61605,445,0,0,drop,70,70,0,1,0,1,0
61603,445,0,0,drop,70,70,0,1,0,1,0
61806,445,0,0,drop,66,66,0,1,0,1,0
61803,445,0,0,drop,66,66,0,1,0,1,0
61601,445,0,0,drop,70,70,0,1,0,1,0
50026,445,0,0,drop,70,70,0,1,0,1,0
50024,445,0,0,drop,70,70,0,1,0,1,0
50021,445,0,0,drop,70,70,0,1,0,1,0
61800,445,0,0,drop,66,66,0,1,0,1,0
61594,445,0,0,drop,70,70,0,1,0,1,0
61790,445,0,0,drop,66,66,0,1,0,1,0
61784,445,0,0,drop,66,66,0,1,0,1,0
61793,445,0,0,drop,66,66,0,1,0,1,0
61788,445,0,0,drop,66,66,0,1,0,1,0
61791,445,0,0,drop,66,66,0,1,0,1,0
61786,445,0,0,drop,66,66,0,1,0,1,0
61782,445,0,0,drop,66,66,0,1,0,1,0
61592,445,0,0,drop,70,70,0,1,0,1,0
50017,445,0,0,drop,70,70,0,1,0,1,0
50013,445,0,0,drop,70,70,0,1,0,1,0
50010,445,0,0,drop,70,70,0,1,0,1,0
50009,445,0,0,drop,70,70,0,1,0,1,0
61591,445,0,0,drop,70,70,0,1,0,1,0
61590,445,0,0,drop,70,70,0,1,0,1,0
61589,445,0,0,drop,70,70,0,1,0,1,0
61583,445,0,0,drop,70,70,0,1,0,1,0
61586,445,0,0,drop,70,70,0,1,0,1,0
61571,445,0,0,drop,70,70,0,1,0,1,0
61570,445,0,0,drop,70,70,0,1,0,1,0
61566,445,0,0,drop,70,70,0,1,0,1,0
56874,67,0,0,deny,60,60,0,1,0,1,0
50006,445,0,0,drop,70,70,0,1,0,1,0
50004,445,0,0,drop,70,70,0,1,0,1,0
61561,445,0,0,drop,70,70,0,1,0,1,0
61560,445,0,0,drop,70,70,0,1,0,1,0
61777,445,0,0,drop,66,66,0,1,0,1,0
50000,445,0,0,drop,70,70,0,1,0,1,0
61773,445,0,0,drop,66,66,0,1,0,1,0
61772,445,0,0,drop,66,66,0,1,0,1,0
61770,445,0,0,drop,66,66,0,1,0,1,0
61768,445,0,0,drop,66,66,0,1,0,1,0
61549,445,0,0,drop,70,70,0,1,0,1,0
49993,445,0,0,drop,70,70,0,1,0,1,0
49988,445,0,0,drop,70,70,0,1,0,1,0
49987,445,0,0,drop,70,70,0,1,0,1,0
40095,23,0,0,deny,60,60,0,1,0,1,0
61757,445,0,0,drop,66,66,0,1,0,1,0
61545,445,0,0,drop,70,70,0,1,0,1,0
61534,445,0,0,drop,70,70,0,1,0,1,0
61533,445,0,0,drop,70,70,0,1,0,1,0
61536,445,0,0,drop,70,70,0,1,0,1,0
61750,445,0,0,drop,66,66,0,1,0,1,0
61530,445,0,0,drop,70,70,0,1,0,1,0
49974,445,0,0,drop,70,70,0,1,0,1,0
61528,445,0,0,drop,70,70,0,1,0,1,0
61747,445,0,0,drop,66,66,0,1,0,1,0
39996,23,0,0,deny,60,60,0,1,0,1,0
61739,445,0,0,drop,66,66,0,1,0,1,0
61522,445,0,0,drop,70,70,0,1,0,1,0
61735,445,0,0,drop,66,66,0,1,0,1,0
61515,445,0,0,drop,70,70,0,1,0,1,0
61512,445,0,0,drop,70,70,0,1,0,1,0
41848,23,0,0,deny,60,60,0,1,0,1,0
49964,445,0,0,drop,70,70,0,1,0,1,0
61725,445,0,0,drop,66,66,0,1,0,1,0
61723,445,0,0,drop,66,66,0,1,0,1,0
61721,445,0,0,drop,66,66,0,1,0,1,0
61719,445,0,0,drop,66,66,0,1,0,1,0
61720,445,0,0,drop,66,66,0,1,0,1,0
61718,445,0,0,drop,66,66,0,1,0,1,0
61717,445,0,0,drop,66,66,0,1,0,1,0
61508,445,0,0,drop,70,70,0,1,0,1,0
61507,445,0,0,drop,70,70,0,1,0,1,0
55406,53,15179,53,allow,768,99,669,2,30,1,1
40219,443,6179,443,allow,2387,979,1408,15,36,6,9
58281,53,0,0,allow,82,82,0,2,40,2,0
56968,53,34326,53,allow,762,97,665,2,30,1,1
50560,53,62139,53,allow,755,94,661,2,30,1,1
50859,53,0,0,allow,286,79,207,2,30,1,1
52189,53,52189,53,allow,825,99,726,2,30,1,1
50235,53,32276,53,allow,768,99,669,2,30,1,1
54630,53,54630,53,allow,825,99,726,2,30,1,1
53788,1,42504,1,allow,70,70,0,1,5,1,0
64547,53,37211,53,allow,762,97,665,2,30,1,1
58344,53,58344,53,allow,847,110,737,2,30,1,1
56571,53,30480,53,allow,749,94,655,2,31,1,1
61503,445,0,0,drop,70,70,0,1,0,1,0
49958,445,0,0,drop,70,70,0,1,0,1,0
49946,445,0,0,drop,70,70,0,1,0,1,0
49942,445,0,0,drop,70,70,0,1,0,1,0
61501,445,0,0,drop,70,70,0,1,0,1,0
61702,445,0,0,drop,66,66,0,1,0,1,0
61704,445,0,0,drop,66,66,0,1,0,1,0
61703,445,0,0,drop,66,66,0,1,0,1,0
49676,53,32954,53,allow,197,102,95,2,30,1,1
49656,53,53745,53,allow,309,118,191,2,30,1,1
49941,445,0,0,drop,70,70,0,1,0,1,0
61497,445,0,0,drop,70,70,0,1,0,1,0
49934,445,0,0,drop,70,70,0,1,0,1,0
49933,445,0,0,drop,70,70,0,1,0,1,0
49923,445,0,0,drop,70,70,0,1,0,1,0
64463,53,5557,53,allow,182,93,89,2,0,1,1
50939,443,29204,443,allow,134,60,74,3,5,2,1
49676,53,40519,53,allow,197,102,95,2,30,1,1
62724,53,2730,53,allow,195,78,117,2,29,1,1
51607,53,46424,53,allow,322,102,220,2,29,1,1
64005,53,33305,53,allow,226,102,124,2,30,1,1
64907,53,3413,53,allow,168,86,82,2,30,1,1
65244,53,58540,53,allow,378,99,279,4,45,2,2
50544,53,44871,53,allow,969,86,883,2,30,1,1
55269,53,35707,53,allow,193,102,91,2,31,1,1
64572,53,23687,53,allow,561,104,457,4,57,2,2
44173,53,9700,53,allow,168,78,90,2,30,1,1
49351,53,18900,53,allow,212,102,110,2,30,1,1
55853,53,55965,53,allow,197,102,95,2,30,1,1
55509,53,37936,53,allow,215,102,113,2,30,1,1
56432,53,38041,53,allow,195,102,93,2,30,1,1
65121,53,39585,53,allow,440,94,346,4,37,2,2
59377,53,59377,53,allow,216,98,118,2,30,1,1
55570,53,55501,53,allow,341,134,207,2,30,1,1
37058,80,51116,80,allow,1056,682,374,10,15,6,4
53792,1,64543,1,allow,70,70,0,1,4,1,0
63957,80,57502,80,allow,314,192,122,6,15,4,2
49203,53,34232,53,allow,195,102,93,2,30,1,1
49421,53,13940,53,allow,215,94,121,2,29,1,1
65379,53,2143,53,allow,126,126,0,1,29,1,0
64905,53,22894,53,allow,458,188,270,6,29,3,3
49393,443,42342,443,allow,62,62,0,1,5,1,0
49203,53,1575,53,allow,195,102,93,2,30,1,1
64711,53,31035,53,allow,273,118,155,2,30,1,1
56661,80,6258,80,allow,234,234,0,4,12,4,0
65524,53,9019,53,allow,386,122,264,4,52,2,2
64683,53,44457,53,allow,370,126,244,2,30,1,1
56199,53,59192,53,allow,227,110,117,2,30,1,1
55679,1024,62004,1024,allow,70,70,0,1,5,1,0
51547,443,55970,443,allow,642,582,60,2,5,1,1
56432,53,16819,53,allow,195,102,93,2,30,1,1
57038,53,18190,53,allow,240,86,154,2,30,1,1
49919,445,0,0,drop,70,70,0,1,0,1,0
61482,445,0,0,drop,70,70,0,1,0,1,0
61690,445,0,0,drop,66,66,0,1,0,1,0
61479,445,0,0,drop,70,70,0,1,0,1,0
49907,445,0,0,drop,70,70,0,1,0,1,0
61474,445,0,0,drop,70,70,0,1,0,1,0
61473,445,0,0,drop,70,70,0,1,0,1,0
61471,445,0,0,drop,70,70,0,1,0,1,0
61677,445,0,0,drop,66,66,0,1,0,1,0
61676,445,0,0,drop,66,66,0,1,0,1,0
49904,445,0,0,drop,70,70,0,1,0,1,0
49903,445,0,0,drop,70,70,0,1,0,1,0
49895,445,0,0,drop,70,70,0,1,0,1,0
61671,445,0,0,drop,66,66,0,1,0,1,0
61464,445,0,0,drop,70,70,0,1,0,1,0
61462,445,0,0,drop,70,70,0,1,0,1,0
50383,443,21192,443,allow,452,386,66,4,1,3,1
64649,81,0,0,deny,60,60,0,1,0,1,0
61666,445,0,0,drop,66,66,0,1,0,1,0
61665,445,0,0,drop,66,66,0,1,0,1,0
61664,445,0,0,drop,66,66,0,1,0,1,0
61661,445,0,0,drop,66,66,0,1,0,1,0
61658,445,0,0,drop,66,66,0,1,0,1,0
61655,445,0,0,drop,66,66,0,1,0,1,0
61656,445,0,0,drop,66,66,0,1,0,1,0
61461,445,0,0,drop,70,70,0,1,0,1,0
49888,445,0,0,drop,70,70,0,1,0,1,0
61460,445,0,0,drop,70,70,0,1,0,1,0
61459,445,0,0,drop,70,70,0,1,0,1,0
49881,445,0,0,drop,70,70,0,1,0,1,0
61457,445,0,0,drop,70,70,0,1,0,1,0
61455,445,0,0,drop,70,70,0,1,0,1,0
61441,445,0,0,drop,70,70,0,1,0,1,0
61440,445,0,0,drop,70,70,0,1,0,1,0
61437,445,0,0,drop,70,70,0,1,0,1,0
61431,445,0,0,drop,70,70,0,1,0,1,0
61430,445,0,0,drop,70,70,0,1,0,1,0
49875,445,0,0,drop,70,70,0,1,0,1,0
61647,445,0,0,drop,66,66,0,1,0,1,0
49872,445,0,0,drop,70,70,0,1,0,1,0
61645,445,0,0,drop,66,66,0,1,0,1,0
61644,445,0,0,drop,66,66,0,1,0,1,0
61642,445,0,0,drop,66,66,0,1,0,1,0
61640,445,0,0,drop,66,66,0,1,0,1,0
61419,445,0,0,drop,70,70,0,1,0,1,0
49867,445,0,0,drop,70,70,0,1,0,1,0
49860,445,0,0,drop,70,70,0,1,0,1,0
61415,445,0,0,drop,70,70,0,1,0,1,0
61630,445,0,0,drop,66,66,0,1,0,1,0
61405,445,0,0,drop,70,70,0,1,0,1,0
61406,445,0,0,drop,70,70,0,1,0,1,0
61404,445,0,0,drop,70,70,0,1,0,1,0
61402,445,0,0,drop,70,70,0,1,0,1,0
61399,445,0,0,drop,70,70,0,1,0,1,0
61622,445,0,0,drop,66,66,0,1,0,1,0
49847,445,0,0,drop,70,70,0,1,0,1,0
40116,23,0,0,deny,60,60,0,1,0,1,0
61619,445,0,0,drop,66,66,0,1,0,1,0
61392,445,0,0,drop,70,70,0,1,0,1,0
61613,445,0,0,drop,66,66,0,1,0,1,0
61608,445,0,0,drop,66,66,0,1,0,1,0
60112,23,0,0,deny,60,60,0,1,0,1,0
61385,445,0,0,drop,70,70,0,1,0,1,0
61383,445,0,0,drop,70,70,0,1,0,1,0
50516,53,53120,53,allow,168,86,82,2,30,1,1
40671,443,5840,443,allow,190,70,120,4,15,2,2
43131,53,0,0,allow,82,82,0,1,30,1,0
55765,53,10201,53,allow,770,101,669,2,30,1,1
55842,80,22065,80,allow,1151,711,440,10,15,5,5
56817,53,9899,53,allow,772,103,669,2,30,1,1
55510,53,10819,53,allow,578,286,292,9,15,5,4
64907,53,25739,53,allow,168,86,82,2,30,1,1
55704,53,41065,53,allow,752,93,659,2,30,1,1
57044,53,19964,53,allow,194,99,95,2,31,1,1
55176,53,63516,53,allow,190,97,93,2,31,1,1
64843,53,27388,53,allow,772,103,669,2,30,1,1
49573,53,33204,53,allow,738,86,652,2,30,1,1
50193,53,18428,53,allow,770,101,669,2,30,1,1
65342,53,53223,53,allow,760,97,663,2,30,1,1
49934,53,41301,53,allow,752,93,659,2,30,1,1
55382,53,44759,53,allow,738,86,652,2,31,1,1
49771,80,10429,80,allow,254,128,126,5,16,3,2
50912,53,50912,53,allow,213,81,132,2,30,1,1
52968,53,0,0,allow,82,82,0,1,30,1,0
49964,53,9082,53,allow,760,97,663,2,30,1,1
65071,53,11229,53,allow,93,93,0,2,60,2,0
55123,53,62052,53,allow,762,97,665,2,31,1,1
49835,445,0,0,drop,70,70,0,1,0,1,0
61379,445,0,0,drop,70,70,0,1,0,1,0
61597,445,0,0,drop,66,66,0,1,0,1,0
61596,445,0,0,drop,66,66,0,1,0,1,0
61595,445,0,0,drop,66,66,0,1,0,1,0
61593,445,0,0,drop,66,66,0,1,0,1,0
61594,445,0,0,drop,66,66,0,1,0,1,0
61592,445,0,0,drop,66,66,0,1,0,1,0
61591,445,0,0,drop,66,66,0,1,0,1,0
61589,445,0,0,drop,66,66,0,1,0,1,0
61377,445,0,0,drop,70,70,0,1,0,1,0
61373,445,0,0,drop,70,70,0,1,0,1,0
36688,443,58971,443,allow,178,118,60,2,15,1,1
50298,53,22376,53,allow,172,94,78,2,30,1,1
61372,445,0,0,drop,70,70,0,1,0,1,0
49825,445,0,0,drop,70,70,0,1,0,1,0
49822,445,0,0,drop,70,70,0,1,0,1,0
49817,445,0,0,drop,70,70,0,1,0,1,0
49814,445,0,0,drop,70,70,0,1,0,1,0
61576,445,0,0,drop,66,66,0,1,0,1,0
61575,445,0,0,drop,66,66,0,1,0,1,0
61574,445,0,0,drop,66,66,0,1,0,1,0
61367,445,0,0,drop,70,70,0,1,0,1,0
65405,53,50341,53,allow,560,104,456,4,43,2,2
54993,53,49299,53,allow,410,109,301,4,32,2,2
63961,53,2242,53,allow,373,171,202,5,40,3,2
57044,53,35114,53,allow,197,102,95,2,30,1,1
55176,53,23619,53,allow,195,102,93,2,30,1,1
52489,53,54304,53,allow,302,78,224,2,29,1,1
64907,53,65054,53,allow,168,86,82,2,29,1,1
55853,53,20879,53,allow,197,102,95,2,29,1,1
65404,53,11597,53,allow,182,94,88,2,30,1,1
64926,53,45252,53,allow,257,102,155,2,30,1,1
40290,22,40290,22,allow,66,66,0,1,5,1,0
55836,443,63316,443,allow,320,140,180,6,15,3,3
55239,53,38143,53,allow,272,94,178,2,30,1,1
54287,443,13671,443,allow,122,62,60,2,15,1,1
65024,53,6765,53,allow,199,102,97,2,30,1,1
55834,443,1790,443,allow,190,70,120,4,15,2,2
49742,53,64876,53,allow,223,102,121,2,30,1,1
57326,53,9216,53,allow,180,94,86,2,35,1,1
64684,53,7467,53,allow,757,102,655,2,30,1,1
64555,53,23004,53,allow,297,102,195,4,48,2,2
64649,53,32892,53,allow,807,94,713,2,30,1,1
46279,443,60019,443,allow,172,172,0,2,5,2,0
55865,53,34168,53,allow,807,94,713,2,30,1,1
50516,53,58230,53,allow,168,86,82,2,30,1,1
49614,53,6383,53,allow,183,94,89,2,30,1,1
49894,80,26822,80,allow,1409,735,674,12,17,5,7
65460,53,50952,53,allow,215,102,113,2,29,1,1
55012,53,50167,53,allow,275,110,165,2,30,1,1
65440,53,38806,53,allow,240,86,154,2,29,1,1
55865,53,22117,53,allow,184,94,90,2,30,1,1
50298,53,38554,53,allow,164,86,78,2,30,1,1
65024,53,19328,53,allow,199,102,97,2,30,1,1
65286,53,17051,53,allow,756,94,662,2,30,1,1
49420,53,26234,53,allow,364,102,262,2,30,1,1
59044,53,47816,53,allow,78,78,0,1,30,1,0
65404,53,9178,53,allow,198,110,88,2,30,1,1
55057,443,7517,443,allow,1364,940,424,12,16,7,5
65101,53,44970,53,allow,749,94,655,2,30,1,1
64649,53,56977,53,allow,184,94,90,2,30,1,1
49867,53,28958,53,allow,232,110,122,2,30,1,1
55176,53,57165,53,allow,195,102,93,2,30,1,1
56724,53,27864,53,allow,182,94,88,2,30,1,1
49534,53,11716,53,allow,193,102,91,2,31,1,1
65432,53,2736,53,allow,254,94,160,2,30,1,1
57044,53,24810,53,allow,197,102,95,2,30,1,1
64102,53,54377,53,allow,619,102,517,4,43,2,2
50077,53,56181,53,allow,261,97,164,4,44,2,2
50077,53,51701,53,allow,261,97,164,4,44,2,2
55993,53,52586,53,allow,199,102,97,2,30,1,1
50596,53,57766,53,allow,168,86,82,2,30,1,1
57136,53,36933,53,allow,209,110,99,2,31,1,1
56055,53,2822,53,allow,168,86,82,2,31,1,1
64769,53,55242,53,allow,418,150,268,2,30,1,1
49812,445,0,0,drop,70,70,0,1,0,1,0
49806,445,0,0,drop,70,70,0,1,0,1,0
49807,445,0,0,deny,70,70,0,1,0,1,0
49805,445,0,0,drop,70,70,0,1,0,1,0
61354,445,0,0,drop,70,70,0,1,0,1,0
37014,23,0,0,deny,60,60,0,1,0,1,0
49795,445,0,0,drop,70,70,0,1,0,1,0
49792,445,0,0,drop,70,70,0,1,0,1,0
49789,445,0,0,drop,70,70,0,1,0,1,0
61351,445,0,0,drop,70,70,0,1,0,1,0
61563,445,0,0,drop,66,66,0,1,0,1,0
61346,445,0,0,drop,70,70,0,1,0,1,0
61345,445,0,0,drop,70,70,0,1,0,1,0
49787,445,0,0,drop,70,70,0,1,0,1,0
49779,445,0,0,drop,70,70,0,1,0,1,0
61343,445,0,0,drop,70,70,0,1,0,1,0
50371,443,40015,443,allow,456,390,66,4,0,3,1
50372,443,12434,443,allow,456,390,66,4,0,3,1
61549,445,0,0,drop,66,66,0,1,0,1,0
61546,445,0,0,drop,66,66,0,1,0,1,0
49773,445,0,0,drop,70,70,0,1,0,1,0
49767,445,0,0,drop,70,70,0,1,0,1,0
49766,445,0,0,drop,70,70,0,1,0,1,0
61336,445,0,0,drop,70,70,0,1,0,1,0
61334,445,0,0,drop,70,70,0,1,0,1,0
61544,445,0,0,drop,66,66,0,1,0,1,0
61333,445,0,0,drop,70,70,0,1,0,1,0
61536,445,0,0,drop,66,66,0,1,0,1,0
61532,445,0,0,drop,66,66,0,1,0,1,0
61537,445,0,0,drop,66,66,0,1,0,1,0
61530,445,0,0,drop,66,66,0,1,0,1,0
61538,445,0,0,drop,66,66,0,1,0,1,0
61535,445,0,0,drop,66,66,0,1,0,1,0
61528,445,0,0,drop,66,66,0,1,0,1,0
61332,445,0,0,drop,70,70,0,1,0,1,0
61331,445,0,0,drop,70,70,0,1,0,1,0
61329,445,0,0,drop,70,70,0,1,0,1,0
61326,445,0,0,deny,70,70,0,1,0,1,0
49757,445,0,0,drop,70,70,0,1,0,1,0
49756,445,0,0,drop,70,70,0,1,0,1,0
61313,445,0,0,drop,70,70,0,1,0,1,0
61312,445,0,0,drop,70,70,0,1,0,1,0
61306,445,0,0,drop,70,70,0,1,0,1,0
61302,445,0,0,drop,70,70,0,1,0,1,0
61303,445,0,0,drop,70,70,0,1,0,1,0
49750,445,0,0,drop,70,70,0,1,0,1,0
49747,445,0,0,drop,70,70,0,1,0,1,0
61522,445,0,0,drop,66,66,0,1,0,1,0
49744,445,0,0,drop,70,70,0,1,0,1,0
61518,445,0,0,drop,66,66,0,1,0,1,0
61516,445,0,0,drop,66,66,0,1,0,1,0
61515,445,0,0,drop,66,66,0,1,0,1,0
61291,445,0,0,drop,70,70,0,1,0,1,0
61513,445,0,0,drop,66,66,0,1,0,1,0
49736,445,0,0,drop,70,70,0,1,0,1,0
49726,445,0,0,drop,70,70,0,1,0,1,0
61287,445,0,0,drop,70,70,0,1,0,1,0
61502,445,0,0,drop,66,66,0,1,0,1,0
61278,445,0,0,drop,70,70,0,1,0,1,0
61275,445,0,0,drop,70,70,0,1,0,1,0
61277,445,0,0,drop,70,70,0,1,0,1,0
61273,445,0,0,drop,70,70,0,1,0,1,0
61270,445,0,0,drop,70,70,0,1,0,1,0
61494,445,0,0,drop,66,66,0,1,0,1,0
62067,80,14393,80,allow,1862,616,1246,11,15,6,5
57331,53,13149,53,allow,1420,95,1325,4,32,2,2
65184,53,54868,53,allow,164,84,80,2,31,1,1
54587,53,0,0,allow,82,82,0,1,30,1,0
56500,53,18802,53,allow,775,103,672,2,31,1,1
57136,53,51914,53,allow,202,103,99,2,31,1,1
56055,53,24959,53,allow,168,86,82,2,30,1,1
55830,53,60660,53,allow,182,93,89,2,31,1,1
56590,53,27360,53,allow,760,97,663,2,30,1,1
56360,53,50871,53,allow,814,110,704,2,30,1,1
50542,53,19780,53,allow,762,98,664,2,30,1,1
55076,53,44619,53,allow,760,97,663,2,30,1,1
50467,53,38713,53,allow,758,93,665,2,31,1,1
49898,53,38099,53,allow,184,94,90,2,31,1,1
50584,53,23534,53,allow,744,89,655,2,31,1,1
55261,53,40486,53,allow,716,95,621,2,31,1,1
49534,53,33345,53,allow,186,95,91,2,31,1,1
55200,53,19804,53,allow,202,103,99,2,31,1,1
56697,53,31729,53,allow,196,100,96,2,31,1,1
55362,53,13886,53,allow,190,97,93,2,31,1,1
55831,53,12169,53,allow,182,93,89,2,31,1,1
50219,53,44100,53,allow,751,95,656,2,31,1,1
61491,445,0,0,drop,66,66,0,1,0,1,0
61265,445,0,0,drop,70,70,0,1,0,1,0
61485,445,0,0,drop,66,66,0,1,0,1,0
61475,445,0,0,drop,66,66,0,1,0,1,0
61257,445,0,0,drop,70,70,0,1,0,1,0
49296,80,39063,80,allow,1515,481,1034,11,15,6,5
56724,53,33113,53,allow,182,94,88,2,29,1,1
49677,53,61420,53,allow,373,126,247,2,29,1,1
50378,53,9266,53,allow,199,102,97,2,29,1,1
55993,53,8187,53,allow,199,102,97,2,29,1,1
63139,53,8265,53,allow,78,78,0,2,31,2,0
50596,53,52895,53,allow,168,86,82,2,29,1,1
45852,53,16051,53,allow,774,76,698,4,29,2,2
37093,53,37093,53,allow,645,90,555,2,29,1,1
50378,53,11083,53,allow,199,102,97,2,29,1,1
50378,53,26291,53,allow,199,102,97,2,29,1,1
65504,53,13937,53,allow,216,94,122,2,30,1,1
55176,53,60647,53,allow,195,102,93,2,30,1,1
56961,53,64914,53,allow,757,102,655,2,30,1,1
51453,80,39611,80,allow,214,140,74,4,15,3,1
50100,53,44319,53,allow,216,110,106,2,30,1,1
50386,53,42277,53,allow,782,110,672,2,30,1,1
64548,53,58347,53,allow,209,110,99,2,30,1,1
49317,53,61782,53,allow,194,102,92,2,30,1,1
54998,53,51168,53,allow,195,102,93,2,30,1,1
64827,53,50756,53,allow,291,86,205,2,30,1,1
38799,53,0,0,allow,86,86,0,1,30,1,0
38101,443,38674,443,allow,190,70,120,4,15,2,2
55107,53,60503,53,allow,816,102,714,2,30,1,1
62480,443,56428,443,allow,1326,876,450,11,26,6,5
64126,53,37940,53,allow,216,102,114,2,30,1,1
56456,53,45669,53,allow,199,102,97,2,30,1,1
55380,53,60904,53,allow,289,97,192,4,45,2,2
56456,53,39368,53,allow,199,102,97,2,30,1,1
55830,53,64690,53,allow,183,94,89,2,30,1,1
55715,53,57381,53,allow,168,86,82,2,30,1,1
50028,53,64249,53,allow,256,102,154,2,30,1,1
57435,53,43686,53,allow,184,102,82,2,30,1,1
56799,80,63768,80,allow,1514,481,1033,11,15,6,5
49199,53,25125,53,allow,193,102,91,2,30,1,1
49199,53,34176,53,allow,816,102,714,2,30,1,1
49678,80,44529,80,allow,1977,921,1056,9,15,5,4
64387,53,16161,53,allow,359,99,260,4,54,2,2
57340,53,29949,53,allow,216,110,106,2,30,1,1
65300,53,36602,53,allow,758,102,656,2,30,1,1
57340,53,7589,53,allow,216,110,106,2,30,1,1
57893,80,44001,80,allow,318,192,126,6,26,4,2
49772,80,38817,80,allow,70,70,0,1,5,1,0
55285,53,16025,53,allow,268,95,173,4,47,2,2
58872,443,3820,443,allow,1178,820,358,9,15,6,3
56660,80,51147,80,allow,234,234,0,4,12,4,0
55285,53,18984,53,allow,268,95,173,4,46,2,2
64589,53,62557,53,allow,814,110,704,2,29,1,1
64882,53,62094,53,allow,343,134,209,2,30,1,1
56357,53,8894,53,allow,168,86,82,2,30,1,1
39422,80,48610,80,allow,1057,683,374,10,15,6,4
64774,53,37147,53,allow,214,102,112,2,29,1,1
49614,53,48973,53,allow,183,94,89,2,29,1,1
56372,53,7936,53,allow,172,94,78,2,30,1,1
56456,53,58146,53,allow,199,102,97,2,30,1,1
65234,53,55204,53,allow,248,110,138,2,29,1,1
62749,53,25858,53,allow,184,86,98,2,30,1,1
56372,53,63368,53,allow,172,94,78,2,29,1,1
49283,53,8368,53,allow,251,102,149,2,30,1,1
39869,53,19258,53,allow,394,80,314,4,29,2,2
50100,53,47683,53,allow,216,110,106,2,30,1,1
56357,53,62096,53,allow,168,86,82,2,30,1,1
55651,53,17505,53,allow,199,102,97,2,30,1,1
65431,53,63045,53,allow,210,102,108,2,30,1,1
57044,53,35705,53,allow,197,102,95,2,30,1,1
64991,53,4692,53,allow,779,86,693,2,30,1,1
50450,53,9173,53,allow,209,110,99,2,30,1,1
60582,53,13685,53,allow,180,86,94,2,30,1,1
38086,53,54095,53,allow,199,94,105,2,30,1,1
49568,53,32071,53,allow,168,86,82,2,31,1,1
57340,53,2776,53,allow,216,110,106,2,30,1,1
50450,53,51972,53,allow,209,110,99,2,30,1,1
51867,53,1821,53,allow,179,86,93,2,30,1,1
65184,53,13116,53,allow,166,86,80,2,30,1,1
56738,53,38791,53,allow,821,102,719,2,30,1,1
49543,53,52836,53,allow,200,102,98,2,30,1,1
56738,53,58828,53,allow,198,102,96,2,30,1,1
65152,53,32824,53,allow,167,86,81,2,31,1,1
64957,53,41435,53,allow,506,131,375,4,41,2,2
65309,53,6020,53,allow,227,110,117,2,30,1,1
57435,53,39763,53,allow,184,102,82,2,30,1,1
50011,53,7545,53,allow,766,102,664,2,30,1,1
50137,53,54059,53,allow,183,94,89,2,31,1,1
49677,80,37951,80,allow,1977,921,1056,9,16,5,4
57136,53,22982,53,allow,209,110,99,2,30,1,1
56626,53,17271,53,allow,224,102,122,2,30,1,1
57054,53,38199,53,allow,164,78,86,2,30,1,1
55107,53,32486,53,allow,193,102,91,2,30,1,1
39888,53,65133,53,allow,168,78,90,2,30,1,1
50630,53,64139,53,allow,209,110,99,2,30,1,1
65515,53,15950,53,allow,652,209,443,6,50,3,3
50100,53,23176,53,allow,216,110,106,2,30,1,1
65193,53,19280,53,allow,436,94,342,2,30,1,1
49898,53,31342,53,allow,184,94,90,2,30,1,1
56365,53,8027,53,allow,199,102,97,2,30,1,1
55830,53,46828,53,allow,183,94,89,2,30,1,1
56365,53,14208,53,allow,199,102,97,2,30,1,1
49898,53,13665,53,allow,184,94,90,2,30,1,1
55849,53,18869,53,allow,195,102,93,2,31,1,1
65112,53,1739,53,allow,209,110,99,2,31,1,1
56934,53,48178,53,allow,216,110,106,2,31,1,1
65219,53,52496,53,allow,197,102,95,2,31,1,1
49326,53,56279,53,allow,765,102,663,2,30,1,1
53258,53,63456,53,allow,277,78,199,2,30,1,1
59802,53,61597,53,allow,168,78,90,2,30,1,1
50418,53,14403,53,allow,177,94,83,2,30,1,1
61255,445,0,0,drop,70,70,0,1,0,1,0
61250,445,0,0,drop,70,70,0,1,0,1,0
61248,445,0,0,drop,70,70,0,1,0,1,0
49705,445,0,0,drop,70,70,0,1,0,1,0
61463,445,0,0,drop,66,66,0,1,0,1,0
61469,445,0,0,drop,66,66,0,1,0,1,0
61462,445,0,0,drop,66,66,0,1,0,1,0
61467,445,0,0,drop,66,66,0,1,0,1,0
61464,445,0,0,drop,66,66,0,1,0,1,0
61465,445,0,0,drop,66,66,0,1,0,1,0
61468,445,0,0,drop,66,66,0,1,0,1,0
61244,445,0,0,drop,70,70,0,1,0,1,0
61243,445,0,0,drop,70,70,0,1,0,1,0
49700,445,0,0,drop,70,70,0,1,0,1,0
49695,445,0,0,drop,70,70,0,1,0,1,0
49688,445,0,0,drop,70,70,0,1,0,1,0
61448,445,0,0,drop,66,66,0,1,0,1,0
61449,445,0,0,drop,66,66,0,1,0,1,0
61447,445,0,0,drop,66,66,0,1,0,1,0
61238,445,0,0,drop,70,70,0,1,0,1,0
49685,445,0,0,drop,70,70,0,1,0,1,0
49677,445,0,0,drop,70,70,0,1,0,1,0
49674,445,0,0,drop,70,70,0,1,0,1,0
61225,445,0,0,drop,70,70,0,1,0,1,0
61222,445,0,0,drop,70,70,0,1,0,1,0
49664,445,0,0,drop,70,70,0,1,0,1,0
53100,443,19603,443,allow,472,406,66,4,0,3,1
49663,445,0,0,drop,70,70,0,1,0,1,0
49661,445,0,0,drop,70,70,0,1,0,1,0
61435,445,0,0,drop,66,66,0,1,0,1,0
61218,445,0,0,drop,70,70,0,1,0,1,0
61216,445,0,0,drop,70,70,0,1,0,1,0
61214,445,0,0,drop,70,70,0,1,0,1,0
49657,445,0,0,drop,70,70,0,1,0,1,0
49651,445,0,0,drop,70,70,0,1,0,1,0
61420,445,0,0,drop,66,66,0,1,0,1,0
61419,445,0,0,drop,66,66,0,1,0,1,0
61207,445,0,0,drop,70,70,0,1,0,1,0
49644,445,0,0,drop,70,70,0,1,0,1,0
49643,445,0,0,drop,70,70,0,1,0,1,0
61205,445,0,0,drop,70,70,0,1,0,1,0
61415,445,0,0,drop,66,66,0,1,0,1,0
61204,445,0,0,drop,70,70,0,1,0,1,0
61203,445,0,0,drop,70,70,0,1,0,1,0
61202,445,0,0,drop,70,70,0,1,0,1,0
61200,445,0,0,drop,70,70,0,1,0,1,0
61197,445,0,0,drop,70,70,0,1,0,1,0
61403,445,0,0,drop,66,66,0,1,0,1,0
61402,445,0,0,drop,66,66,0,1,0,1,0
61410,445,0,0,drop,66,66,0,1,0,1,0
61408,445,0,0,drop,66,66,0,1,0,1,0
61399,445,0,0,drop,66,66,0,1,0,1,0
61405,445,0,0,drop,66,66,0,1,0,1,0
61398,445,0,0,drop,66,66,0,1,0,1,0
49632,445,0,0,drop,70,70,0,1,0,1,0
49628,445,0,0,drop,70,70,0,1,0,1,0
61184,445,0,0,drop,70,70,0,1,0,1,0
61183,445,0,0,drop,70,70,0,1,0,1,0
61181,445,0,0,drop,70,70,0,1,0,1,0
61174,445,0,0,drop,70,70,0,1,0,1,0
61173,445,0,0,drop,70,70,0,1,0,1,0
49624,445,0,0,drop,70,70,0,1,0,1,0
49622,445,0,0,drop,70,70,0,1,0,1,0
61394,445,0,0,drop,66,66,0,1,0,1,0
49616,445,0,0,drop,70,70,0,1,0,1,0
61389,445,0,0,drop,66,66,0,1,0,1,0
61162,445,0,0,drop,70,70,0,1,0,1,0
61388,445,0,0,drop,66,66,0,1,0,1,0
61386,445,0,0,drop,66,66,0,1,0,1,0
61385,445,0,0,drop,66,66,0,1,0,1,0
49608,445,0,0,deny,70,70,0,1,0,1,0
61158,445,0,0,drop,70,70,0,1,0,1,0
49605,445,0,0,drop,70,70,0,1,0,1,0
49604,445,0,0,drop,70,70,0,1,0,1,0
61148,445,0,0,drop,70,70,0,1,0,1,0
61147,445,0,0,drop,70,70,0,1,0,1,0
50158,53,45524,53,allow,758,96,662,2,30,1,1
50601,53,58017,53,allow,760,97,663,2,30,1,1
49631,80,18406,80,allow,1446,914,532,8,16,5,3
50589,53,50328,53,allow,733,85,648,2,30,1,1
64823,53,49719,53,allow,754,94,660,2,30,1,1
56006,53,14148,53,allow,200,102,98,2,30,1,1
50602,53,48380,53,allow,761,100,661,2,30,1,1
50152,53,50662,53,allow,776,102,674,2,30,1,1
39575,53,26625,53,allow,198,93,105,2,30,1,1
49654,80,62671,80,allow,1506,914,592,9,16,5,4
55380,53,27233,53,allow,289,97,192,4,45,2,2
49989,53,14607,53,allow,778,103,675,2,30,1,1
39251,53,9429,53,allow,198,93,105,2,30,1,1
56365,53,1142,53,allow,198,101,97,2,30,1,1
56068,53,2215,53,allow,752,93,659,2,30,1,1
50135,53,57045,53,allow,774,101,673,2,30,1,1
56934,53,42274,53,allow,216,110,106,2,31,1,1
49429,53,29436,53,allow,188,96,92,2,31,1,1
55849,53,21168,53,allow,190,97,93,2,31,1,1
50803,443,40558,443,allow,1590,1038,552,12,48,6,6
65219,53,39844,53,allow,410,99,311,4,56,2,2
55651,53,31474,53,allow,198,101,97,2,30,1,1
57066,53,53308,53,allow,778,103,675,2,30,1,1
55185,53,27754,53,allow,758,93,665,2,30,1,1
56795,53,37529,53,allow,776,102,674,2,30,1,1
64729,53,52284,53,allow,770,102,668,2,30,1,1
55715,53,53520,53,allow,168,86,82,2,30,1,1
55791,53,26721,53,allow,770,101,669,2,30,1,1
57423,53,20278,53,allow,774,101,673,2,30,1,1
50426,53,23864,53,allow,760,97,663,2,30,1,1
56500,53,34519,53,allow,198,101,97,2,31,1,1
57025,53,3380,53,allow,168,86,82,2,31,1,1
65313,53,63714,53,allow,164,84,80,2,31,1,1
64959,53,59416,53,allow,202,103,99,2,31,1,1
57157,53,17035,53,allow,755,94,661,2,31,1,1
56290,53,40983,53,allow,716,95,621,2,31,1,1
55439,53,12410,53,allow,738,86,652,2,30,1,1
55390,53,32407,53,allow,778,103,675,2,31,1,1
64687,53,62553,53,allow,182,93,89,2,31,1,1
49593,53,21447,53,allow,762,98,664,2,31,1,1
56804,53,22833,53,allow,760,96,664,2,31,1,1
55443,53,31894,53,allow,751,95,656,2,31,1,1
65112,53,30397,53,allow,202,103,99,2,31,1,1
64054,53,42745,53,allow,182,93,89,2,31,1,1
56664,53,62279,53,allow,774,101,673,2,31,1,1
55262,53,28090,53,allow,762,98,664,2,31,1,1
64330,53,32772,53,allow,186,95,91,2,31,1,1
56544,53,62437,53,allow,760,97,663,2,31,1,1
56245,53,57808,53,allow,200,102,98,2,31,1,1
56624,53,13351,53,allow,198,101,97,2,31,1,1
61146,445,0,0,drop,70,70,0,1,0,1,0
61145,445,0,0,drop,70,70,0,1,0,1,0
61373,445,0,0,drop,66,66,0,1,0,1,0
61142,445,0,0,drop,70,70,0,1,0,1,0
55831,53,65358,53,allow,183,94,89,2,30,1,1
65311,53,5309,53,allow,198,94,104,2,30,1,1
64959,53,9017,53,allow,209,110,99,2,30,1,1
46271,443,30209,443,allow,70,70,0,2,4,2,0
49461,53,38932,53,allow,198,102,96,2,29,1,1
49568,53,53479,53,allow,184,102,82,2,29,1,1
56697,53,16898,53,allow,198,102,96,2,29,1,1
49543,53,5363,53,allow,200,102,98,2,30,1,1
65313,53,62981,53,allow,166,86,80,2,30,1,1
55380,53,32660,53,allow,289,97,192,4,44,2,2
55050,443,54563,443,allow,126,60,66,3,5,2,1
55651,53,8251,53,allow,199,102,97,2,29,1,1
65219,53,31087,53,allow,197,102,95,2,29,1,1
56934,53,16279,53,allow,216,110,106,2,29,1,1
49534,53,40703,53,allow,193,102,91,2,29,1,1
49461,53,21062,53,allow,821,102,719,2,29,1,1
56474,53,60230,53,allow,209,110,99,2,29,1,1
55715,53,19164,53,allow,168,86,82,2,29,1,1
49403,53,28281,53,allow,228,102,126,2,29,1,1
57136,53,60175,53,allow,209,110,99,2,29,1,1
50630,53,12018,53,allow,209,110,99,2,29,1,1
49429,53,2752,53,allow,194,102,92,2,30,1,1
55200,53,14143,53,allow,209,110,99,2,30,1,1
37048,53,15129,53,allow,168,78,90,2,29,1,1
50418,53,58072,53,allow,185,102,83,2,30,1,1
60290,53,25533,53,allow,199,94,105,2,29,1,1
42300,53,40798,53,allow,168,78,90,2,29,1,1
54998,53,32757,53,allow,195,102,93,2,29,1,1
58767,53,1096,53,allow,168,78,90,2,29,1,1
65245,53,50630,53,allow,193,102,91,2,30,1,1
55715,53,18469,53,allow,168,86,82,2,30,1,1
65116,53,63151,53,allow,214,110,104,2,30,1,1
56459,53,30479,53,allow,209,110,99,2,30,1,1
56673,53,38951,53,allow,183,94,89,2,30,1,1
49814,53,14666,53,allow,189,102,87,2,30,1,1
55200,53,50421,53,allow,209,110,99,2,30,1,1
55712,53,64759,53,allow,164,86,78,2,30,1,1
65323,53,29690,53,allow,816,102,714,2,30,1,1
65116,53,4360,53,allow,214,110,104,2,30,1,1
55380,53,36013,53,allow,289,97,192,4,45,2,2
49814,53,29277,53,allow,181,94,87,2,30,1,1
65152,53,13983,53,allow,167,86,81,2,30,1,1
53864,443,51683,443,allow,232,172,60,3,5,2,1
65449,53,42820,53,allow,723,102,621,2,30,1,1
55830,53,32937,53,allow,183,94,89,2,30,1,1
55651,53,20940,53,allow,199,102,97,2,30,1,1
65057,53,5504,53,allow,199,102,97,2,30,1,1
55262,53,4967,53,allow,193,102,91,2,30,1,1
64905,53,62456,53,allow,283,102,181,2,30,1,1
56273,53,10176,53,allow,200,102,98,2,30,1,1
56006,53,56453,53,allow,200,102,98,2,30,1,1
55932,53,42862,53,allow,193,102,91,2,30,1,1
56365,53,6321,53,allow,199,102,97,2,30,1,1
62415,53,36183,53,allow,86,86,0,1,30,1,0
65245,53,59048,53,allow,193,102,91,2,30,1,1
49429,53,55360,53,allow,194,102,92,2,30,1,1
55169,53,40051,53,allow,199,102,97,2,30,1,1
63084,53,54059,53,allow,86,86,0,1,30,1,0
50614,80,59659,80,allow,318,192,126,6,25,4,2
64338,53,13922,53,allow,298,102,196,4,43,2,2
64544,53,63880,53,allow,199,94,105,2,30,1,1
50161,53,38218,53,allow,165,86,79,2,30,1,1
64537,53,37078,53,allow,168,86,82,2,30,1,1
64959,53,12491,53,allow,209,110,99,2,30,1,1
53394,53,24735,53,allow,86,86,0,1,30,1,0
57203,53,26707,53,allow,199,102,97,2,30,1,1
45458,80,54981,80,allow,138,78,60,2,5,1,1
51037,80,32981,80,allow,134,60,74,3,4,2,1
65060,53,21160,53,allow,324,97,227,4,52,2,2
39224,53,62138,53,allow,168,78,90,2,29,1,1
56474,53,9698,53,allow,209,110,99,2,29,1,1
64943,53,17729,53,allow,341,110,231,2,29,1,1
48458,53,36064,53,allow,289,86,203,2,29,1,1
55362,53,21893,53,allow,195,102,93,2,29,1,1
49317,53,28300,53,allow,194,102,92,2,29,1,1
50137,53,58176,53,allow,183,94,89,2,29,1,1
57838,53,1470,53,allow,70,70,0,1,29,1,0
60548,53,24812,53,allow,199,94,105,2,29,1,1
56273,53,30021,53,allow,200,102,98,2,30,1,1
58536,53,15925,53,allow,177,86,91,2,30,1,1
55362,53,39798,53,allow,195,102,93,2,30,1,1
50558,53,44600,53,allow,733,94,639,2,30,1,1
64595,53,8174,53,allow,305,94,211,4,60,2,2
56697,53,1249,53,allow,198,102,96,2,30,1,1
49885,53,38127,53,allow,377,94,283,2,30,1,1
55169,53,58327,53,allow,199,102,97,2,30,1,1
50151,53,17420,53,allow,152,78,74,2,30,1,1
50151,53,44129,53,allow,168,94,74,2,30,1,1
56492,53,1811,53,allow,94,94,0,1,30,1,0
55831,53,9463,53,allow,183,94,89,2,30,1,1
57025,53,16250,53,allow,168,86,82,2,30,1,1
64519,53,39794,53,allow,277,94,183,4,60,2,2
65313,53,7915,53,allow,166,86,80,2,30,1,1
49898,53,22442,53,allow,184,94,90,2,30,1,1
55752,53,44697,53,allow,200,102,98,2,30,1,1
64723,53,38339,53,allow,165,86,79,2,30,1,1
55752,53,6985,53,allow,200,102,98,2,30,1,1
64575,53,5183,53,allow,182,102,80,2,31,1,1
65019,53,29209,53,allow,195,102,93,2,31,1,1
49416,53,31346,53,allow,177,94,83,2,31,1,1
56934,53,21277,53,allow,216,110,106,2,31,1,1
65219,53,20854,53,allow,197,102,95,2,31,1,1
56500,53,23471,53,allow,199,102,97,2,30,1,1
55170,53,27773,53,allow,250,94,156,2,30,1,1
57258,53,22772,53,allow,821,102,719,2,30,1,1
55200,53,19754,53,allow,209,110,99,2,30,1,1
65057,53,53489,53,allow,199,102,97,2,30,1,1
49689,53,60193,53,allow,812,110,702,2,30,1,1
55262,53,22053,53,allow,193,102,91,2,30,1,1
64261,53,48738,53,allow,295,110,185,2,30,1,1
65101,53,61768,53,allow,402,118,284,2,30,1,1
58101,53,38765,53,allow,86,86,0,1,30,1,0
64054,53,33800,53,allow,183,94,89,2,31,1,1
64513,53,5790,53,allow,336,93,243,4,33,2,2
56673,53,13282,53,allow,183,94,89,2,30,1,1
49173,53,27694,53,allow,214,110,104,2,30,1,1
65112,53,26607,53,allow,209,110,99,2,30,1,1
49610,53,38769,53,allow,754,94,660,2,30,1,1
49227,53,61588,53,allow,179,94,85,2,30,1,1
42341,443,25797,443,allow,276,70,206,5,26,2,3
56459,53,20811,53,allow,209,110,99,2,30,1,1
50100,53,17377,53,allow,734,94,640,2,30,1,1
56006,53,30347,53,allow,200,102,98,2,30,1,1
64440,53,9584,53,allow,270,110,160,2,30,1,1
50161,53,40110,53,allow,173,94,79,2,30,1,1
49687,53,40743,53,allow,184,102,82,2,30,1,1
65323,53,20486,53,allow,193,102,91,2,30,1,1
64586,53,21236,53,allow,173,94,79,2,30,1,1
57190,53,17320,53,allow,757,102,655,2,30,1,1
48864,123,32657,123,allow,184,94,90,2,30,1,1
56500,53,60506,53,allow,199,102,97,2,30,1,1
49687,53,9331,53,allow,184,102,82,2,30,1,1
55831,53,4843,53,allow,183,94,89,2,30,1,1
56447,53,39784,53,allow,403,110,293,2,30,1,1
64959,53,12342,53,allow,209,110,99,2,30,1,1
64330,53,5975,53,allow,193,102,91,2,30,1,1
64054,53,34990,53,allow,183,94,89,2,30,1,1
64586,53,2228,53,allow,173,94,79,2,30,1,1
49365,53,34232,53,allow,199,94,105,2,31,1,1
57258,53,32914,53,allow,198,102,96,2,30,1,1
56170,53,19497,53,allow,198,102,96,2,30,1,1
56787,53,40108,53,allow,209,110,99,2,30,1,1
56328,53,20002,53,allow,214,102,112,2,31,1,1
65328,53,29572,53,allow,182,102,80,2,31,1,1
49163,53,27365,53,allow,167,86,81,2,31,1,1
46531,53,8725,53,allow,209,86,123,2,30,1,1
55849,53,54594,53,allow,195,102,93,2,30,1,1
57647,53,15724,53,allow,265,78,187,2,30,1,1
56697,53,34605,53,allow,198,102,96,2,30,1,1
65384,53,4009,53,allow,443,182,261,6,30,3,3
64519,53,52190,53,allow,184,94,90,2,30,1,1
49416,53,16616,53,allow,185,102,83,2,30,1,1
49163,53,4379,53,allow,167,86,81,2,30,1,1
56787,53,13426,53,allow,209,110,99,2,30,1,1
65398,53,64225,53,allow,214,110,104,2,30,1,1
49503,53,8833,53,allow,167,86,81,2,30,1,1
55371,53,41494,53,allow,168,86,82,2,30,1,1
64723,53,29424,53,allow,165,86,79,2,31,1,1
49218,53,12399,53,allow,195,102,93,2,31,1,1
49722,53,40518,53,allow,200,102,98,2,31,1,1
49227,53,18246,53,allow,179,94,85,2,31,1,1
64316,53,46275,53,allow,184,94,90,2,31,1,1
65112,53,6227,53,allow,209,110,99,2,31,1,1
55070,53,47871,53,allow,195,102,93,2,31,1,1
54342,80,39601,80,allow,1515,481,1034,11,16,6,5
56006,53,22097,53,allow,200,102,98,2,30,1,1
56695,53,2838,53,allow,183,94,89,2,30,1,1
55362,53,23060,53,allow,374,97,277,4,32,2,2
64614,53,5990,53,allow,517,179,338,6,62,3,3
56492,53,62080,53,allow,184,94,90,2,30,1,1
56500,53,41129,53,allow,199,102,97,2,30,1,1
56170,53,52947,53,allow,198,102,96,2,31,1,1
65366,53,44706,53,allow,458,188,270,6,31,3,3
49667,53,30486,53,allow,759,102,657,2,31,1,1
64330,53,52470,53,allow,193,102,91,2,31,1,1
50278,53,13442,53,allow,196,102,94,2,31,1,1
61366,445,0,0,drop,66,66,0,1,0,1,0
61135,445,0,0,drop,70,70,0,1,0,1,0
61363,445,0,0,drop,66,66,0,1,0,1,0
61355,445,0,0,drop,66,66,0,1,0,1,0
61128,445,0,0,drop,70,70,0,1,0,1,0
61127,445,0,0,drop,70,70,0,1,0,1,0
61349,445,0,0,drop,66,66,0,1,0,1,0
61122,445,0,0,drop,70,70,0,1,0,1,0
61120,445,0,0,drop,70,70,0,1,0,1,0
49578,445,0,0,drop,70,70,0,1,0,1,0
61334,445,0,0,drop,66,66,0,1,0,1,0
61340,445,0,0,drop,66,66,0,1,0,1,0
61341,445,0,0,drop,66,66,0,1,0,1,0
61337,445,0,0,drop,66,66,0,1,0,1,0
61339,445,0,0,drop,66,66,0,1,0,1,0
61335,445,0,0,drop,66,66,0,1,0,1,0
61336,445,0,0,drop,66,66,0,1,0,1,0
61333,445,0,0,drop,66,66,0,1,0,1,0
61116,445,0,0,drop,70,70,0,1,0,1,0
61115,445,0,0,drop,70,70,0,1,0,1,0
49575,445,0,0,drop,70,70,0,1,0,1,0
49568,445,0,0,drop,70,70,0,1,0,1,0
49565,445,0,0,drop,70,70,0,1,0,1,0
49566,445,0,0,drop,70,70,0,1,0,1,0
61110,445,0,0,drop,70,70,0,1,0,1,0
61319,445,0,0,drop,66,66,0,1,0,1,0
61321,445,0,0,drop,66,66,0,1,0,1,0
61318,445,0,0,drop,66,66,0,1,0,1,0
49556,445,0,0,drop,70,70,0,1,0,1,0
49555,445,0,0,drop,70,70,0,1,0,1,0
49547,445,0,0,drop,70,70,0,1,0,1,0
61097,445,0,0,drop,70,70,0,1,0,1,0
61094,445,0,0,drop,70,70,0,1,0,1,0
63345,53,0,0,deny,75,75,0,1,0,1,0
49536,445,0,0,drop,70,70,0,1,0,1,0
49533,445,0,0,drop,70,70,0,1,0,1,0
61088,445,0,0,drop,70,70,0,1,0,1,0
61087,445,0,0,drop,70,70,0,1,0,1,0
61085,445,0,0,drop,70,70,0,1,0,1,0
49529,445,0,0,drop,70,70,0,1,0,1,0
61294,445,0,0,drop,66,66,0,1,0,1,0
61293,445,0,0,drop,66,66,0,1,0,1,0
61078,445,0,0,drop,70,70,0,1,0,1,0
61076,445,0,0,drop,70,70,0,1,0,1,0
49516,445,0,0,drop,70,70,0,1,0,1,0
49508,445,0,0,drop,70,70,0,1,0,1,0
49511,445,0,0,drop,70,70,0,1,0,1,0
61075,445,0,0,drop,70,70,0,1,0,1,0
61074,445,0,0,drop,70,70,0,1,0,1,0
61073,445,0,0,drop,70,70,0,1,0,1,0
61287,445,0,0,drop,66,66,0,1,0,1,0
61069,445,0,0,drop,70,70,0,1,0,1,0
61068,445,0,0,drop,70,70,0,1,0,1,0
61282,445,0,0,drop,66,66,0,1,0,1,0
61280,445,0,0,drop,66,66,0,1,0,1,0
61281,445,0,0,drop,66,66,0,1,0,1,0
61279,445,0,0,drop,66,66,0,1,0,1,0
61271,445,0,0,drop,66,66,0,1,0,1,0
61275,445,0,0,drop,66,66,0,1,0,1,0
61276,445,0,0,drop,66,66,0,1,0,1,0
61055,445,0,0,drop,70,70,0,1,0,1,0
61054,445,0,0,drop,70,70,0,1,0,1,0
61051,445,0,0,drop,70,70,0,1,0,1,0
49501,445,0,0,drop,70,70,0,1,0,1,0
61044,445,0,0,drop,70,70,0,1,0,1,0
61045,445,0,0,drop,70,70,0,1,0,1,0
49496,445,0,0,drop,70,70,0,1,0,1,0
49494,445,0,0,drop,70,70,0,1,0,1,0
61033,445,0,0,drop,70,70,0,1,0,1,0
61264,445,0,0,drop,66,66,0,1,0,1,0
56695,53,39577,53,allow,93,93,0,1,30,1,0
60244,80,21449,80,allow,1114,534,580,12,16,7,5
49722,53,48716,53,allow,200,102,98,2,30,1,1
55285,53,1660,53,allow,268,95,173,4,45,2,2
65019,53,42326,53,allow,190,97,93,2,31,1,1
49227,53,39429,53,allow,174,89,85,2,30,1,1
56492,53,6474,53,allow,184,94,90,2,30,1,1
64316,53,59418,53,allow,184,94,90,2,31,1,1
55830,53,59149,53,allow,164,84,80,2,31,1,1
57208,53,63369,53,allow,182,93,89,2,31,1,1
56636,53,8907,53,allow,168,86,82,2,30,1,1
64519,53,20237,53,allow,277,94,183,4,60,2,2
56992,80,9421,80,allow,214,140,74,4,35,3,1
55098,53,22759,53,allow,474,200,274,6,44,3,3
56320,53,27969,53,allow,761,100,661,2,30,1,1
55616,53,41127,53,allow,776,102,674,2,30,1,1
49390,53,24759,53,allow,204,104,100,2,31,1,1
55979,53,36976,53,allow,186,95,91,2,31,1,1
56994,80,47420,80,allow,214,140,74,4,35,3,1
56993,80,53078,80,allow,214,140,74,4,35,3,1
55932,53,3397,53,allow,186,95,91,2,30,1,1
50154,53,53091,53,allow,756,95,661,2,30,1,1
55539,53,7321,53,allow,814,110,704,2,30,1,1
55083,53,43737,53,allow,751,95,656,2,30,1,1
56170,53,28854,53,allow,196,100,96,2,30,1,1
55154,53,45659,53,allow,184,94,90,2,30,1,1
65398,53,61803,53,allow,212,108,104,2,30,1,1
65384,53,45912,53,allow,735,88,647,2,31,1,1
56658,53,11385,53,allow,186,95,91,2,31,1,1
49205,53,38111,53,allow,188,96,92,2,31,1,1
56226,53,58477,53,allow,780,104,676,2,31,1,1
56603,53,25992,53,allow,1400,97,1303,4,57,2,2
49163,53,24237,53,allow,166,85,81,2,30,1,1
49218,53,62258,53,allow,190,97,93,2,31,1,1
56723,53,2628,53,allow,733,85,648,2,31,1,1
57241,53,11880,53,allow,760,97,663,2,31,1,1
57366,53,63370,53,allow,745,93,652,2,31,1,1
57398,53,10527,53,allow,770,102,668,2,31,1,1
57049,53,52014,53,allow,755,93,662,2,31,1,1
49354,53,30111,53,allow,192,98,94,2,31,1,1
56362,53,49796,53,allow,190,97,93,2,31,1,1
64380,53,29472,53,allow,186,95,91,2,31,1,1
55070,53,2161,53,allow,190,97,93,2,31,1,1
64089,53,25036,53,allow,188,96,92,2,31,1,1
49754,53,54663,53,allow,176,90,86,2,31,1,1
56344,53,27123,53,allow,198,101,97,2,31,1,1
64631,53,41468,53,allow,186,95,91,2,31,1,1
49293,53,58522,53,allow,172,88,84,2,31,1,1
56457,53,47112,53,allow,731,91,640,2,31,1,1
55919,53,57611,53,allow,754,94,660,2,31,1,1
64573,53,7328,53,allow,184,94,90,2,31,1,1
64326,53,28923,53,allow,192,98,94,2,31,1,1
56318,53,8880,53,allow,182,93,89,2,31,1,1
55356,53,43051,53,allow,756,95,661,2,31,1,1
55976,53,37566,53,allow,758,96,662,2,31,1,1
55646,53,39790,53,allow,760,97,663,2,31,1,1
56816,53,44842,53,allow,754,94,660,2,31,1,1
55463,53,53091,53,allow,216,110,106,2,31,1,1
55411,53,60848,53,allow,182,93,89,2,31,1,1
56930,53,53703,53,allow,774,101,673,2,31,1,1
49488,445,0,0,drop,70,70,0,1,0,1,0
61261,445,0,0,drop,66,66,0,1,0,1,0
61258,445,0,0,drop,66,66,0,1,0,1,0
61259,445,0,0,drop,66,66,0,1,0,1,0
61256,445,0,0,drop,66,66,0,1,0,1,0
61029,445,0,0,drop,70,70,0,1,0,1,0
49480,445,0,0,drop,70,70,0,1,0,1,0
55979,53,33606,53,allow,193,102,91,2,30,1,1
53670,80,8760,80,allow,950,502,448,12,15,7,5
61332,23,0,0,deny,60,60,0,1,0,1,0
49476,445,0,0,drop,70,70,0,1,0,1,0
61020,445,0,0,drop,70,70,0,1,0,1,0
61018,445,0,0,drop,70,70,0,1,0,1,0
61017,445,0,0,drop,70,70,0,1,0,1,0
61016,445,0,0,drop,70,70,0,1,0,1,0
61012,445,0,0,drop,70,70,0,1,0,1,0
51244,1,0,0,deny,100,100,0,1,0,1,0
61246,445,0,0,drop,66,66,0,1,0,1,0
61238,445,0,0,drop,66,66,0,1,0,1,0
49464,445,0,0,drop,70,70,0,1,0,1,0
56658,53,53602,53,allow,193,102,91,2,30,1,1
64575,53,7510,53,allow,182,102,80,2,30,1,1
56327,53,30596,53,allow,199,102,97,2,30,1,1
50589,53,14237,53,allow,786,110,676,2,30,1,1
57344,53,11119,53,allow,969,86,883,2,30,1,1
53799,53,39316,53,allow,213,78,135,2,30,1,1
59779,443,59854,443,allow,568,568,0,5,10,5,0
57016,53,13360,53,allow,266,110,156,2,30,1,1
50303,443,52524,443,allow,208,60,148,4,11,2,2
55042,443,45406,443,allow,126,60,66,3,5,2,1
55285,53,22135,53,allow,268,95,173,4,45,2,2
55098,53,38857,53,allow,474,200,274,6,43,3,3
35941,443,48738,443,allow,190,70,120,4,18,2,2
64980,53,40885,53,allow,274,88,186,4,35,2,2
65238,53,61898,53,allow,302,104,198,4,46,2,2
50612,80,47441,80,allow,1559,1107,452,9,24,5,4
55932,53,10932,53,allow,193,102,91,2,29,1,1
64537,53,60663,53,allow,168,86,82,2,29,1,1
55371,53,15832,53,allow,184,102,82,2,29,1,1
56395,53,34668,53,allow,199,102,97,2,29,1,1
49811,53,10574,53,allow,763,102,661,2,29,1,1
57203,53,8040,53,allow,199,102,97,2,29,1,1
56450,53,8472,53,allow,168,86,82,2,30,1,1
56395,53,54170,53,allow,199,102,97,2,29,1,1
49390,53,36883,53,allow,210,110,100,2,30,1,1
56636,53,49408,53,allow,168,86,82,2,30,1,1
56151,53,10029,53,allow,194,102,92,2,30,1,1
55727,53,33963,53,allow,335,93,242,4,32,2,2
56245,53,35606,53,allow,200,102,98,2,30,1,1
49835,53,19938,53,allow,194,102,92,2,30,1,1
57299,53,60240,53,allow,338,110,228,2,30,1,1
65019,53,36796,53,allow,195,102,93,2,30,1,1
55849,53,49045,53,allow,195,102,93,2,30,1,1
56170,53,63567,53,allow,198,102,96,2,30,1,1
55113,53,62631,53,allow,177,94,83,2,30,1,1
58993,443,55872,443,allow,416,210,206,7,26,4,3
55098,53,15101,53,allow,474,200,274,6,43,3,3
56998,80,16426,80,allow,214,140,74,4,35,3,1
56327,53,60019,53,allow,199,102,97,2,30,1,1
55154,53,33060,53,allow,184,94,90,2,30,1,1
56958,53,59654,53,allow,816,102,714,2,30,1,1
56995,80,29664,80,allow,214,140,74,4,35,3,1
56198,53,28713,53,allow,184,102,82,2,30,1,1
49372,53,16928,53,allow,210,110,100,2,30,1,1
64980,53,62800,53,allow,180,94,86,2,30,1,1
56001,53,33036,53,allow,196,94,102,2,30,1,1
65328,53,18942,53,allow,166,86,80,2,30,1,1
64330,53,10524,53,allow,193,102,91,2,30,1,1
49354,53,61914,53,allow,196,102,94,2,30,1,1
56624,53,44653,53,allow,199,102,97,2,30,1,1
56988,53,43201,53,allow,216,110,106,2,30,1,1
49205,53,61916,53,allow,194,102,92,2,30,1,1
55098,53,33176,53,allow,474,200,274,6,44,3,3
55979,53,60691,53,allow,193,102,91,2,30,1,1
49218,53,40400,53,allow,195,102,93,2,30,1,1
56416,53,14432,53,allow,193,102,91,2,30,1,1
55684,53,56434,53,allow,193,102,91,2,30,1,1
55272,53,55902,53,allow,198,110,88,2,30,1,1
64621,53,62273,53,allow,214,102,112,2,30,1,1
64894,53,1246,53,allow,550,113,437,4,46,2,2
56492,53,12334,53,allow,184,94,90,2,29,1,1
37175,53,14480,53,allow,231,86,145,2,29,1,1
56450,53,45835,53,allow,184,102,82,2,29,1,1
55932,53,12204,53,allow,193,102,91,2,29,1,1
64687,53,10483,53,allow,183,94,89,2,29,1,1
57002,80,6505,80,allow,214,140,74,4,35,3,1
56245,53,14605,53,allow,200,102,98,2,30,1,1
56997,80,45711,80,allow,214,140,74,4,35,3,1
65307,53,36094,53,allow,811,94,717,2,29,1,1
55712,53,52427,53,allow,164,86,78,2,29,1,1
56395,53,56804,53,allow,199,102,97,2,29,1,1
49503,53,43089,53,allow,167,86,81,2,29,1,1
49722,53,64718,53,allow,200,102,98,2,29,1,1
64687,53,9775,53,allow,183,94,89,2,29,1,1
64599,53,10160,53,allow,250,94,156,2,29,1,1
57437,53,35666,53,allow,193,102,91,2,30,1,1
57208,53,39529,53,allow,183,94,89,2,30,1,1
55154,53,5239,53,allow,184,94,90,2,30,1,1
56344,53,2417,53,allow,199,102,97,2,30,1,1
49205,53,36921,53,allow,194,102,92,2,30,1,1
56245,53,47709,53,allow,200,102,98,2,30,1,1
55154,53,39546,53,allow,184,94,90,2,30,1,1
56344,53,47952,53,allow,199,102,97,2,30,1,1
64089,53,37654,53,allow,194,102,92,2,30,1,1
64573,53,39960,53,allow,184,94,90,2,30,1,1
56067,53,59693,53,allow,294,102,192,2,30,1,1
55463,53,9844,53,allow,216,110,106,2,31,1,1
65398,53,27490,53,allow,214,110,104,2,30,1,1
49429,53,47373,53,allow,194,102,92,2,30,1,1
56624,53,64033,53,allow,199,102,97,2,30,1,1
57208,53,19470,53,allow,183,94,89,2,30,1,1
56988,53,29456,53,allow,216,110,106,2,30,1,1
64631,53,8154,53,allow,193,102,91,2,30,1,1
56362,53,16824,53,allow,195,102,93,2,30,1,1
64380,53,47265,53,allow,193,102,91,2,30,1,1
55070,53,21493,53,allow,195,102,93,2,30,1,1
55975,53,27530,53,allow,939,678,261,2,30,1,1
55113,53,22722,53,allow,177,94,83,2,30,1,1
56151,53,18710,53,allow,194,102,92,2,30,1,1
56318,53,32737,53,allow,183,94,89,2,30,1,1
49390,53,56282,53,allow,210,110,100,2,30,1,1
64907,53,21503,53,allow,247,86,161,3,31,2,1
55155,53,52768,53,allow,194,102,92,2,31,1,1
55830,53,50350,53,allow,166,86,80,2,30,1,1
56198,53,50578,53,allow,184,102,82,2,30,1,1
53671,80,50539,80,allow,956,502,454,12,15,7,5
56655,80,36577,80,allow,234,234,0,4,12,4,0
56999,80,32577,80,allow,214,140,74,4,35,3,1
56996,80,27965,80,allow,214,140,74,4,35,3,1
57003,80,40780,80,allow,526,304,222,8,35,5,3
57076,53,47154,53,allow,184,94,90,2,30,1,1
49878,53,52467,53,allow,262,126,136,2,30,1,1
56958,53,40535,53,allow,193,102,91,2,30,1,1
49835,53,6905,53,allow,817,102,715,2,30,1,1
64573,53,34650,53,allow,184,94,90,2,30,1,1
49372,53,57735,53,allow,210,110,100,2,30,1,1
56988,53,25747,53,allow,216,110,106,2,30,1,1
53798,53,26638,53,allow,224,86,138,2,30,1,1
64316,53,5577,53,allow,184,94,90,2,30,1,1
50278,53,34897,53,allow,819,102,717,2,30,1,1
57409,53,6816,53,allow,168,86,82,2,31,1,1
57001,80,47227,80,allow,214,140,74,4,35,3,1
57000,80,51268,80,allow,214,140,74,4,35,3,1
57437,53,57480,53,allow,193,102,91,2,30,1,1
64980,53,51851,53,allow,180,94,86,2,30,1,1
56658,53,26187,53,allow,193,102,91,2,30,1,1
57409,53,63027,53,allow,168,86,82,2,30,1,1
56416,53,30154,53,allow,816,102,714,2,30,1,1
49390,53,61910,53,allow,210,110,100,2,30,1,1
55755,53,57482,53,allow,779,86,693,2,30,1,1
56636,53,34067,53,allow,168,86,82,2,30,1,1
50025,53,33178,53,allow,761,102,659,2,30,1,1
49354,53,16501,53,allow,196,102,94,2,30,1,1
55085,53,9873,53,allow,301,94,207,2,30,1,1
65398,53,49816,53,allow,214,110,104,2,30,1,1
65356,53,49410,53,allow,199,102,97,2,30,1,1
55979,53,21397,53,allow,193,102,91,2,31,1,1
65019,53,46989,53,allow,195,102,93,2,31,1,1
57243,53,64536,53,allow,165,86,79,2,31,1,1
56880,53,8683,53,allow,209,110,99,2,31,1,1
64326,53,50909,53,allow,196,102,94,2,31,1,1
53797,53,41009,53,allow,260,86,174,2,30,1,1
49813,53,53266,53,allow,775,102,673,2,30,1,1
64089,53,3452,53,allow,194,102,92,2,31,1,1
57208,53,46583,53,allow,183,94,89,2,31,1,1
56344,53,6437,53,allow,199,102,97,2,31,1,1
56757,53,30520,53,allow,167,86,81,2,31,1,1
55883,53,56307,53,allow,181,94,87,2,31,1,1
65356,53,36098,53,allow,199,102,97,2,30,1,1
55315,53,5468,53,allow,196,102,94,2,31,1,1
49218,53,22762,53,allow,195,102,93,2,31,1,1
56637,53,47556,53,allow,214,110,104,2,31,1,1
55684,53,54861,53,allow,193,102,91,2,31,1,1
56318,53,47693,53,allow,183,94,89,2,31,1,1
49205,53,19317,53,allow,194,102,92,2,31,1,1
55070,53,23784,53,allow,195,102,93,2,31,1,1
64316,53,34882,53,allow,184,94,90,2,31,1,1
64519,53,15868,53,allow,518,185,333,6,60,3,3
57418,53,1554,53,allow,165,86,79,2,31,1,1
56487,53,61282,53,allow,194,102,92,2,31,1,1
57337,443,40846,443,allow,1169,616,553,12,16,7,5
50584,80,65205,80,allow,1883,995,888,11,47,6,5
61007,445,0,0,drop,70,70,0,1,0,1,0
61235,445,0,0,drop,66,66,0,1,0,1,0
60999,445,0,0,drop,70,70,0,1,0,1,0
60997,445,0,0,drop,70,70,0,1,0,1,0
61229,445,0,0,drop,66,66,0,1,0,1,0
61226,445,0,0,drop,66,66,0,1,0,1,0
60993,445,0,0,drop,70,70,0,1,0,1,0
60991,445,0,0,drop,70,70,0,1,0,1,0
60987,445,0,0,drop,70,70,0,1,0,1,0
49450,445,0,0,drop,70,70,0,1,0,1,0
49449,445,0,0,drop,70,70,0,1,0,1,0
49448,445,0,0,drop,70,70,0,1,0,1,0
61211,445,0,0,drop,66,66,0,1,0,1,0
61213,445,0,0,drop,66,66,0,1,0,1,0
61212,445,0,0,drop,66,66,0,1,0,1,0
61209,445,0,0,drop,66,66,0,1,0,1,0
61210,445,0,0,drop,66,66,0,1,0,1,0
61207,445,0,0,drop,66,66,0,1,0,1,0
61208,445,0,0,drop,66,66,0,1,0,1,0
61205,445,0,0,drop,66,66,0,1,0,1,0
60986,445,0,0,drop,70,70,0,1,0,1,0
60981,445,0,0,drop,70,70,0,1,0,1,0
49447,445,0,0,drop,70,70,0,1,0,1,0
49446,445,0,0,drop,70,70,0,1,0,1,0
49444,445,0,0,drop,70,70,0,1,0,1,0
49443,445,0,0,drop,70,70,0,1,0,1,0
61191,445,0,0,drop,66,66,0,1,0,1,0
61193,445,0,0,drop,66,66,0,1,0,1,0
61190,445,0,0,drop,66,66,0,1,0,1,0
49428,445,0,0,drop,70,70,0,1,0,1,0
49420,445,0,0,drop,70,70,0,1,0,1,0
49421,445,0,0,drop,70,70,0,1,0,1,0
60968,445,0,0,drop,70,70,0,1,0,1,0
60965,445,0,0,drop,70,70,0,1,0,1,0
49408,445,0,0,drop,70,70,0,1,0,1,0
49406,445,0,0,drop,70,70,0,1,0,1,0
60960,445,0,0,drop,70,70,0,1,0,1,0
61180,445,0,0,drop,66,66,0,1,0,1,0
60959,445,0,0,drop,70,70,0,1,0,1,0
60957,445,0,0,drop,70,70,0,1,0,1,0
49401,445,0,0,drop,70,70,0,1,0,1,0
46218,23,0,0,deny,60,60,0,1,0,1,0
60950,445,0,0,drop,70,70,0,1,0,1,0
61164,445,0,0,drop,66,66,0,1,0,1,0
61163,445,0,0,drop,66,66,0,1,0,1,0
60948,445,0,0,drop,70,70,0,1,0,1,0
60947,445,0,0,drop,70,70,0,1,0,1,0
60946,445,0,0,drop,70,70,0,1,0,1,0
60945,445,0,0,drop,70,70,0,1,0,1,0
49388,445,0,0,drop,70,70,0,1,0,1,0
60939,445,0,0,drop,70,70,0,1,0,1,0
60942,445,0,0,drop,70,70,0,1,0,1,0
49386,445,0,0,drop,70,70,0,1,0,1,0
49383,445,0,0,drop,70,70,0,1,0,1,0
49380,445,0,0,drop,70,70,0,1,0,1,0
61159,445,0,0,drop,66,66,0,1,0,1,0
61154,445,0,0,drop,66,66,0,1,0,1,0
61153,445,0,0,drop,66,66,0,1,0,1,0
61152,445,0,0,drop,66,66,0,1,0,1,0
61150,445,0,0,drop,66,66,0,1,0,1,0
61142,445,0,0,drop,66,66,0,1,0,1,0
61143,445,0,0,drop,66,66,0,1,0,1,0
61148,445,0,0,drop,66,66,0,1,0,1,0
60927,445,0,0,drop,70,70,0,1,0,1,0
60925,445,0,0,drop,70,70,0,1,0,1,0
60923,445,0,0,drop,70,70,0,1,0,1,0
60917,445,0,0,drop,70,70,0,1,0,1,0
60916,445,0,0,drop,70,70,0,1,0,1,0
56487,53,12533,53,allow,188,96,92,2,30,1,1
56779,53,7300,53,allow,757,98,659,2,30,1,1
56169,53,42323,53,allow,204,104,100,2,30,1,1
43632,80,17222,80,allow,2000,710,1290,8,15,5,3
55684,53,10799,53,allow,186,95,91,2,30,1,1
57092,53,22566,53,allow,756,95,661,2,31,1,1
55155,53,65476,53,allow,188,96,92,2,31,1,1
57721,443,65259,443,allow,1019,644,375,10,37,6,4
55351,53,4702,53,allow,1497,108,1389,4,53,2,2
55986,53,53201,53,allow,744,89,655,2,30,1,1
55546,53,22275,53,allow,1417,96,1321,4,30,2,2
55315,53,41500,53,allow,192,98,94,2,31,1,1
56540,53,53541,53,allow,735,88,647,2,30,1,1
57409,53,7230,53,allow,168,86,82,2,30,1,1
56880,53,23570,53,allow,202,103,99,2,31,1,1
55907,53,18391,53,allow,184,94,90,2,31,1,1
55068,53,58274,53,allow,192,98,94,2,31,1,1
56112,53,3199,53,allow,198,101,97,2,31,1,1
56875,53,47885,53,allow,166,85,81,2,31,1,1
59994,53,59994,53,allow,462,158,304,4,31,2,2
56503,53,8942,53,allow,916,86,830,2,31,1,1
55525,53,23543,53,allow,212,108,104,2,31,1,1
56427,53,59297,53,allow,164,84,80,2,31,1,1
56676,53,4759,53,allow,172,88,84,2,31,1,1
57343,53,26142,53,allow,178,91,87,2,31,1,1
56382,53,19333,53,allow,190,97,93,2,31,1,1
49373,445,0,0,drop,70,70,0,1,0,1,0
60905,445,0,0,drop,70,70,0,1,0,1,0
56704,53,35730,53,allow,210,94,116,2,30,1,1
64823,53,30935,53,allow,508,102,406,2,30,1,1
55155,53,23280,53,allow,194,102,92,2,30,1,1
58057,80,12753,80,allow,254,128,126,5,15,3,2
56105,53,14961,53,allow,372,142,230,2,29,1,1
64999,53,5804,53,allow,178,94,84,2,29,1,1
56560,53,15895,53,allow,164,86,78,2,29,1,1
55777,53,5442,53,allow,733,94,639,2,29,1,1
64999,53,33322,53,allow,178,94,84,2,29,1,1
56632,53,26751,53,allow,200,94,106,2,29,1,1
55803,53,18638,53,allow,261,89,172,4,32,2,2
55358,53,33999,53,allow,200,94,106,2,29,1,1
56624,53,40354,53,allow,199,102,97,2,29,1,1
64380,53,22158,53,allow,193,102,91,2,29,1,1
55272,53,54690,53,allow,198,110,88,2,29,1,1
64326,53,30580,53,allow,196,102,94,2,29,1,1
56639,53,47791,53,allow,168,86,82,2,32,1,1
54506,80,60844,80,allow,254,128,126,5,15,3,2
56655,53,1875,53,allow,210,110,100,2,30,1,1
57211,53,8547,53,allow,258,110,148,2,30,1,1
57419,53,26611,53,allow,196,102,94,2,30,1,1
55582,53,15587,53,allow,168,86,82,2,30,1,1
39205,53,46384,53,allow,489,94,395,2,30,1,1
55068,53,54785,53,allow,196,102,94,2,30,1,1
65108,53,40239,53,allow,215,94,121,2,30,1,1
55427,53,22421,53,allow,200,102,98,2,33,1,1
64424,53,30245,53,allow,211,102,109,2,30,1,1
55260,53,35785,53,allow,183,94,89,2,30,1,1
50057,53,32757,53,allow,718,94,624,2,30,1,1
64104,53,19823,53,allow,288,101,187,4,57,2,2
55411,53,33954,53,allow,183,94,89,2,30,1,1
56107,53,50537,53,allow,817,102,715,2,30,1,1
49924,53,19826,53,allow,718,94,624,2,30,1,1
49293,53,24281,53,allow,178,94,84,2,30,1,1
56487,53,32287,53,allow,194,102,92,2,30,1,1
49935,53,50105,53,allow,177,94,83,2,30,1,1
56757,53,39521,53,allow,167,86,81,2,30,1,1
56107,53,24230,53,allow,194,102,92,2,30,1,1
55411,53,25352,53,allow,183,94,89,2,30,1,1
49754,53,60786,53,allow,180,94,86,2,30,1,1
65391,53,47962,53,allow,720,94,626,2,30,1,1
55427,53,31506,53,allow,200,102,98,2,30,1,1
55411,53,47570,53,allow,183,94,89,2,30,1,1
56111,53,56414,53,allow,152,78,74,2,30,1,1
55791,53,4698,53,allow,811,94,717,2,30,1,1
57243,53,20159,53,allow,173,94,79,2,30,1,1
56667,53,19814,53,allow,244,94,150,2,30,1,1
55261,53,19627,53,allow,173,94,79,2,30,1,1
64326,53,26486,53,allow,196,102,94,2,30,1,1
56941,53,32595,53,allow,212,102,110,2,30,1,1
49625,53,64446,53,allow,251,102,149,2,30,1,1
56362,53,49455,53,allow,195,102,93,2,30,1,1
56860,53,63586,53,allow,184,102,82,2,30,1,1
54953,53,51225,53,allow,289,134,155,2,30,1,1
55250,53,30475,53,allow,416,102,314,2,30,1,1
57000,53,37935,53,allow,193,94,99,2,30,1,1
63941,53,42926,53,allow,253,102,151,2,30,1,1
55883,53,20281,53,allow,189,102,87,2,30,1,1
56880,53,27129,53,allow,209,110,99,2,30,1,1
56319,53,40959,53,allow,455,94,361,2,30,1,1
55671,53,24025,53,allow,196,102,94,2,33,1,1
64089,53,43918,53,allow,340,96,244,4,35,2,2
55729,53,3835,53,allow,256,96,160,4,42,2,2
55907,53,49379,53,allow,184,94,90,2,30,1,1
49293,53,18352,53,allow,294,88,206,4,57,2,2
57340,443,31175,443,allow,1169,616,553,12,16,7,5
49227,53,40527,53,allow,340,89,251,4,44,2,2
58001,443,15727,443,allow,300,180,120,6,28,4,2
56362,53,31120,53,allow,195,102,93,2,29,1,1
55463,53,33769,53,allow,216,110,106,2,29,1,1
56560,53,37508,53,allow,172,94,78,2,29,1,1
55329,53,39839,53,allow,210,102,108,2,29,1,1
56636,53,35098,53,allow,372,86,286,4,54,2,2
55684,53,19288,53,allow,193,102,91,2,29,1,1
56111,53,50559,53,allow,168,94,74,2,30,1,1
49163,53,13314,53,allow,167,86,81,2,29,1,1
64631,53,29007,53,allow,193,102,91,2,29,1,1
55260,53,54111,53,allow,183,94,89,2,30,1,1
64104,53,54315,53,allow,288,101,187,4,58,2,2
65503,53,13139,53,allow,177,94,83,2,30,1,1
56427,53,59591,53,allow,166,86,80,2,30,1,1
56860,53,58794,53,allow,168,86,82,2,30,1,1
56658,53,32323,53,allow,193,102,91,2,30,1,1
56700,53,42094,53,allow,443,182,261,6,30,3,3
56169,53,21391,53,allow,210,110,100,2,30,1,1
56110,53,15545,53,allow,508,102,406,2,30,1,1
56050,53,62054,53,allow,178,94,84,2,30,1,1
55803,53,62058,53,allow,179,94,85,2,30,1,1
65160,53,39178,53,allow,198,94,104,2,30,1,1
57092,53,56689,53,allow,445,86,359,2,30,1,1
55525,53,56574,53,allow,214,110,104,2,30,1,1
56382,53,27838,53,allow,195,102,93,2,30,1,1
65106,53,60145,53,allow,438,180,258,6,30,3,3
56487,53,4784,53,allow,194,102,92,2,30,1,1
56917,53,28057,53,allow,194,102,92,2,31,1,1
64631,53,5606,53,allow,193,102,91,2,30,1,1
57419,53,1217,53,allow,819,102,717,2,30,1,1
56847,53,58381,53,allow,252,102,150,2,30,1,1
49387,53,43855,53,allow,323,102,221,2,30,1,1
55030,53,38017,53,allow,185,102,83,2,30,1,1
56261,53,47864,53,allow,184,94,90,2,31,1,1
55315,53,24638,53,allow,196,102,94,2,31,1,1
64266,53,26877,53,allow,180,94,86,2,35,1,1
56571,53,42202,53,allow,325,102,223,2,30,1,1
56655,53,35529,53,allow,210,110,100,2,30,1,1
57428,53,16884,53,allow,198,94,104,2,30,1,1
56637,53,51918,53,allow,214,110,104,2,30,1,1
57396,53,17014,53,allow,212,102,110,2,30,1,1
56637,53,18660,53,allow,214,110,104,2,30,1,1
56169,53,53942,53,allow,210,110,100,2,30,1,1
49935,53,46528,53,allow,177,94,83,2,30,1,1
64573,53,51074,53,allow,184,94,90,2,30,1,1
64992,53,64992,53,allow,180,82,98,2,30,1,1
63948,80,9193,80,allow,314,192,122,6,15,4,2
64292,53,10616,53,allow,387,94,293,4,51,2,2
55582,53,34252,53,allow,168,86,82,2,30,1,1
65503,53,29061,53,allow,177,94,83,2,30,1,1
55315,53,15960,53,allow,196,102,94,2,30,1,1
49354,53,25819,53,allow,196,102,94,2,30,1,1
64380,53,5955,53,allow,193,102,91,2,30,1,1
55030,53,46316,53,allow,177,94,83,2,30,1,1
55973,53,5208,53,allow,939,678,261,2,30,1,1
56160,53,10248,53,allow,94,94,0,1,30,1,0
55525,53,5634,53,allow,214,110,104,2,30,1,1
56875,53,43240,53,allow,167,86,81,2,30,1,1
57253,53,58310,53,allow,199,102,97,2,30,1,1
56050,53,60245,53,allow,178,94,84,2,30,1,1
49884,53,8513,53,allow,252,102,150,2,30,1,1
55421,53,47278,53,allow,200,102,98,2,30,1,1
57343,53,25885,53,allow,181,94,87,2,30,1,1
58695,53,54969,53,allow,392,86,306,2,30,1,1
57418,53,45442,53,allow,165,86,79,2,30,1,1
56427,53,42294,53,allow,166,86,80,2,30,1,1
57082,53,9901,53,allow,239,94,145,2,30,1,1
56382,53,5952,53,allow,195,102,93,2,31,1,1
55276,53,37772,53,allow,215,94,121,2,30,1,1
56167,53,20756,53,allow,461,94,367,2,30,1,1
55463,53,21645,53,allow,216,110,106,2,30,1,1
55666,53,45375,53,allow,211,102,109,2,30,1,1
56112,53,63106,53,allow,199,102,97,2,30,1,1
55934,53,0,0,allow,86,86,0,1,30,1,0
56676,53,9987,53,allow,178,94,84,2,30,1,1
56875,53,55228,53,allow,167,86,81,2,30,1,1
56676,53,39365,53,allow,178,94,84,2,31,1,1
57343,53,32639,53,allow,181,94,87,2,31,1,1
56556,53,18816,53,allow,184,94,90,2,31,1,1
55155,53,35899,53,allow,194,102,92,2,31,1,1
55321,53,4307,53,allow,193,102,91,2,31,1,1
55727,53,2697,53,allow,195,102,93,2,31,1,1
55002,53,42728,53,allow,196,102,94,2,31,1,1
56297,53,38652,53,allow,228,75,153,4,31,2,2
57032,53,17045,53,allow,166,86,80,2,31,1,1
57409,53,32069,53,allow,168,86,82,2,31,1,1
55834,53,32935,53,allow,184,94,90,2,31,1,1
58761,443,45887,443,allow,318,192,126,6,26,4,2
59936,80,54096,80,allow,1281,399,882,10,16,6,4
49367,445,0,0,drop,70,70,0,1,0,1,0
49366,445,0,0,drop,70,70,0,1,0,1,0
61138,445,0,0,drop,66,66,0,1,0,1,0
49360,445,0,0,drop,70,70,0,1,0,1,0
61133,445,0,0,drop,66,66,0,1,0,1,0
61132,445,0,0,drop,66,66,0,1,0,1,0
61130,445,0,0,drop,66,66,0,1,0,1,0
61128,445,0,0,drop,66,66,0,1,0,1,0
60899,445,0,0,drop,70,70,0,1,0,1,0
60888,445,0,0,drop,70,70,0,1,0,1,0
60889,445,0,0,drop,70,70,0,1,0,1,0
60887,445,0,0,drop,70,70,0,1,0,1,0
49352,445,0,0,drop,70,70,0,1,0,1,0
60886,445,0,0,drop,70,70,0,1,0,1,0
49351,445,0,0,drop,70,70,0,1,0,1,0
49348,445,0,0,drop,70,70,0,1,0,1,0
60883,445,0,0,drop,70,70,0,1,0,1,0
61117,445,0,0,drop,66,66,0,1,0,1,0
60877,445,0,0,drop,70,70,0,1,0,1,0
61110,445,0,0,drop,66,66,0,1,0,1,0
61108,445,0,0,drop,66,66,0,1,0,1,0
60869,445,0,0,drop,70,70,0,1,0,1,0
60868,445,0,0,drop,70,70,0,1,0,1,0
61100,445,0,0,drop,66,66,0,1,0,1,0
61096,445,0,0,drop,66,66,0,1,0,1,0
60863,445,0,0,drop,70,70,0,1,0,1,0
60861,445,0,0,drop,70,70,0,1,0,1,0
60857,445,0,0,drop,70,70,0,1,0,1,0
49322,445,0,0,drop,70,70,0,1,0,1,0
49320,445,0,0,drop,70,70,0,1,0,1,0
60856,445,0,0,drop,70,70,0,1,0,1,0
61082,445,0,0,drop,66,66,0,1,0,1,0
61077,445,0,0,drop,66,66,0,1,0,1,0
61085,445,0,0,drop,66,66,0,1,0,1,0
61083,445,0,0,drop,66,66,0,1,0,1,0
61078,445,0,0,drop,66,66,0,1,0,1,0
61079,445,0,0,drop,66,66,0,1,0,1,0
61080,445,0,0,drop,66,66,0,1,0,1,0
61081,445,0,0,drop,66,66,0,1,0,1,0
60851,445,0,0,drop,70,70,0,1,0,1,0
49316,445,0,0,drop,70,70,0,1,0,1,0
49310,445,0,0,drop,70,70,0,1,0,1,0
49311,445,0,0,drop,70,70,0,1,0,1,0
61065,445,0,0,drop,66,66,0,1,0,1,0
61064,445,0,0,drop,66,66,0,1,0,1,0
61063,445,0,0,drop,66,66,0,1,0,1,0
49300,445,0,0,drop,70,70,0,1,0,1,0
60838,445,0,0,drop,70,70,0,1,0,1,0
49298,445,0,0,drop,70,70,0,1,0,1,0
49290,445,0,0,drop,70,70,0,1,0,1,0
49289,445,0,0,drop,70,70,0,1,0,1,0
60835,445,0,0,drop,70,70,0,1,0,1,0
60830,445,0,0,drop,70,70,0,1,0,1,0
49280,445,0,0,drop,70,70,0,1,0,1,0
49278,445,0,0,drop,70,70,0,1,0,1,0
49277,445,0,0,drop,70,70,0,1,0,1,0
60829,445,0,0,drop,70,70,0,1,0,1,0
60827,445,0,0,drop,70,70,0,1,0,1,0
61050,445,0,0,drop,66,66,0,1,0,1,0
49274,445,0,0,drop,70,70,0,1,0,1,0
49266,445,0,0,drop,70,70,0,1,0,1,0
60820,445,0,0,drop,70,70,0,1,0,1,0
60818,445,0,0,drop,70,70,0,1,0,1,0
61038,445,0,0,drop,66,66,0,1,0,1,0
61037,445,0,0,drop,66,66,0,1,0,1,0
60817,445,0,0,drop,70,70,0,1,0,1,0
55421,53,44471,53,allow,200,102,98,2,30,1,1
55756,53,41764,53,allow,747,90,657,2,30,1,1
55834,53,38945,53,allow,184,94,90,2,31,1,1
56261,53,22541,53,allow,184,94,90,2,31,1,1
58035,80,60635,80,allow,130,70,60,2,15,1,1
60999,53,14276,53,allow,578,286,292,9,16,5,4
56556,53,58365,53,allow,184,94,90,2,31,1,1
57262,53,44073,53,allow,176,90,86,2,30,1,1
56639,53,16587,53,allow,168,86,82,2,36,1,1
53788,1,8231,1,allow,70,70,0,2,8,2,0
43818,80,62769,80,allow,2005,715,1290,8,15,5,3
55803,53,28022,53,allow,174,89,85,3,36,2,1
55321,53,43693,53,allow,186,95,91,2,31,1,1
57193,80,36563,80,allow,2235,1055,1180,12,16,7,5
60929,80,45754,80,allow,2235,1055,1180,12,15,7,5
49990,443,43414,443,allow,622,210,412,10,21,4,6
60593,80,43950,80,allow,130,70,60,2,15,1,1
56297,53,44253,53,allow,168,86,82,2,30,1,1
55727,53,51328,53,allow,190,97,93,2,30,1,1
56917,53,47484,53,allow,188,96,92,2,31,1,1
57176,53,65163,53,allow,793,101,692,2,31,1,1
55002,53,54595,53,allow,192,98,94,2,31,1,1
60816,445,0,0,drop,70,70,0,1,0,1,0
60815,445,0,0,drop,70,70,0,1,0,1,0
60812,445,0,0,drop,70,70,0,1,0,1,0
60811,445,0,0,drop,70,70,0,1,0,1,0
49259,445,0,0,drop,70,70,0,1,0,1,0
49256,445,0,0,drop,70,70,0,1,0,1,0
49252,445,0,0,drop,70,70,0,1,0,1,0
56297,53,58728,53,allow,168,86,82,2,30,1,1
56783,53,44308,53,allow,193,102,91,2,30,1,1
39742,80,38417,80,allow,1569,593,976,10,44,6,4
50498,53,36030,53,allow,751,94,657,2,29,1,1
57032,53,53093,53,allow,166,86,80,2,29,1,1
57098,80,38453,80,allow,819,530,289,8,40,5,3
59994,53,59994,53,allow,86,86,0,1,29,1,0
43014,443,37896,443,allow,134,60,74,3,5,2,1
56169,53,27417,53,allow,210,110,100,2,29,1,1
56109,53,59181,53,allow,323,102,221,2,29,1,1
55387,53,15050,53,allow,195,94,101,2,29,1,1
55907,53,31154,53,allow,184,94,90,2,29,1,1
55261,53,55428,53,allow,165,86,79,2,29,1,1
57253,53,25140,53,allow,199,102,97,2,29,1,1
58101,53,12737,53,allow,83,83,0,2,31,2,0
64887,53,53065,53,allow,209,110,99,2,30,1,1
55907,53,18173,53,allow,184,94,90,2,30,1,1
55421,53,56436,53,allow,200,102,98,2,30,1,1
64219,53,14756,53,allow,403,94,309,4,38,2,2
65439,53,10579,53,allow,228,110,118,2,30,1,1
55002,53,6216,53,allow,196,102,94,2,30,1,1
63084,53,39134,53,allow,86,86,0,2,31,2,0
57326,53,16719,53,allow,180,94,86,2,35,1,1
55679,1024,59914,1024,allow,70,70,0,2,8,2,0
49879,53,57267,53,allow,517,95,422,4,44,2,2
49662,53,37093,53,allow,268,93,175,4,59,2,2
56676,53,50057,53,allow,178,94,84,2,30,1,1
55656,53,30150,53,allow,413,102,311,2,30,1,1
57262,53,58338,53,allow,180,94,86,2,30,1,1
58322,53,48798,53,allow,320,94,226,2,30,1,1
45977,53,27186,53,allow,164,78,86,2,30,1,1
56556,53,50468,53,allow,184,94,90,2,30,1,1
57053,53,14001,53,allow,211,102,109,2,30,1,1
59923,53,29358,53,allow,197,78,119,2,30,1,1
56112,53,18781,53,allow,199,102,97,2,30,1,1
55321,53,63193,53,allow,193,102,91,2,30,1,1
49991,443,60218,443,allow,622,210,412,10,21,4,6
41052,80,7228,80,allow,1056,682,374,10,15,6,4
49568,80,26293,80,allow,1515,481,1034,11,15,6,5
56297,53,12569,53,allow,168,86,82,2,30,1,1
55803,53,42450,53,allow,261,89,172,4,38,2,2
56438,53,21882,53,allow,312,94,218,2,30,1,1
56810,53,20653,53,allow,438,180,258,6,30,3,3
56653,53,34935,53,allow,78,78,0,1,30,1,0
63925,53,36572,53,allow,682,199,483,6,46,3,3
64999,53,20323,53,allow,515,86,429,4,45,2,2
47052,80,21524,80,allow,1217,486,731,8,43,5,3
55399,53,4452,53,allow,405,99,306,4,41,2,2
55729,53,41477,53,allow,256,96,160,4,41,2,2
65466,53,9762,53,allow,298,102,196,4,39,2,2
53792,1,12742,1,allow,70,70,0,2,7,2,0
54828,443,63990,443,allow,70,70,0,1,5,1,0
58885,443,6031,443,allow,152,86,66,2,5,1,1
59723,443,10674,443,allow,70,70,0,2,5,2,0
49385,53,59773,53,allow,241,102,139,2,29,1,1
64017,53,10978,53,allow,461,94,367,2,29,1,1
49500,53,31434,53,allow,248,118,130,2,29,1,1
45344,53,14086,53,allow,538,328,210,3,29,2,1
64775,53,35140,53,allow,445,86,359,2,29,1,1
55727,53,2459,53,allow,195,102,93,2,29,1,1
55068,53,59463,53,allow,196,102,94,2,29,1,1
56112,53,63692,53,allow,199,102,97,2,29,1,1
56318,53,21992,53,allow,183,94,89,2,29,1,1
55421,53,33025,53,allow,200,102,98,2,29,1,1
56880,53,13587,53,allow,209,110,99,2,30,1,1
65071,53,37727,53,allow,93,93,0,2,60,2,0
55868,53,39236,53,allow,458,188,270,6,29,3,3
56261,53,2901,53,allow,184,94,90,2,30,1,1
55525,53,3773,53,allow,214,110,104,2,30,1,1
59923,53,7241,53,allow,197,78,119,2,30,1,1
56556,53,6278,53,allow,184,94,90,2,31,1,1
59381,53,5162,53,allow,189,78,111,2,30,1,1
55834,53,17845,53,allow,184,94,90,2,30,1,1
56875,53,33833,53,allow,167,86,81,2,30,1,1
56917,53,28541,53,allow,194,102,92,2,30,1,1
56427,53,19551,53,allow,166,86,80,2,30,1,1
57262,53,33477,53,allow,180,94,86,2,30,1,1
57683,53,53315,53,allow,243,94,149,2,30,1,1
57343,53,33500,53,allow,181,94,87,2,30,1,1
57262,53,12912,53,allow,180,94,86,2,30,1,1
62415,53,11045,53,allow,86,86,0,2,31,2,0
58762,443,39294,443,allow,318,192,126,6,25,4,2
57206,123,21797,123,allow,184,94,90,2,30,1,1
59381,53,57847,53,allow,189,78,111,2,30,1,1
56639,53,41760,53,allow,168,86,82,2,30,1,1
46000,53,44521,53,allow,164,78,86,2,31,1,1
55068,53,43226,53,allow,196,102,94,2,31,1,1
55817,53,30944,53,allow,392,102,290,2,30,1,1
64709,53,47288,53,allow,353,118,235,2,30,1,1
48444,53,53992,53,allow,164,78,86,2,30,1,1
53796,53,64571,53,allow,213,78,135,2,30,1,1
55321,53,21988,53,allow,193,102,91,2,31,1,1
55002,53,11641,53,allow,196,102,94,2,31,1,1
64500,53,31734,53,allow,212,102,110,2,30,1,1
56419,53,45684,53,allow,199,102,97,2,30,1,1
56279,53,33232,53,allow,228,110,118,2,30,1,1
53746,53,62050,53,allow,164,78,86,2,31,1,1
56544,53,44845,53,allow,183,86,97,2,31,1,1
55582,53,48223,53,allow,344,107,237,4,54,2,2
62800,80,25172,80,allow,1437,659,778,11,45,6,5
49662,53,31424,53,allow,268,93,175,4,58,2,2
55834,53,8445,53,allow,429,94,335,4,52,2,2
56783,53,44833,53,allow,193,102,91,2,30,1,1
59759,53,58276,53,allow,211,78,133,2,30,1,1
55142,53,43974,53,allow,889,404,485,10,30,5,5
55680,53,53324,53,allow,198,94,104,2,30,1,1
44133,53,62526,53,allow,164,78,86,2,30,1,1
61030,445,0,0,drop,66,66,0,1,0,1,0
60797,445,0,0,drop,70,70,0,1,0,1,0
60795,445,0,0,drop,70,70,0,1,0,1,0
60792,445,0,0,drop,70,70,0,1,0,1,0
60787,445,0,0,drop,70,70,0,1,0,1,0
60786,445,0,0,drop,70,70,0,1,0,1,0
61026,445,0,0,drop,66,66,0,1,0,1,0
61024,445,0,0,drop,66,66,0,1,0,1,0
61019,445,0,0,drop,66,66,0,1,0,1,0
61017,445,0,0,drop,66,66,0,1,0,1,0
61020,445,0,0,drop,66,66,0,1,0,1,0
61022,445,0,0,drop,66,66,0,1,0,1,0
61015,445,0,0,drop,66,66,0,1,0,1,0
49245,445,0,0,drop,70,70,0,1,0,1,0
49240,445,0,0,drop,70,70,0,1,0,1,0
49238,445,0,0,drop,70,70,0,1,0,1,0
60775,445,0,0,drop,70,70,0,1,0,1,0
58962,23,0,0,deny,60,60,0,1,0,1,0
49234,445,0,0,drop,70,70,0,1,0,1,0
49232,445,0,0,drop,70,70,0,1,0,1,0
49230,445,0,0,drop,70,70,0,1,0,1,0
61009,445,0,0,drop,66,66,0,1,0,1,0
49227,445,0,0,drop,70,70,0,1,0,1,0
61006,445,0,0,drop,66,66,0,1,0,1,0
61004,445,0,0,drop,66,66,0,1,0,1,0
61002,445,0,0,drop,66,66,0,1,0,1,0
60771,445,0,0,drop,70,70,0,1,0,1,0
61001,445,0,0,drop,66,66,0,1,0,1,0
60761,445,0,0,drop,70,70,0,1,0,1,0
60760,445,0,0,drop,70,70,0,1,0,1,0
60762,445,0,0,drop,70,70,0,1,0,1,0
60756,445,0,0,drop,70,70,0,1,0,1,0
60754,445,0,0,drop,70,70,0,1,0,1,0
49214,445,0,0,drop,70,70,0,1,0,1,0
60989,445,0,0,drop,66,66,0,1,0,1,0
60748,445,0,0,drop,70,70,0,1,0,1,0
60982,445,0,0,drop,66,66,0,1,0,1,0
49182,445,0,0,drop,70,70,0,1,0,1,0
60740,445,0,0,drop,70,70,0,1,0,1,0
60738,445,0,0,drop,70,70,0,1,0,1,0
60979,445,0,0,drop,66,66,0,1,0,1,0
60734,445,0,0,drop,70,70,0,1,0,1,0
60970,445,0,0,drop,66,66,0,1,0,1,0
60732,445,0,0,drop,70,70,0,1,0,1,0
60969,445,0,0,drop,66,66,0,1,0,1,0
60728,445,0,0,drop,70,70,0,1,0,1,0
60727,445,0,0,drop,70,70,0,1,0,1,0
49168,445,0,0,drop,70,70,0,1,0,1,0
49170,445,0,0,drop,70,70,0,1,0,1,0
60949,445,0,0,drop,66,66,0,1,0,1,0
60956,445,0,0,drop,66,66,0,1,0,1,0
60951,445,0,0,drop,66,66,0,1,0,1,0
60953,445,0,0,drop,66,66,0,1,0,1,0
60955,445,0,0,drop,66,66,0,1,0,1,0
60954,445,0,0,drop,66,66,0,1,0,1,0
60952,445,0,0,drop,66,66,0,1,0,1,0
60948,445,0,0,drop,66,66,0,1,0,1,0
60722,445,0,0,drop,70,70,0,1,0,1,0
49166,445,0,0,drop,70,70,0,1,0,1,0
49163,445,0,0,drop,70,70,0,1,0,1,0
65528,445,0,0,drop,70,70,0,1,0,1,0
65526,445,0,0,drop,70,70,0,1,0,1,0
60933,445,0,0,drop,66,66,0,1,0,1,0
60936,445,0,0,drop,66,66,0,1,0,1,0
60934,445,0,0,drop,66,66,0,1,0,1,0
60709,445,0,0,drop,70,70,0,1,0,1,0
65522,445,0,0,drop,70,70,0,1,0,1,0
65515,445,0,0,drop,70,70,0,1,0,1,0
60706,445,0,0,drop,70,70,0,1,0,1,0
60701,445,0,0,drop,70,70,0,1,0,1,0
60700,445,0,0,drop,70,70,0,1,0,1,0
65502,445,0,0,drop,70,70,0,1,0,1,0
65501,445,0,0,drop,70,70,0,1,0,1,0
65498,445,0,0,drop,70,70,0,1,0,1,0
60698,445,0,0,drop,70,70,0,1,0,1,0
60922,445,0,0,drop,66,66,0,1,0,1,0
41730,443,24945,443,allow,760,422,338,12,28,7,5
40970,80,47105,80,allow,1052,612,440,10,15,5,5
40858,53,40858,53,allow,200,90,110,2,30,1,1
56783,53,3501,53,allow,186,95,91,2,30,1,1
56419,53,8331,53,allow,198,101,97,2,30,1,1
56101,53,1484,53,allow,188,96,92,2,40,1,1
38504,443,56099,443,allow,2227,1018,1209,17,15,8,9
56014,53,32746,53,allow,711,87,624,2,30,1,1
39058,443,50860,443,allow,70,70,0,1,5,1,0
39057,443,14567,443,allow,70,70,0,1,5,1,0
49662,53,40322,53,allow,268,93,175,4,58,2,2
58890,53,0,0,allow,180,82,98,2,31,1,1
60691,445,0,0,drop,70,70,0,1,0,1,0
47773,53,42715,53,allow,236,86,150,2,30,1,1
53794,53,8818,53,allow,260,86,174,2,30,1,1
60689,445,0,0,drop,70,70,0,1,0,1,0
60688,445,0,0,drop,70,70,0,1,0,1,0
60908,445,0,0,drop,66,66,0,1,0,1,0
60904,445,0,0,drop,66,66,0,1,0,1,0
60687,445,0,0,drop,70,70,0,1,0,1,0
60686,445,0,0,drop,70,70,0,1,0,1,0
60681,445,0,0,drop,70,70,0,1,0,1,0
60680,445,0,0,drop,70,70,0,1,0,1,0
65484,445,0,0,drop,70,70,0,1,0,1,0
60668,445,0,0,drop,70,70,0,1,0,1,0
60666,445,0,0,drop,70,70,0,1,0,1,0
65479,445,0,0,drop,70,70,0,1,0,1,0
65472,445,0,0,drop,70,70,0,1,0,1,0
60665,445,0,0,drop,70,70,0,1,0,1,0
60900,445,0,0,drop,66,66,0,1,0,1,0
60658,445,0,0,drop,70,70,0,1,0,1,0
60657,445,0,0,drop,70,70,0,1,0,1,0
60897,445,0,0,drop,66,66,0,1,0,1,0
49662,53,17327,53,allow,268,93,175,4,57,2,2
59933,80,46618,80,allow,1756,414,1342,12,15,6,6
65332,53,55664,53,allow,94,94,0,1,30,1,0
51534,443,19846,443,allow,262,70,192,5,21,2,3
49682,53,35686,53,allow,341,110,231,2,29,1,1
56419,53,27801,53,allow,199,102,97,2,30,1,1
37148,53,21111,53,allow,164,78,86,2,30,1,1
63954,53,25119,53,allow,352,102,250,2,29,1,1
56382,53,40376,53,allow,195,102,93,2,29,1,1
56917,53,8537,53,allow,424,104,320,4,30,2,2
56419,53,51375,53,allow,199,102,97,2,30,1,1
56261,53,26001,53,allow,184,94,90,2,29,1,1
56119,53,14584,53,allow,199,102,97,2,33,1,1
64539,53,38642,53,allow,276,126,150,2,30,1,1
64561,53,25485,53,allow,270,94,176,2,30,1,1
55548,53,39542,53,allow,197,102,95,2,35,1,1
49912,53,25675,53,allow,246,102,144,2,30,1,1
55281,53,62349,53,allow,94,94,0,1,30,1,0
64811,53,63660,53,allow,446,93,353,4,55,2,2
55972,53,37415,53,allow,699,438,261,2,30,1,1
40207,80,3053,80,allow,1364,860,504,13,32,8,5
49219,53,24039,53,allow,264,102,162,2,30,1,1
60093,443,38976,443,allow,292,172,120,4,15,2,2
51547,443,7780,443,allow,202,70,132,3,11,1,2
51538,443,33433,443,allow,262,70,192,5,21,2,3
64819,53,53319,53,allow,198,94,104,2,30,1,1
56119,53,4548,53,allow,199,102,97,2,30,1,1
64660,53,61374,53,allow,278,94,184,2,30,1,1
64924,53,49056,53,allow,292,126,166,2,30,1,1
65269,53,14472,53,allow,237,94,143,2,30,1,1
64121,443,64564,443,allow,1411,852,559,13,24,7,6
53787,1,62839,1,allow,320,140,180,6,6,3,3
55475,53,3330,53,allow,381,102,279,4,44,2,2
53795,53,11623,53,allow,224,86,138,2,30,1,1
64127,53,10956,53,allow,471,182,289,6,57,3,3
59722,443,18746,443,allow,70,70,0,2,5,2,0
51539,443,19176,443,allow,262,70,192,5,21,2,3
49419,443,41592,443,allow,318,192,126,6,15,4,2
55014,80,6896,80,allow,1573,1145,428,13,32,8,5
56783,53,7045,53,allow,193,102,91,2,30,1,1
65444,53,15259,53,allow,86,86,0,1,30,1,0
55747,53,24250,53,allow,258,102,156,2,30,1,1
55377,53,7280,53,allow,164,78,86,2,30,1,1
64119,53,14375,53,allow,259,102,157,2,30,1,1
65511,53,1627,53,allow,212,102,110,2,30,1,1
57240,53,57857,53,allow,215,94,121,2,30,1,1
49222,53,15691,53,allow,199,94,105,2,30,1,1
49418,443,14696,443,allow,318,192,126,6,16,4,2
50025,53,20225,53,allow,215,94,121,2,30,1,1
64615,53,13915,53,allow,386,134,252,2,30,1,1
64726,53,22205,53,allow,231,94,137,2,30,1,1
49604,53,53151,53,allow,179,94,85,2,30,1,1
49512,53,64595,53,allow,210,102,108,2,30,1,1
49289,53,50733,53,allow,322,118,204,2,30,1,1
60896,445,0,0,drop,66,66,0,1,0,1,0
60895,445,0,0,drop,66,66,0,1,0,1,0
60894,445,0,0,drop,66,66,0,1,0,1,0
60891,445,0,0,drop,66,66,0,1,0,1,0
60887,445,0,0,drop,66,66,0,1,0,1,0
60885,445,0,0,drop,66,66,0,1,0,1,0
65470,445,0,0,drop,70,70,0,1,0,1,0
65465,445,0,0,drop,70,70,0,1,0,1,0
65463,445,0,0,drop,70,70,0,1,0,1,0
40598,23,0,0,deny,60,60,0,1,0,1,0
60646,445,0,0,drop,70,70,0,1,0,1,0
65460,445,0,0,drop,70,70,0,1,0,1,0
65459,445,0,0,drop,70,70,0,1,0,1,0
60879,445,0,0,drop,66,66,0,1,0,1,0
65452,445,0,0,drop,70,70,0,1,0,1,0
60641,445,0,0,drop,70,70,0,1,0,1,0
60876,445,0,0,drop,66,66,0,1,0,1,0
60873,445,0,0,drop,66,66,0,1,0,1,0
60874,445,0,0,drop,66,66,0,1,0,1,0
60872,445,0,0,drop,66,66,0,1,0,1,0
60632,445,0,0,drop,70,70,0,1,0,1,0
60633,445,0,0,drop,70,70,0,1,0,1,0
60631,445,0,0,drop,70,70,0,1,0,1,0
60628,445,0,0,drop,70,70,0,1,0,1,0
60625,445,0,0,drop,70,70,0,1,0,1,0
65437,445,0,0,drop,70,70,0,1,0,1,0
60861,445,0,0,drop,66,66,0,1,0,1,0
64104,53,45169,53,allow,288,101,187,4,28,2,2
60619,445,0,0,drop,70,70,0,1,0,1,0
60853,445,0,0,drop,66,66,0,1,0,1,0
60612,445,0,0,drop,70,70,0,1,0,1,0
65424,445,0,0,drop,70,70,0,1,0,1,0
60609,445,0,0,drop,70,70,0,1,0,1,0
44344,23,0,0,deny,60,60,0,1,0,1,0
60851,445,0,0,drop,66,66,0,1,0,1,0
60606,445,0,0,drop,70,70,0,1,0,1,0
60604,445,0,0,drop,70,70,0,1,0,1,0
60842,445,0,0,drop,66,66,0,1,0,1,0
60839,445,0,0,drop,66,66,0,1,0,1,0
60600,445,0,0,drop,70,70,0,1,0,1,0
60599,445,0,0,drop,70,70,0,1,0,1,0
65415,445,0,0,drop,70,70,0,1,0,1,0
60822,445,0,0,drop,66,66,0,1,0,1,0
60828,445,0,0,drop,66,66,0,1,0,1,0
60825,445,0,0,drop,66,66,0,1,0,1,0
60826,445,0,0,drop,66,66,0,1,0,1,0
60823,445,0,0,drop,66,66,0,1,0,1,0
60821,445,0,0,drop,66,66,0,1,0,1,0
60824,445,0,0,drop,66,66,0,1,0,1,0
60820,445,0,0,drop,66,66,0,1,0,1,0
60594,445,0,0,drop,70,70,0,1,0,1,0
65406,445,0,0,drop,70,70,0,1,0,1,0
65404,445,0,0,drop,70,70,0,1,0,1,0
65405,445,0,0,drop,70,70,0,1,0,1,0
65396,445,0,0,drop,70,70,0,1,0,1,0
60807,445,0,0,drop,66,66,0,1,0,1,0
60806,445,0,0,drop,66,66,0,1,0,1,0
60805,445,0,0,drop,66,66,0,1,0,1,0
60581,445,0,0,drop,70,70,0,1,0,1,0
60578,445,0,0,drop,70,70,0,1,0,1,0
65390,445,0,0,drop,70,70,0,1,0,1,0
65385,445,0,0,drop,70,70,0,1,0,1,0
56168,53,62337,53,allow,745,93,652,2,30,1,1
43708,53,62627,53,allow,168,78,90,2,30,1,1
55427,53,54288,53,allow,200,102,98,2,30,1,1
57388,53,36277,53,allow,732,89,643,2,30,1,1
57326,53,28871,53,allow,90,90,0,1,30,1,0
47820,443,39799,443,allow,1132,596,536,17,28,9,8
58507,80,58507,80,allow,348,132,216,6,26,3,3
55840,53,9224,53,allow,170,87,83,2,30,1,1
50288,53,0,0,allow,82,82,0,1,30,1,0
56501,53,62547,53,allow,711,87,624,2,31,1,1
64116,53,59357,53,allow,87,87,0,1,31,1,0
56629,53,58033,53,allow,182,93,89,2,30,1,1
64980,53,39962,53,allow,90,90,0,1,31,1,0
41937,53,0,0,allow,82,82,0,1,31,1,0
60574,445,0,0,drop,70,70,0,1,0,1,0
60572,445,0,0,drop,70,70,0,1,0,1,0
60570,445,0,0,drop,70,70,0,1,0,1,0
65372,445,0,0,drop,70,70,0,1,0,1,0
49236,53,51973,53,allow,377,94,283,2,30,1,1
65368,445,0,0,drop,70,70,0,1,0,1,0
60794,445,0,0,drop,66,66,0,1,0,1,0
60563,445,0,0,drop,70,70,0,1,0,1,0
60560,445,0,0,drop,70,70,0,1,0,1,0
60559,445,0,0,drop,70,70,0,1,0,1,0
60558,445,0,0,drop,70,70,0,1,0,1,0
60557,445,0,0,drop,70,70,0,1,0,1,0
60555,445,0,0,drop,70,70,0,1,0,1,0
60554,445,0,0,drop,70,70,0,1,0,1,0
60777,445,0,0,drop,66,66,0,1,0,1,0
60778,445,0,0,drop,66,66,0,1,0,1,0
48080,22,0,0,deny,60,60,0,1,0,1,0
60539,445,0,0,drop,70,70,0,1,0,1,0
60537,445,0,0,drop,70,70,0,1,0,1,0
60536,445,0,0,drop,70,70,0,1,0,1,0
65357,445,0,0,drop,70,70,0,1,0,1,0
60528,445,0,0,drop,70,70,0,1,0,1,0
60529,445,0,0,drop,70,70,0,1,0,1,0
65344,445,0,0,drop,70,70,0,1,0,1,0
65347,445,0,0,drop,70,70,0,1,0,1,0
65343,445,0,0,drop,70,70,0,1,0,1,0
60774,445,0,0,drop,66,66,0,1,0,1,0
60757,445,0,0,drop,66,66,0,1,0,1,0
65404,53,13922,53,allow,256,94,162,2,30,1,1
62071,443,12103,443,allow,134,60,74,3,4,2,1
55548,53,2209,53,allow,197,102,95,2,29,1,1
55027,53,44978,53,allow,177,94,83,2,29,1,1
56056,53,42855,53,allow,164,86,78,2,29,1,1
58554,80,58554,80,allow,348,132,216,6,26,3,3
65514,53,61722,53,allow,291,98,193,4,33,2,2
56629,53,53878,53,allow,183,94,89,2,30,1,1
65438,53,17432,53,allow,332,94,238,2,29,1,1
56056,53,12861,53,allow,172,94,78,2,29,1,1
55840,53,55617,53,allow,177,94,83,2,30,1,1
64730,53,52714,53,allow,1152,86,1066,2,29,1,1
54496,53,1798,53,allow,164,86,78,2,29,1,1
64703,53,47599,53,allow,306,142,164,2,30,1,1
49432,53,61997,53,allow,312,94,218,2,30,1,1
42894,443,60082,443,allow,448,78,370,6,25,1,5
56541,53,2371,53,allow,294,142,152,2,30,1,1
40386,443,23622,443,allow,600,156,444,8,25,2,6
56629,53,25209,53,allow,183,94,89,2,30,1,1
48575,123,43562,123,allow,184,94,90,2,30,1,1
55840,53,28820,53,allow,177,94,83,2,30,1,1
60848,53,46740,53,allow,168,78,90,2,30,1,1
54269,53,35881,53,allow,86,86,0,1,30,1,0
38274,443,9313,443,allow,600,156,444,8,25,2,6
64638,53,19660,53,allow,397,102,295,2,30,1,1
44519,443,58426,443,allow,716,428,288,11,26,7,4
56652,80,38597,80,allow,234,234,0,4,12,4,0
64665,53,55262,53,allow,181,94,87,2,31,1,1
42895,443,18411,443,allow,600,156,444,8,25,2,6
55027,53,14460,53,allow,177,94,83,2,29,1,1
56379,53,17881,53,allow,94,94,0,1,29,1,0
50380,53,4521,53,allow,737,94,643,2,29,1,1
49604,53,54196,53,allow,179,94,85,2,29,1,1
42892,443,39711,443,allow,448,78,370,6,25,1,5
55323,53,29422,53,allow,279,94,185,2,30,1,1
56058,53,33400,53,allow,200,94,106,2,30,1,1
56219,53,57925,53,allow,177,94,83,2,30,1,1
64642,53,2609,53,allow,307,94,213,2,30,1,1
64116,53,59887,53,allow,177,94,83,2,31,1,1
38278,443,39999,443,allow,448,78,370,6,25,1,5
55840,53,8081,53,allow,177,94,83,2,30,1,1
49772,80,38136,80,allow,70,70,0,2,8,2,0
38276,443,11817,443,allow,600,156,444,8,25,2,6
38275,443,49031,443,allow,448,78,370,6,25,1,5
65216,53,41251,53,allow,292,94,198,2,30,1,1
60399,123,27117,123,allow,184,94,90,2,30,1,1
64310,53,12682,53,allow,404,102,302,2,30,1,1
56586,53,33852,53,allow,177,94,83,2,31,1,1
56219,53,60572,53,allow,177,94,83,2,30,1,1
60762,445,0,0,drop,66,66,0,1,0,1,0
60763,445,0,0,drop,66,66,0,1,0,1,0
60768,445,0,0,drop,66,66,0,1,0,1,0
60764,445,0,0,drop,66,66,0,1,0,1,0
60765,445,0,0,drop,66,66,0,1,0,1,0
60756,445,0,0,drop,66,66,0,1,0,1,0
65339,445,0,0,drop,70,70,0,1,0,1,0
65337,445,0,0,drop,70,70,0,1,0,1,0
65335,445,0,0,drop,70,70,0,1,0,1,0
60517,445,0,0,drop,70,70,0,1,0,1,0
60513,445,0,0,drop,70,70,0,1,0,1,0
65330,445,0,0,drop,70,70,0,1,0,1,0
65329,445,0,0,drop,70,70,0,1,0,1,0
47827,67,0,0,deny,60,60,0,1,0,1,0
60752,445,0,0,drop,66,66,0,1,0,1,0
65324,445,0,0,drop,70,70,0,1,0,1,0
60748,445,0,0,drop,66,66,0,1,0,1,0
60502,445,0,0,drop,70,70,0,1,0,1,0
60501,445,0,0,drop,70,70,0,1,0,1,0
60504,445,0,0,drop,70,70,0,1,0,1,0
60746,445,0,0,drop,66,66,0,1,0,1,0
60745,445,0,0,drop,66,66,0,1,0,1,0
60499,445,0,0,drop,70,70,0,1,0,1,0
60743,445,0,0,drop,66,66,0,1,0,1,0
60496,445,0,0,drop,70,70,0,1,0,1,0
65312,445,0,0,drop,70,70,0,1,0,1,0
60491,445,0,0,drop,70,70,0,1,0,1,0
60731,445,0,0,drop,66,66,0,1,0,1,0
60483,445,0,0,drop,70,70,0,1,0,1,0
60481,445,0,0,drop,70,70,0,1,0,1,0
60724,445,0,0,drop,66,66,0,1,0,1,0
65299,445,0,0,drop,70,70,0,1,0,1,0
49734,23,0,0,deny,60,60,0,1,0,1,0
60477,445,0,0,drop,70,70,0,1,0,1,0
60722,445,0,0,drop,66,66,0,1,0,1,0
60475,445,0,0,drop,70,70,0,1,0,1,0
60714,445,0,0,drop,66,66,0,1,0,1,0
60471,445,0,0,drop,70,70,0,1,0,1,0
60710,445,0,0,drop,66,66,0,1,0,1,0
60470,445,0,0,drop,70,70,0,1,0,1,0
65286,445,0,0,drop,70,70,0,1,0,1,0
60465,445,0,0,drop,70,70,0,1,0,1,0
60696,445,0,0,drop,66,66,0,1,0,1,0
60699,445,0,0,drop,66,66,0,1,0,1,0
60695,445,0,0,drop,66,66,0,1,0,1,0
60692,445,0,0,drop,66,66,0,1,0,1,0
60697,445,0,0,drop,66,66,0,1,0,1,0
60698,445,0,0,drop,66,66,0,1,0,1,0
60693,445,0,0,drop,66,66,0,1,0,1,0
60691,445,0,0,drop,66,66,0,1,0,1,0
50626,80,27963,80,allow,1366,865,501,8,15,5,3
55098,53,8835,53,allow,176,90,86,2,30,1,1
58734,443,48413,443,allow,1413,876,537,12,26,6,6
55835,53,7338,53,allow,176,90,86,2,31,1,1
49846,53,37794,53,allow,763,101,662,2,31,1,1
40039,80,11580,80,allow,1112,534,578,12,16,7,5
56586,53,23269,53,allow,170,87,83,2,30,1,1
56024,53,53250,53,allow,711,87,624,2,30,1,1
58735,443,63211,443,allow,1413,876,537,12,26,6,6
65283,445,0,0,drop,70,70,0,1,0,1,0
65274,445,0,0,drop,70,70,0,1,0,1,0
65276,445,0,0,drop,70,70,0,1,0,1,0
65269,445,0,0,drop,70,70,0,1,0,1,0
60452,445,0,0,drop,70,70,0,1,0,1,0
60678,445,0,0,drop,66,66,0,1,0,1,0
60677,445,0,0,drop,66,66,0,1,0,1,0
60675,445,0,0,drop,66,66,0,1,0,1,0
60449,445,0,0,drop,70,70,0,1,0,1,0
65265,445,0,0,drop,70,70,0,1,0,1,0
65253,445,0,0,drop,70,70,0,1,0,1,0
65254,445,0,0,drop,70,70,0,1,0,1,0
60444,445,0,0,drop,70,70,0,1,0,1,0
60443,445,0,0,drop,70,70,0,1,0,1,0
60441,445,0,0,drop,70,70,0,1,0,1,0
56494,1,0,0,deny,146,146,0,1,0,1,0
65245,445,0,0,drop,70,70,0,1,0,1,0
65242,445,0,0,drop,70,70,0,1,0,1,0
60665,445,0,0,drop,66,66,0,1,0,1,0
60434,445,0,0,drop,70,70,0,1,0,1,0
60431,445,0,0,drop,70,70,0,1,0,1,0
60430,445,0,0,drop,70,70,0,1,0,1,0
65237,445,0,0,drop,70,70,0,1,0,1,0
60429,445,0,0,drop,70,70,0,1,0,1,0
60423,445,0,0,drop,70,70,0,1,0,1,0
60424,445,0,0,drop,70,70,0,1,0,1,0
55206,53,49621,53,allow,196,94,102,2,30,1,1
64988,53,16723,53,allow,196,94,102,2,30,1,1
53238,80,59852,80,allow,1726,940,786,8,55,5,3
36100,443,53812,443,allow,812,440,372,14,25,8,6
63937,53,8865,53,allow,183,94,89,2,30,1,1
56367,53,12261,53,allow,900,110,790,2,29,1,1
56405,53,42424,53,allow,226,102,124,2,30,1,1
56184,53,63317,53,allow,215,94,121,2,30,1,1
55835,53,25257,53,allow,180,94,86,2,30,1,1
49932,53,2052,53,allow,289,94,195,2,30,1,1
50522,443,6531,443,allow,1579,988,591,13,45,7,6
60438,53,9919,53,allow,77,77,0,2,31,2,0
59758,53,7104,53,allow,211,78,133,2,30,1,1
64648,53,9787,53,allow,215,94,121,2,30,1,1
52295,53,54282,53,allow,322,102,220,2,30,1,1
57303,53,6094,53,allow,177,94,83,2,30,1,1
61637,53,32273,53,allow,82,82,0,2,31,2,0
57159,53,30985,53,allow,292,94,198,2,30,1,1
57303,53,43423,53,allow,177,94,83,2,30,1,1
55835,53,39257,53,allow,180,94,86,2,30,1,1
55243,53,43461,53,allow,356,118,238,2,30,1,1
62995,53,59527,53,allow,101,101,0,2,31,2,0
65355,53,22974,53,allow,321,102,219,2,30,1,1
53791,53,14073,53,allow,102,102,0,2,31,2,0
54553,53,43102,53,allow,101,101,0,2,31,2,0
50523,443,11789,443,allow,1579,988,591,13,45,7,6
55305,53,15624,53,allow,88,88,0,2,31,2,0
53237,80,8152,80,allow,194,128,66,4,55,3,1
56629,53,45116,53,allow,183,94,89,2,29,1,1
55318,53,29370,53,allow,215,102,113,2,30,1,1
49988,443,8213,443,allow,642,582,60,2,5,1,1
52993,53,60182,53,allow,70,70,0,1,29,1,0
57152,53,56256,53,allow,720,94,626,2,30,1,1
55098,53,14805,53,allow,180,94,86,2,30,1,1
49153,53,32682,53,allow,214,102,112,2,29,1,1
59757,53,47514,53,allow,260,86,174,2,30,1,1
64199,53,4669,53,allow,215,102,113,2,30,1,1
56586,53,39065,53,allow,177,94,83,2,30,1,1
56621,53,30051,53,allow,177,94,83,2,31,1,1
53434,53,34860,53,allow,87,87,0,2,31,2,0
49983,53,19113,53,allow,267,110,157,2,30,1,1
64406,53,8536,53,allow,102,102,0,2,31,2,0
64714,53,5629,53,allow,250,86,164,4,36,2,2
65183,53,12672,53,allow,381,89,292,4,43,2,2
64201,53,54602,53,allow,434,96,338,4,30,2,2
54267,53,33061,53,allow,86,86,0,1,30,1,0
61566,53,28325,53,allow,86,86,0,1,30,1,0
54983,53,35853,53,allow,728,102,626,2,30,1,1
56654,53,54903,53,allow,102,102,0,2,31,2,0
65466,53,31281,53,allow,200,102,98,2,33,1,1
49771,53,61386,53,allow,86,86,0,1,30,1,0
49165,53,19244,53,allow,379,94,285,2,30,1,1
64505,53,53732,53,allow,388,134,254,2,30,1,1
57189,53,13765,53,allow,78,78,0,1,30,1,0
56621,53,19745,53,allow,177,94,83,2,30,1,1
55445,53,54858,53,allow,96,96,0,2,31,2,0
55199,53,62103,53,allow,196,94,102,2,30,1,1
63937,53,33435,53,allow,183,94,89,2,30,1,1
56075,53,1883,53,allow,215,102,113,2,30,1,1
56020,53,51205,53,allow,199,102,97,2,32,1,1
55225,53,24302,53,allow,199,102,97,2,30,1,1
55225,53,48958,53,allow,822,102,720,2,30,1,1
60649,445,0,0,drop,66,66,0,1,0,1,0
60648,445,0,0,drop,66,66,0,1,0,1,0
60411,445,0,0,drop,70,70,0,1,0,1,0
60410,445,0,0,drop,70,70,0,1,0,1,0
60408,445,0,0,drop,70,70,0,1,0,1,0
60401,445,0,0,drop,70,70,0,1,0,1,0
60400,445,0,0,drop,70,70,0,1,0,1,0
65219,445,0,0,drop,70,70,0,1,0,1,0
65220,445,0,0,drop,70,70,0,1,0,1,0
65216,445,0,0,drop,70,70,0,1,0,1,0
60644,445,0,0,drop,66,66,0,1,0,1,0
60633,445,0,0,drop,66,66,0,1,0,1,0
60636,445,0,0,drop,66,66,0,1,0,1,0
60635,445,0,0,drop,66,66,0,1,0,1,0
60634,445,0,0,drop,66,66,0,1,0,1,0
60630,445,0,0,drop,66,66,0,1,0,1,0
60632,445,0,0,drop,66,66,0,1,0,1,0
60629,445,0,0,drop,66,66,0,1,0,1,0
65211,445,0,0,drop,70,70,0,1,0,1,0
60389,445,0,0,drop,70,70,0,1,0,1,0
65209,445,0,0,drop,70,70,0,1,0,1,0
60385,445,0,0,drop,70,70,0,1,0,1,0
65204,445,0,0,drop,70,70,0,1,0,1,0
65202,445,0,0,drop,70,70,0,1,0,1,0
60621,445,0,0,drop,66,66,0,1,0,1,0
60375,445,0,0,drop,70,70,0,1,0,1,0
60376,445,0,0,drop,70,70,0,1,0,1,0
60374,445,0,0,drop,70,70,0,1,0,1,0
65196,445,0,0,drop,70,70,0,1,0,1,0
60372,445,0,0,drop,70,70,0,1,0,1,0
60619,445,0,0,drop,66,66,0,1,0,1,0
60368,445,0,0,drop,70,70,0,1,0,1,0
60617,445,0,0,drop,66,66,0,1,0,1,0
60616,445,0,0,drop,66,66,0,1,0,1,0
60614,445,0,0,drop,66,66,0,1,0,1,0
65184,445,0,0,drop,70,70,0,1,0,1,0
65179,445,0,0,drop,70,70,0,1,0,1,0
60362,445,0,0,drop,70,70,0,1,0,1,0
60603,445,0,0,drop,66,66,0,1,0,1,0
60355,445,0,0,drop,70,70,0,1,0,1,0
60354,445,0,0,drop,70,70,0,1,0,1,0
60595,445,0,0,drop,66,66,0,1,0,1,0
65171,445,0,0,drop,70,70,0,1,0,1,0
60349,445,0,0,drop,70,70,0,1,0,1,0
60347,445,0,0,drop,70,70,0,1,0,1,0
60593,445,0,0,drop,66,66,0,1,0,1,0
60343,445,0,0,drop,70,70,0,1,0,1,0
60584,445,0,0,drop,66,66,0,1,0,1,0
60342,445,0,0,drop,70,70,0,1,0,1,0
60575,445,0,0,drop,66,66,0,1,0,1,0
56281,53,50630,53,allow,170,87,83,2,31,1,1
55624,53,27462,53,allow,701,88,613,2,30,1,1
49270,53,43465,53,allow,216,110,106,2,30,1,1
49270,53,27956,53,allow,216,110,106,2,31,1,1
63937,53,56505,53,allow,182,93,89,2,30,1,1
50583,53,30118,53,allow,783,96,687,2,30,1,1
55071,53,28115,53,allow,711,87,624,2,30,1,1
55307,53,50101,53,allow,1415,101,1314,4,51,2,2
60165,80,45319,80,allow,1982,692,1290,8,15,5,3
56621,53,42291,53,allow,170,87,83,2,30,1,1
56119,53,42460,53,allow,198,101,97,2,30,1,1
50319,53,41804,53,allow,188,96,92,2,31,1,1
56138,53,1894,53,allow,783,96,687,2,31,1,1
52426,53,52426,53,allow,310,94,216,2,31,1,1
55563,53,56094,53,allow,188,96,92,2,31,1,1
55021,53,4080,53,allow,174,89,85,2,31,1,1
60337,445,0,0,drop,70,70,0,1,0,1,0
65158,445,0,0,drop,70,70,0,1,0,1,0
60568,445,0,0,drop,66,66,0,1,0,1,0
60561,445,0,0,drop,66,66,0,1,0,1,0
60569,445,0,0,drop,66,66,0,1,0,1,0
60566,445,0,0,drop,66,66,0,1,0,1,0
60563,445,0,0,drop,66,66,0,1,0,1,0
60565,445,0,0,drop,66,66,0,1,0,1,0
60564,445,0,0,drop,66,66,0,1,0,1,0
60324,445,0,0,drop,70,70,0,1,0,1,0
65155,445,0,0,drop,70,70,0,1,0,1,0
65153,445,0,0,drop,70,70,0,1,0,1,0
49270,53,46560,53,allow,322,110,212,4,30,2,2
65146,445,0,0,drop,70,70,0,1,0,1,0
65143,445,0,0,drop,70,70,0,1,0,1,0
60549,445,0,0,drop,66,66,0,1,0,1,0
60548,445,0,0,drop,66,66,0,1,0,1,0
60546,445,0,0,drop,66,66,0,1,0,1,0
53902,67,0,0,deny,60,60,0,1,0,1,0
60319,445,0,0,drop,70,70,0,1,0,1,0
65136,445,0,0,drop,70,70,0,1,0,1,0
65134,445,0,0,drop,70,70,0,1,0,1,0
56281,53,4042,53,allow,177,94,83,2,30,1,1
53721,443,6188,443,allow,70,70,0,1,4,1,0
55835,53,15423,53,allow,180,94,86,2,29,1,1
56020,53,34140,53,allow,199,102,97,2,29,1,1
57350,53,53074,53,allow,257,94,163,2,30,1,1
47495,443,53611,443,allow,490,210,280,8,28,4,4
60572,80,35245,80,allow,556,280,276,9,28,5,4
63937,53,1528,53,allow,183,94,89,2,29,1,1
64919,53,28952,53,allow,199,102,97,2,29,1,1
64919,53,63713,53,allow,822,102,720,2,29,1,1
56586,53,17774,53,allow,177,94,83,2,29,1,1
57438,53,26523,53,allow,340,110,230,2,29,1,1
65514,53,51532,53,allow,177,94,83,2,30,1,1
50288,80,24804,80,allow,2032,600,1432,10,45,6,4
49270,53,44798,53,allow,216,110,106,2,30,1,1
49264,80,49264,80,allow,698,366,332,12,44,7,5
55862,53,15902,53,allow,177,94,83,2,30,1,1
64170,53,8544,53,allow,355,118,237,2,30,1,1
56119,53,10048,53,allow,199,102,97,2,33,1,1
53858,53,53858,53,allow,832,106,726,2,30,1,1
36754,443,35340,443,allow,1320,822,498,16,41,9,7
45350,443,10693,443,allow,918,358,560,14,40,6,8
56650,80,32144,80,allow,234,234,0,4,12,4,0
64984,53,22465,53,allow,177,94,83,2,30,1,1
55289,53,47764,53,allow,446,94,352,4,44,2,2
58718,443,59357,443,allow,1129,599,530,12,25,6,6
65321,53,63779,53,allow,283,103,180,4,54,2,2
59433,53,26803,53,allow,218,78,140,2,29,1,1
49886,53,25717,53,allow,275,94,181,2,30,1,1
55862,53,22118,53,allow,177,94,83,2,30,1,1
57113,53,7922,53,allow,215,102,113,2,30,1,1
49256,53,15315,53,allow,212,102,110,2,30,1,1
56621,53,63745,53,allow,177,94,83,2,29,1,1
45099,123,62953,123,allow,184,94,90,2,30,1,1
50319,53,7471,53,allow,194,102,92,2,30,1,1
49741,53,12587,53,allow,211,102,109,2,30,1,1
55958,53,14478,53,allow,212,102,110,2,30,1,1
50319,53,65506,53,allow,194,102,92,2,30,1,1
64917,53,19019,53,allow,718,94,624,2,30,1,1
64984,53,54223,53,allow,177,94,83,2,30,1,1
50287,53,47633,53,allow,177,94,83,2,30,1,1
56281,53,7565,53,allow,177,94,83,2,30,1,1
63941,80,15778,80,allow,314,192,122,6,15,4,2
47130,80,63322,80,allow,613,539,74,7,15,6,1
43865,443,4892,443,allow,560,280,280,9,26,5,4
64642,53,25504,53,allow,718,94,624,2,30,1,1
50287,53,45385,53,allow,177,94,83,2,30,1,1
49173,53,47440,53,allow,234,94,140,2,30,1,1
55563,53,47239,53,allow,194,102,92,2,31,1,1
56281,53,38618,53,allow,177,94,83,2,31,1,1
56388,443,34459,443,allow,70,70,0,1,5,1,0
59928,53,64195,53,allow,168,78,90,2,30,1,1
58744,53,27095,53,allow,368,86,282,2,30,1,1
50140,53,14261,53,allow,177,94,83,2,30,1,1
56578,53,41828,53,allow,219,86,133,2,31,1,1
64113,53,33491,53,allow,294,134,160,2,30,1,1
56056,53,19190,53,allow,184,86,98,2,30,1,1
60442,53,50367,53,allow,184,78,106,2,30,1,1
65133,445,0,0,drop,70,70,0,1,0,1,0
65125,445,0,0,drop,70,70,0,1,0,1,0
60315,445,0,0,drop,70,70,0,1,0,1,0
60313,445,0,0,drop,70,70,0,1,0,1,0
60311,445,0,0,drop,70,70,0,1,0,1,0
65118,445,0,0,drop,70,70,0,1,0,1,0
65112,445,0,0,drop,70,70,0,1,0,1,0
65114,445,0,0,drop,70,70,0,1,0,1,0
60304,445,0,0,drop,70,70,0,1,0,1,0
60537,445,0,0,drop,66,66,0,1,0,1,0
60302,445,0,0,drop,70,70,0,1,0,1,0
60301,445,0,0,drop,70,70,0,1,0,1,0
60300,445,0,0,drop,70,70,0,1,0,1,0
60299,445,0,0,drop,70,70,0,1,0,1,0
60297,445,0,0,drop,70,70,0,1,0,1,0
60295,445,0,0,drop,70,70,0,1,0,1,0
65110,445,0,0,drop,70,70,0,1,0,1,0
60281,445,0,0,drop,70,70,0,1,0,1,0
60280,445,0,0,drop,70,70,0,1,0,1,0
53856,443,18832,443,allow,495,421,74,4,0,3,1
60521,445,0,0,drop,66,66,0,1,0,1,0
60520,445,0,0,drop,66,66,0,1,0,1,0
60278,445,0,0,drop,70,70,0,1,0,1,0
60271,445,0,0,drop,70,70,0,1,0,1,0
60270,445,0,0,drop,70,70,0,1,0,1,0
65095,445,0,0,drop,70,70,0,1,0,1,0
65091,445,0,0,drop,70,70,0,1,0,1,0
65092,445,0,0,drop,70,70,0,1,0,1,0
60516,445,0,0,drop,66,66,0,1,0,1,0
60259,445,0,0,drop,70,70,0,1,0,1,0
60508,445,0,0,drop,66,66,0,1,0,1,0
60509,445,0,0,drop,66,66,0,1,0,1,0
60504,445,0,0,drop,66,66,0,1,0,1,0
60506,445,0,0,drop,66,66,0,1,0,1,0
60502,445,0,0,drop,66,66,0,1,0,1,0
60498,445,0,0,drop,66,66,0,1,0,1,0
60500,445,0,0,drop,66,66,0,1,0,1,0
65085,445,0,0,drop,70,70,0,1,0,1,0
65081,445,0,0,drop,70,70,0,1,0,1,0
65079,445,0,0,drop,70,70,0,1,0,1,0
60255,445,0,0,drop,70,70,0,1,0,1,0
60243,445,0,0,drop,70,70,0,1,0,1,0
60244,445,0,0,drop,70,70,0,1,0,1,0
60246,445,0,0,drop,70,70,0,1,0,1,0
65075,445,0,0,drop,70,70,0,1,0,1,0
65073,445,0,0,drop,70,70,0,1,0,1,0
60241,445,0,0,drop,70,70,0,1,0,1,0
60493,445,0,0,drop,66,66,0,1,0,1,0
60238,445,0,0,drop,70,70,0,1,0,1,0
65068,445,0,0,drop,70,70,0,1,0,1,0
60489,445,0,0,drop,66,66,0,1,0,1,0
60486,445,0,0,drop,66,66,0,1,0,1,0
60487,445,0,0,drop,66,66,0,1,0,1,0
60485,445,0,0,drop,66,66,0,1,0,1,0
60232,445,0,0,drop,70,70,0,1,0,1,0
63344,53,0,0,deny,73,73,0,1,0,1,0
60474,445,0,0,drop,66,66,0,1,0,1,0
60223,445,0,0,drop,70,70,0,1,0,1,0
60219,445,0,0,drop,70,70,0,1,0,1,0
60466,445,0,0,drop,66,66,0,1,0,1,0
60217,445,0,0,drop,70,70,0,1,0,1,0
65041,445,0,0,drop,70,70,0,1,0,1,0
60463,445,0,0,drop,66,66,0,1,0,1,0
49604,53,29103,53,allow,89,89,0,1,30,1,0
54202,53,3615,53,allow,578,286,292,9,16,5,4
65514,53,50854,53,allow,170,87,83,2,30,1,1
64540,53,58172,53,allow,174,89,85,2,30,1,1
55913,53,58939,53,allow,170,87,83,2,31,1,1
49914,53,39261,53,allow,815,95,720,2,30,1,1
55249,53,63785,53,allow,711,87,624,2,30,1,1
36714,80,19257,80,allow,1792,703,1089,12,16,7,5
56020,53,53467,53,allow,198,101,97,2,31,1,1
39629,53,0,0,allow,82,82,0,1,30,1,0
55504,53,5700,53,allow,711,87,624,2,30,1,1
57275,53,65357,53,allow,170,87,83,2,31,1,1
50362,53,31941,53,allow,181,98,83,2,31,1,1
64915,53,25917,53,allow,98,98,0,1,31,1,0
60213,445,0,0,drop,70,70,0,1,0,1,0
60212,445,0,0,drop,70,70,0,1,0,1,0
60455,445,0,0,drop,66,66,0,1,0,1,0
60446,445,0,0,drop,66,66,0,1,0,1,0
57275,53,56267,53,allow,177,94,83,2,30,1,1
49604,53,12616,53,allow,179,94,85,2,30,1,1
56161,53,11132,53,allow,199,94,105,2,30,1,1
49840,53,47224,53,allow,463,87,376,4,38,2,2
65061,53,50134,53,allow,297,101,196,4,33,2,2
49339,443,31744,443,allow,208,70,138,4,25,2,2
49604,53,14213,53,allow,86,86,0,1,29,1,0
56876,53,26048,53,allow,283,110,173,2,29,1,1
54151,443,32501,443,allow,1749,966,783,13,75,8,5
43628,53,19035,53,allow,168,78,90,2,29,1,1
65514,53,17473,53,allow,177,94,83,2,29,1,1
65153,53,31638,53,allow,184,86,98,2,29,1,1
65492,53,51377,53,allow,707,94,613,2,29,1,1
65014,53,11511,53,allow,718,94,624,2,29,1,1
49198,53,16713,53,allow,261,94,167,2,29,1,1
64145,53,4283,53,allow,177,94,83,2,31,1,1
55021,53,44725,53,allow,179,94,85,2,30,1,1
49646,53,41795,53,allow,209,102,107,2,30,1,1
56352,53,18136,53,allow,177,94,83,2,30,1,1
55021,53,50748,53,allow,179,94,85,2,30,1,1
55330,53,64550,53,allow,194,102,92,2,31,1,1
64540,53,24153,53,allow,179,94,85,2,30,1,1
60036,53,52040,53,allow,86,86,0,1,30,1,0
64768,53,30874,53,allow,78,78,0,1,30,1,0
64714,53,29165,53,allow,168,86,82,2,32,1,1
65124,53,4615,53,allow,353,118,235,2,30,1,1
64889,53,50666,53,allow,215,102,113,2,30,1,1
55872,53,55616,53,allow,177,94,83,2,30,1,1
56352,53,39464,53,allow,177,94,83,2,30,1,1
55343,53,44963,53,allow,366,94,272,2,30,1,1
55021,53,26465,53,allow,94,94,0,1,30,1,0
46597,53,0,0,allow,86,86,0,1,30,1,0
55913,53,60589,53,allow,177,94,83,2,30,1,1
37906,443,31579,443,allow,416,210,206,7,26,4,3
57149,53,29225,53,allow,612,114,498,4,52,2,2
65158,53,9153,53,allow,728,102,626,2,30,1,1
52847,53,50629,53,allow,86,86,0,1,30,1,0
64145,53,46343,53,allow,177,94,83,2,30,1,1
64475,53,57543,53,allow,314,99,215,4,39,2,2
64108,53,41542,53,allow,296,126,170,2,30,1,1
55667,53,30119,53,allow,305,126,179,2,30,1,1
64694,53,58763,53,allow,361,107,254,4,37,2,2
64956,53,28840,53,allow,322,84,238,4,36,2,2
49777,53,2324,53,allow,485,79,406,4,31,2,2
50140,53,8390,53,allow,177,94,83,2,30,1,1
49383,53,63729,53,allow,226,110,116,2,30,1,1
55872,53,18177,53,allow,177,94,83,2,30,1,1
55913,53,2700,53,allow,177,94,83,2,30,1,1
50495,53,47068,53,allow,195,102,93,2,30,1,1
36567,53,0,0,allow,86,86,0,1,30,1,0
57275,53,32208,53,allow,177,94,83,2,31,1,1
64540,53,45439,53,allow,179,94,85,2,30,1,1
49519,53,62256,53,allow,264,94,170,2,30,1,1
50495,53,56662,53,allow,195,102,93,2,30,1,1
49369,53,17790,53,allow,246,94,152,2,30,1,1
49285,53,46992,53,allow,94,94,0,1,30,1,0
55563,53,39714,53,allow,194,102,92,2,30,1,1
50365,443,19679,443,allow,712,374,338,11,28,6,5
56639,53,13077,53,allow,168,86,82,2,31,1,1
57275,53,14863,53,allow,177,94,83,2,30,1,1
64204,53,12423,53,allow,211,102,109,2,30,1,1
59950,53,40733,53,allow,168,78,90,2,31,1,1
55589,53,12456,53,allow,177,94,83,2,30,1,1
59998,53,31845,53,allow,481,110,371,2,31,1,1
60207,445,0,0,drop,70,70,0,1,0,1,0
43323,1,0,0,deny,62,62,0,1,0,1,0
65030,445,0,0,drop,70,70,0,1,0,1,0
60435,445,0,0,drop,66,66,0,1,0,1,0
60436,445,0,0,drop,66,66,0,1,0,1,0
60438,445,0,0,drop,66,66,0,1,0,1,0
60432,445,0,0,drop,66,66,0,1,0,1,0
60437,445,0,0,drop,66,66,0,1,0,1,0
60439,445,0,0,drop,66,66,0,1,0,1,0
60433,445,0,0,drop,66,66,0,1,0,1,0
60440,445,0,0,drop,66,66,0,1,0,1,0
59483,23,0,0,deny,60,60,0,1,0,1,0
60194,445,0,0,drop,70,70,0,1,0,1,0
53500,1,0,0,deny,66,66,0,1,0,1,0
65027,445,0,0,drop,70,70,0,1,0,1,0
65026,445,0,0,drop,70,70,0,1,0,1,0
65024,445,0,0,drop,70,70,0,1,0,1,0
65012,445,0,0,drop,70,70,0,1,0,1,0
60191,445,0,0,drop,70,70,0,1,0,1,0
60419,445,0,0,drop,66,66,0,1,0,1,0
60417,445,0,0,drop,66,66,0,1,0,1,0
60416,445,0,0,drop,66,66,0,1,0,1,0
65008,445,0,0,drop,70,70,0,1,0,1,0
60186,445,0,0,drop,70,70,0,1,0,1,0
60185,445,0,0,drop,70,70,0,1,0,1,0
60183,445,0,0,drop,70,70,0,1,0,1,0
60176,445,0,0,drop,70,70,0,1,0,1,0
64986,445,0,0,drop,70,70,0,1,0,1,0
64987,445,0,0,drop,70,70,0,1,0,1,0
64988,445,0,0,drop,70,70,0,1,0,1,0
60174,445,0,0,drop,70,70,0,1,0,1,0
60406,445,0,0,drop,66,66,0,1,0,1,0
60173,445,0,0,drop,70,70,0,1,0,1,0
60172,445,0,0,drop,70,70,0,1,0,1,0
60171,445,0,0,drop,70,70,0,1,0,1,0
60169,445,0,0,drop,70,70,0,1,0,1,0
60167,445,0,0,drop,70,70,0,1,0,1,0
64982,445,0,0,drop,70,70,0,1,0,1,0
64975,445,0,0,drop,70,70,0,1,0,1,0
60153,445,0,0,drop,70,70,0,1,0,1,0
60151,445,0,0,drop,70,70,0,1,0,1,0
60150,445,0,0,drop,70,70,0,1,0,1,0
60142,445,0,0,drop,70,70,0,1,0,1,0
60143,445,0,0,drop,70,70,0,1,0,1,0
60388,445,0,0,drop,66,66,0,1,0,1,0
60387,445,0,0,drop,66,66,0,1,0,1,0
64967,445,0,0,drop,70,70,0,1,0,1,0
64965,445,0,0,drop,70,70,0,1,0,1,0
64964,445,0,0,drop,70,70,0,1,0,1,0
60383,445,0,0,drop,66,66,0,1,0,1,0
60131,445,0,0,drop,70,70,0,1,0,1,0
60371,445,0,0,drop,66,66,0,1,0,1,0
60370,445,0,0,drop,66,66,0,1,0,1,0
60380,445,0,0,drop,66,66,0,1,0,1,0
60375,445,0,0,drop,66,66,0,1,0,1,0
60369,445,0,0,drop,66,66,0,1,0,1,0
60373,445,0,0,drop,66,66,0,1,0,1,0
60372,445,0,0,drop,66,66,0,1,0,1,0
64957,445,0,0,drop,70,70,0,1,0,1,0
64953,445,0,0,drop,70,70,0,1,0,1,0
64952,445,0,0,drop,70,70,0,1,0,1,0
64949,445,0,0,drop,70,70,0,1,0,1,0
60127,445,0,0,drop,70,70,0,1,0,1,0
60118,445,0,0,drop,70,70,0,1,0,1,0
60117,445,0,0,drop,70,70,0,1,0,1,0
60116,445,0,0,drop,70,70,0,1,0,1,0
60114,445,0,0,drop,70,70,0,1,0,1,0
60110,445,0,0,drop,70,70,0,1,0,1,0
64948,445,0,0,drop,70,70,0,1,0,1,0
64944,445,0,0,drop,70,70,0,1,0,1,0
60364,445,0,0,drop,66,66,0,1,0,1,0
64940,445,0,0,drop,70,70,0,1,0,1,0
60360,445,0,0,drop,66,66,0,1,0,1,0
60357,445,0,0,drop,66,66,0,1,0,1,0
60356,445,0,0,drop,66,66,0,1,0,1,0
60355,445,0,0,drop,66,66,0,1,0,1,0
46149,23,0,0,deny,60,60,0,1,0,1,0
60105,445,0,0,drop,70,70,0,1,0,1,0
64926,445,0,0,drop,70,70,0,1,0,1,0
60097,445,0,0,drop,70,70,0,1,0,1,0
60094,445,0,0,drop,70,70,0,1,0,1,0
55921,53,30522,53,allow,711,87,624,2,30,1,1
56733,53,13870,53,allow,170,87,83,2,30,1,1
56025,53,63426,53,allow,761,100,661,2,30,1,1
65449,53,25371,53,allow,170,87,83,2,31,1,1
64145,53,55779,53,allow,170,87,83,2,30,1,1
56368,53,19422,53,allow,817,98,719,2,30,1,1
55548,53,25199,53,allow,194,99,95,2,30,1,1
60342,445,0,0,drop,66,66,0,1,0,1,0
40308,67,0,0,deny,60,60,0,1,0,1,0
36453,23,0,0,deny,60,60,0,1,0,1,0
60091,445,0,0,drop,70,70,0,1,0,1,0
60089,445,0,0,drop,70,70,0,1,0,1,0
60335,445,0,0,drop,66,66,0,1,0,1,0
64914,445,0,0,drop,70,70,0,1,0,1,0
65024,53,8030,53,allow,295,101,194,4,33,2,2
50299,443,56417,443,allow,86,86,0,1,4,1,0
55589,53,33223,53,allow,177,94,83,2,29,1,1
64634,53,6012,53,allow,211,102,109,2,29,1,1
51441,443,56551,443,allow,642,582,60,2,15,1,1
57226,53,37479,53,allow,178,94,84,2,30,1,1
56648,80,59981,80,allow,234,234,0,4,12,4,0
64145,53,59140,53,allow,177,94,83,2,30,1,1
59049,53,37929,53,allow,199,94,105,2,30,1,1
56887,53,15011,53,allow,312,94,218,2,30,1,1
65449,53,31955,53,allow,177,94,83,2,30,1,1
56733,53,1965,53,allow,177,94,83,2,30,1,1
64161,53,62669,53,allow,261,102,159,2,30,1,1
52310,53,0,0,allow,247,76,171,2,30,1,1
49987,443,39263,443,allow,426,180,246,8,21,4,4
55545,53,1793,53,allow,821,102,719,2,30,1,1
63931,53,21564,53,allow,380,105,275,4,35,2,2
55548,53,43983,53,allow,197,102,95,2,33,1,1
49638,53,28303,53,allow,331,88,243,4,32,2,2
55545,53,34965,53,allow,196,100,96,3,33,2,1
64456,53,28818,53,allow,341,110,231,2,29,1,1
55913,53,19739,53,allow,177,94,83,2,30,1,1
65449,53,22193,53,allow,177,94,83,2,30,1,1
64509,53,38948,53,allow,385,134,251,2,30,1,1
56733,53,65238,53,allow,177,94,83,2,30,1,1
41126,53,30186,53,allow,199,94,105,2,30,1,1
64657,53,12172,53,allow,312,94,218,2,30,1,1
50362,53,19652,53,allow,177,94,83,2,30,1,1
55796,53,34450,53,allow,214,94,120,2,30,1,1
56020,53,46192,53,allow,199,102,97,2,30,1,1
49342,53,61829,53,allow,402,118,284,2,30,1,1
57226,53,25603,53,allow,178,94,84,2,30,1,1
49761,53,37619,53,allow,382,94,288,2,30,1,1
65418,53,5528,53,allow,197,94,103,2,30,1,1
37757,53,12221,53,allow,86,86,0,1,30,1,0
49321,53,65339,53,allow,225,102,123,2,30,1,1
55526,53,8264,53,allow,250,86,164,2,30,1,1
65449,53,26123,53,allow,315,87,228,4,40,2,2
57069,53,3710,53,allow,177,94,83,2,30,1,1
57069,53,52685,53,allow,177,94,83,2,31,1,1
60085,445,0,0,drop,70,70,0,1,0,1,0
60332,445,0,0,drop,66,66,0,1,0,1,0
60083,445,0,0,drop,70,70,0,1,0,1,0
60324,445,0,0,drop,66,66,0,1,0,1,0
60316,445,0,0,drop,66,66,0,1,0,1,0
37911,443,2261,443,allow,466,392,74,4,0,3,1
60079,445,0,0,drop,70,70,0,1,0,1,0
64903,445,0,0,drop,70,70,0,1,0,1,0
64901,445,0,0,drop,70,70,0,1,0,1,0
64900,445,0,0,drop,70,70,0,1,0,1,0
60310,445,0,0,drop,66,66,0,1,0,1,0
60308,445,0,0,drop,66,66,0,1,0,1,0
60304,445,0,0,drop,66,66,0,1,0,1,0
60306,445,0,0,drop,66,66,0,1,0,1,0
60309,445,0,0,drop,66,66,0,1,0,1,0
60307,445,0,0,drop,66,66,0,1,0,1,0
60303,445,0,0,drop,66,66,0,1,0,1,0
60302,445,0,0,drop,66,66,0,1,0,1,0
60066,445,0,0,drop,70,70,0,1,0,1,0
60063,445,0,0,drop,70,70,0,1,0,1,0
64891,445,0,0,drop,70,70,0,1,0,1,0
64890,445,0,0,drop,70,70,0,1,0,1,0
64886,445,0,0,drop,70,70,0,1,0,1,0
60288,445,0,0,drop,66,66,0,1,0,1,0
60290,445,0,0,drop,66,66,0,1,0,1,0
60287,445,0,0,drop,66,66,0,1,0,1,0
60058,445,0,0,drop,70,70,0,1,0,1,0
60057,445,0,0,drop,70,70,0,1,0,1,0
64880,445,0,0,drop,70,70,0,1,0,1,0
60055,445,0,0,drop,70,70,0,1,0,1,0
64877,445,0,0,drop,70,70,0,1,0,1,0
60048,445,0,0,drop,70,70,0,1,0,1,0
60046,445,0,0,drop,70,70,0,1,0,1,0
64862,445,0,0,drop,70,70,0,1,0,1,0
64857,445,0,0,drop,70,70,0,1,0,1,0
60045,445,0,0,drop,70,70,0,1,0,1,0
60276,445,0,0,drop,66,66,0,1,0,1,0
60044,445,0,0,drop,70,70,0,1,0,1,0
60043,445,0,0,drop,70,70,0,1,0,1,0
60038,445,0,0,drop,70,70,0,1,0,1,0
60037,445,0,0,drop,70,70,0,1,0,1,0
60025,445,0,0,drop,70,70,0,1,0,1,0
60024,445,0,0,drop,70,70,0,1,0,1,0
60018,445,0,0,drop,70,70,0,1,0,1,0
64847,445,0,0,drop,70,70,0,1,0,1,0
60015,445,0,0,drop,70,70,0,1,0,1,0
60014,445,0,0,drop,70,70,0,1,0,1,0
58021,17,0,0,deny,60,60,0,1,0,1,0
60263,445,0,0,drop,66,66,0,1,0,1,0
60260,445,0,0,drop,66,66,0,1,0,1,0
64844,445,0,0,drop,70,70,0,1,0,1,0
60003,445,0,0,drop,70,70,0,1,0,1,0
64839,445,0,0,drop,70,70,0,1,0,1,0
64838,445,0,0,drop,70,70,0,1,0,1,0
64837,445,0,0,drop,70,70,0,1,0,1,0
36679,443,65477,443,allow,466,392,74,4,0,3,1
60257,445,0,0,drop,66,66,0,1,0,1,0
60249,445,0,0,drop,66,66,0,1,0,1,0
60251,445,0,0,drop,66,66,0,1,0,1,0
60240,445,0,0,drop,66,66,0,1,0,1,0
60245,445,0,0,drop,66,66,0,1,0,1,0
60246,445,0,0,drop,66,66,0,1,0,1,0
60241,445,0,0,drop,66,66,0,1,0,1,0
60239,445,0,0,drop,66,66,0,1,0,1,0
64827,445,0,0,drop,70,70,0,1,0,1,0
59999,445,0,0,drop,70,70,0,1,0,1,0
64825,445,0,0,drop,70,70,0,1,0,1,0
64823,445,0,0,drop,70,70,0,1,0,1,0
64821,445,0,0,drop,70,70,0,1,0,1,0
59989,445,0,0,drop,70,70,0,1,0,1,0
59987,445,0,0,drop,70,70,0,1,0,1,0
59990,445,0,0,drop,70,70,0,1,0,1,0
59985,445,0,0,drop,70,70,0,1,0,1,0
59982,445,0,0,drop,70,70,0,1,0,1,0
64818,445,0,0,drop,70,70,0,1,0,1,0
64817,445,0,0,drop,70,70,0,1,0,1,0
60232,445,0,0,drop,66,66,0,1,0,1,0
64812,445,0,0,drop,70,70,0,1,0,1,0
60228,445,0,0,drop,66,66,0,1,0,1,0
60226,445,0,0,drop,66,66,0,1,0,1,0
56450,53,26592,53,allow,170,87,83,2,30,1,1
58907,80,55384,80,allow,694,350,344,11,28,6,5
55101,53,3206,53,allow,711,87,624,2,30,1,1
50820,53,0,0,allow,371,77,294,2,30,1,1
55671,53,32686,53,allow,98,98,0,1,30,1,0
56734,53,17479,53,allow,751,95,656,2,30,1,1
50110,53,49491,53,allow,172,88,84,2,31,1,1
55531,53,64298,53,allow,216,110,106,2,30,1,1
58012,53,0,0,allow,82,82,0,1,30,1,0
56997,53,59115,53,allow,711,87,624,2,30,1,1
55711,53,2553,53,allow,728,96,632,2,30,1,1
64763,53,29524,53,allow,728,96,632,2,30,1,1
65024,53,40250,53,allow,198,101,97,2,32,1,1
50466,53,25118,53,allow,295,101,194,4,30,2,2
55330,53,46578,53,allow,188,96,92,2,30,1,1
55531,53,31789,53,allow,216,110,106,2,30,1,1
57238,53,18077,53,allow,701,88,613,2,31,1,1
55850,53,22849,53,allow,711,87,624,2,31,1,1
55655,53,43785,53,allow,754,94,660,2,31,1,1
58906,80,61612,80,allow,742,350,392,12,28,6,6
64788,53,8538,53,allow,749,94,655,2,31,1,1
57143,53,34750,53,allow,184,94,90,2,31,1,1
49454,53,56383,53,allow,762,97,665,2,31,1,1
55705,53,6400,53,allow,281,101,180,4,60,2,2
64792,53,58723,53,allow,768,99,669,2,31,1,1
56612,53,23653,53,allow,172,88,84,2,31,1,1
59977,445,0,0,drop,70,70,0,1,0,1,0
60224,445,0,0,drop,66,66,0,1,0,1,0
59969,445,0,0,drop,70,70,0,1,0,1,0
64797,445,0,0,drop,70,70,0,1,0,1,0
59967,445,0,0,drop,70,70,0,1,0,1,0
37607,443,8291,443,allow,499,425,74,4,0,3,1
37609,443,19871,443,allow,499,425,74,4,0,3,1
37610,443,1253,443,allow,499,425,74,4,0,3,1
37612,443,15502,443,allow,499,425,74,4,0,3,1
37611,443,44824,443,allow,499,425,74,4,0,3,1
37608,443,17459,443,allow,499,425,74,4,0,3,1
60214,445,0,0,drop,66,66,0,1,0,1,0
59962,445,0,0,drop,70,70,0,1,0,1,0
59961,445,0,0,drop,70,70,0,1,0,1,0
60206,445,0,0,drop,66,66,0,1,0,1,0
64785,445,0,0,drop,70,70,0,1,0,1,0
59957,445,0,0,drop,70,70,0,1,0,1,0
59956,445,0,0,drop,70,70,0,1,0,1,0
60204,445,0,0,drop,66,66,0,1,0,1,0
50466,53,28614,53,allow,199,102,97,2,30,1,1
62062,443,21250,443,allow,134,60,74,3,5,2,1
49493,53,48045,53,allow,241,118,123,2,30,1,1
56199,53,11587,53,allow,79,79,0,2,33,2,0
57436,66,1487,66,allow,70,70,0,1,4,1,0
56832,53,34537,53,allow,214,102,112,2,29,1,1
64747,53,39095,53,allow,216,94,122,2,29,1,1
65082,53,4469,53,allow,718,94,624,2,29,1,1
56312,53,57178,53,allow,214,102,112,2,29,1,1
55330,53,28011,53,allow,194,102,92,2,29,1,1
55126,53,7380,53,allow,177,94,83,2,30,1,1
64374,53,21299,53,allow,194,94,100,2,30,1,1
62961,53,49359,53,allow,209,102,107,2,30,1,1
56450,53,63813,53,allow,177,94,83,2,30,1,1
55126,53,57162,53,allow,177,94,83,2,30,1,1
51179,53,60232,53,allow,86,86,0,1,30,1,0
56361,53,48019,53,allow,816,102,714,2,30,1,1
56101,53,11714,53,allow,194,102,92,2,30,1,1
49183,53,38350,53,allow,177,94,83,2,30,1,1
64937,53,49091,53,allow,94,94,0,1,30,1,0
54429,53,0,0,allow,195,70,125,2,30,1,1
56450,53,31149,53,allow,177,94,83,2,30,1,1
64172,53,37844,53,allow,197,102,95,2,33,1,1
64729,53,36616,53,allow,262,94,168,2,30,1,1
56986,53,20950,53,allow,259,87,172,4,37,2,2
50466,53,34951,53,allow,199,102,97,2,30,1,1
49266,53,11642,53,allow,330,97,233,4,33,2,2
35804,443,35654,443,allow,232,172,60,3,5,2,1
48541,80,51953,80,allow,812,672,140,6,28,4,2
37339,443,37972,443,allow,130,70,60,3,5,2,1
55671,53,40091,53,allow,196,102,94,2,33,1,1
41246,443,49001,443,allow,78,78,0,1,5,1,0
64981,53,62988,53,allow,214,102,112,2,29,1,1
56733,53,5825,53,allow,177,94,83,2,29,1,1
50336,53,8935,53,allow,102,102,0,1,30,1,0
51877,53,28972,53,allow,254,78,176,2,29,1,1
49668,53,14674,53,allow,214,102,112,2,29,1,1
55531,53,2010,53,allow,322,110,212,4,30,2,2
64192,53,23253,53,allow,308,110,198,2,29,1,1
49183,53,55748,53,allow,177,94,83,2,30,1,1
65510,53,46580,53,allow,229,102,127,2,30,1,1
55531,53,46307,53,allow,216,110,106,2,30,1,1
64000,53,28661,53,allow,241,102,139,2,30,1,1
50252,53,45062,53,allow,173,94,79,2,30,1,1
49981,53,44663,53,allow,360,102,258,2,30,1,1
49688,53,10693,53,allow,782,110,672,2,30,1,1
56273,53,37875,53,allow,330,126,204,2,30,1,1
50010,53,28513,53,allow,330,126,204,2,31,1,1
56177,53,3037,53,allow,807,94,713,2,31,1,1
49812,53,26847,53,allow,193,102,91,2,31,1,1
49948,53,31894,53,allow,755,102,653,2,30,1,1
65049,53,34852,53,allow,199,102,97,2,30,1,1
49328,53,46932,53,allow,748,94,654,2,30,1,1
50110,53,63137,53,allow,178,94,84,2,30,1,1
56361,53,14867,53,allow,193,102,91,2,30,1,1
57019,53,54333,53,allow,193,102,91,2,30,1,1
49896,53,58946,53,allow,772,102,670,2,30,1,1
57241,53,26543,53,allow,224,102,122,2,30,1,1
50466,53,18896,53,allow,199,102,97,2,30,1,1
56628,80,40916,80,allow,1359,435,924,13,30,7,6
64226,53,55510,53,allow,211,102,109,2,30,1,1
56101,53,64581,53,allow,194,102,92,2,30,1,1
65206,53,13449,53,allow,330,118,212,2,30,1,1
65212,53,36121,53,allow,230,102,128,2,30,1,1
51566,53,46943,53,allow,239,102,137,2,30,1,1
49587,53,25936,53,allow,229,102,127,2,30,1,1
58805,53,42120,53,allow,237,86,151,2,30,1,1
36701,53,35437,53,allow,199,94,105,2,30,1,1
55334,53,17897,53,allow,199,102,97,2,31,1,1
56000,53,26233,53,allow,177,94,83,2,30,1,1
57019,53,50222,53,allow,193,102,91,2,30,1,1
65277,53,2071,53,allow,775,102,673,2,30,1,1
65275,53,62237,53,allow,184,94,90,2,30,1,1
55330,53,61986,53,allow,194,102,92,2,31,1,1
44881,53,62824,53,allow,212,78,134,2,30,1,1
65275,53,60428,53,allow,807,94,713,2,30,1,1
46985,53,9920,53,allow,199,94,105,2,30,1,1
49348,53,64482,53,allow,214,94,120,2,31,1,1
56000,53,8849,53,allow,177,94,83,2,31,1,1
64665,53,12742,53,allow,181,94,87,2,32,1,1
60195,445,0,0,drop,66,66,0,1,0,1,0
59951,445,0,0,drop,70,70,0,1,0,1,0
60193,445,0,0,drop,66,66,0,1,0,1,0
64773,445,0,0,drop,70,70,0,1,0,1,0
64774,445,0,0,drop,70,70,0,1,0,1,0
64772,445,0,0,drop,70,70,0,1,0,1,0
60174,445,0,0,drop,66,66,0,1,0,1,0
60180,445,0,0,drop,66,66,0,1,0,1,0
60175,445,0,0,drop,66,66,0,1,0,1,0
60179,445,0,0,drop,66,66,0,1,0,1,0
60177,445,0,0,drop,66,66,0,1,0,1,0
60181,445,0,0,drop,66,66,0,1,0,1,0
60178,445,0,0,drop,66,66,0,1,0,1,0
60176,445,0,0,drop,66,66,0,1,0,1,0
59938,445,0,0,drop,70,70,0,1,0,1,0
59935,445,0,0,drop,70,70,0,1,0,1,0
64765,445,0,0,drop,70,70,0,1,0,1,0
64763,445,0,0,drop,70,70,0,1,0,1,0
64758,445,0,0,drop,70,70,0,1,0,1,0
37603,443,61350,443,allow,573,425,148,5,1,3,2
37602,443,57970,443,allow,573,425,148,5,0,3,2
37601,443,50258,443,allow,573,425,148,5,0,3,2
54251,443,43085,443,allow,499,425,74,4,0,3,1
54252,443,11078,443,allow,499,425,74,4,0,3,1
54250,443,54030,443,allow,499,425,74,4,0,3,1
60161,445,0,0,drop,66,66,0,1,0,1,0
60160,445,0,0,drop,66,66,0,1,0,1,0
60159,445,0,0,drop,66,66,0,1,0,1,0
59930,445,0,0,drop,70,70,0,1,0,1,0
59929,445,0,0,drop,70,70,0,1,0,1,0
59927,445,0,0,drop,70,70,0,1,0,1,0
64752,445,0,0,drop,70,70,0,1,0,1,0
64747,445,0,0,drop,70,70,0,1,0,1,0
54249,443,37595,443,allow,499,425,74,4,0,3,1
37605,443,2336,443,allow,573,425,148,5,0,3,2
37604,443,27839,443,allow,573,425,148,5,0,3,2
54248,443,24435,443,allow,499,425,74,4,0,3,1
37606,443,60055,443,allow,499,425,74,4,0,3,1
54245,443,40246,443,allow,499,425,74,4,0,3,1
59920,445,0,0,drop,70,70,0,1,0,1,0
59918,445,0,0,drop,70,70,0,1,0,1,0
64735,445,0,0,drop,70,70,0,1,0,1,0
64729,445,0,0,drop,70,70,0,1,0,1,0
64730,445,0,0,drop,70,70,0,1,0,1,0
59917,445,0,0,drop,70,70,0,1,0,1,0
59916,445,0,0,drop,70,70,0,1,0,1,0
59915,445,0,0,drop,70,70,0,1,0,1,0
59911,445,0,0,drop,70,70,0,1,0,1,0
59910,445,0,0,drop,70,70,0,1,0,1,0
60149,445,0,0,drop,66,66,0,1,0,1,0
59897,445,0,0,drop,70,70,0,1,0,1,0
59896,445,0,0,drop,70,70,0,1,0,1,0
59891,445,0,0,drop,70,70,0,1,0,1,0
59886,445,0,0,drop,70,70,0,1,0,1,0
59887,445,0,0,drop,70,70,0,1,0,1,0
60134,445,0,0,drop,66,66,0,1,0,1,0
60132,445,0,0,drop,66,66,0,1,0,1,0
52062,443,35040,443,allow,466,392,74,4,0,3,1
59875,445,0,0,drop,70,70,0,1,0,1,0
64714,445,0,0,drop,70,70,0,1,0,1,0
64709,445,0,0,drop,70,70,0,1,0,1,0
64708,445,0,0,drop,70,70,0,1,0,1,0
60125,445,0,0,drop,66,66,0,1,0,1,0
60120,445,0,0,drop,66,66,0,1,0,1,0
60122,445,0,0,drop,66,66,0,1,0,1,0
60114,445,0,0,drop,66,66,0,1,0,1,0
60118,445,0,0,drop,66,66,0,1,0,1,0
60111,445,0,0,drop,66,66,0,1,0,1,0
60110,445,0,0,drop,66,66,0,1,0,1,0
59871,445,0,0,drop,70,70,0,1,0,1,0
64701,445,0,0,drop,70,70,0,1,0,1,0
55387,53,17527,53,allow,761,100,661,2,31,1,1
57311,53,52829,53,allow,768,99,669,2,31,1,1
45550,80,42274,80,allow,890,420,470,14,27,7,7
56654,53,59245,53,allow,202,103,99,2,31,1,1
57444,53,22248,53,allow,170,87,83,2,30,1,1
50036,80,50018,80,allow,1665,923,742,7,32,4,3
45552,80,5282,80,allow,890,420,470,14,27,7,7
65251,53,54208,53,allow,183,98,85,3,36,2,1
64665,53,63171,53,allow,91,91,0,1,30,1,0
55196,53,52555,53,allow,711,87,624,2,30,1,1
65266,53,41690,53,allow,216,110,106,2,31,1,1
52332,443,52332,443,allow,960,539,421,9,52,5,4
50578,80,53375,80,allow,1114,534,580,12,16,7,5
45551,80,20742,80,allow,694,350,344,11,27,6,5
65061,53,34099,53,allow,297,101,196,4,31,2,2
56440,53,14356,53,allow,742,88,654,2,30,1,1
55949,53,62692,53,allow,774,101,673,2,30,1,1
56169,53,29884,53,allow,749,94,655,2,30,1,1
57019,53,12115,53,allow,186,95,91,2,30,1,1
56479,53,28725,53,allow,775,103,672,2,30,1,1
55019,53,16040,53,allow,299,110,189,4,32,2,2
56986,53,50579,53,allow,259,87,172,4,37,2,2
56240,53,50619,53,allow,748,95,653,2,30,1,1
65244,53,43768,53,allow,170,87,83,2,30,1,1
64016,53,54219,53,allow,184,94,90,2,31,1,1
49552,53,40374,53,allow,760,97,663,2,31,1,1
55066,53,26532,53,allow,815,95,720,2,31,1,1
65180,53,32141,53,allow,198,101,97,2,31,1,1
50089,53,38993,53,allow,752,93,659,2,31,1,1
50621,53,54722,53,allow,256,93,163,2,31,1,1
56755,53,37076,53,allow,184,94,90,2,31,1,1
64697,445,0,0,drop,70,70,0,1,0,1,0
64695,445,0,0,drop,70,70,0,1,0,1,0
64693,445,0,0,drop,70,70,0,1,0,1,0
59861,445,0,0,drop,70,70,0,1,0,1,0
59862,445,0,0,drop,70,70,0,1,0,1,0
59860,445,0,0,deny,70,70,0,1,0,1,0
59856,445,0,0,drop,70,70,0,1,0,1,0
59855,445,0,0,drop,70,70,0,1,0,1,0
64689,445,0,0,drop,70,70,0,1,0,1,0
64688,445,0,0,drop,70,70,0,1,0,1,0
57074,53,2955,53,allow,195,102,93,2,30,1,1
56612,53,28216,53,allow,178,94,84,2,30,1,1
56681,53,9758,53,allow,195,102,93,2,30,1,1
64156,53,39777,53,allow,409,92,317,4,30,2,2
56986,53,34763,53,allow,259,87,172,4,36,2,2
62053,443,33820,443,allow,134,60,74,3,5,2,1
65251,53,36655,53,allow,277,98,179,4,36,2,2
55334,53,36263,53,allow,199,102,97,2,30,1,1
49945,53,62137,53,allow,198,102,96,2,30,1,1
65049,53,13947,53,allow,199,102,97,2,29,1,1
56450,53,17647,53,allow,177,94,83,2,29,1,1
64345,53,39290,53,allow,499,94,405,2,29,1,1
65435,53,59924,53,allow,196,94,102,2,29,1,1
64561,53,50313,53,allow,209,110,99,2,30,1,1
56654,53,7307,53,allow,209,110,99,2,30,1,1
37384,443,22279,443,allow,416,210,206,7,29,4,3
64561,53,6022,53,allow,209,110,99,2,30,1,1
53940,53,37682,53,allow,70,70,0,1,30,1,0
65244,53,54645,53,allow,177,94,83,2,30,1,1
49945,53,22837,53,allow,821,102,719,2,30,1,1
55019,53,27465,53,allow,299,110,189,4,31,2,2
65224,53,18679,53,allow,197,102,95,2,30,1,1
56717,53,2347,53,allow,178,94,84,2,30,1,1
52333,443,52333,443,allow,960,539,421,9,52,5,4
64266,53,18916,53,allow,180,94,86,2,31,1,1
50169,53,12431,53,allow,211,78,133,2,30,1,1
56177,53,33735,53,allow,184,94,90,2,30,1,1
57143,53,42791,53,allow,184,94,90,2,30,1,1
55938,53,31705,53,allow,209,110,99,2,30,1,1
65224,53,46834,53,allow,197,102,95,2,30,1,1
55770,53,22601,53,allow,177,94,83,2,30,1,1
57444,53,32931,53,allow,177,94,83,2,30,1,1
49812,53,34841,53,allow,193,102,91,2,30,1,1
57444,53,54223,53,allow,177,94,83,2,30,1,1
64125,53,55658,53,allow,370,94,276,2,30,1,1
56717,53,46335,53,allow,178,94,84,2,31,1,1
55705,53,9254,53,allow,281,101,180,4,58,2,2
56035,53,45102,53,allow,173,94,79,2,30,1,1
63939,53,40762,53,allow,226,110,116,2,30,1,1
49258,53,9142,53,allow,228,102,126,2,30,1,1
55019,53,59602,53,allow,299,110,189,4,31,2,2
65244,53,26357,53,allow,177,94,83,2,31,1,1
65061,53,31774,53,allow,299,103,196,4,33,2,2
55065,80,56775,80,allow,306,180,126,6,28,4,2
64174,53,47378,53,allow,438,130,308,4,35,2,2
56647,80,55289,80,allow,234,234,0,4,12,4,0
53123,443,38611,443,allow,1630,1089,541,14,15,8,6
50252,53,7370,53,allow,165,86,79,2,30,1,1
57143,53,50787,53,allow,184,94,90,2,30,1,1
56654,53,36546,53,allow,209,110,99,2,30,1,1
49786,53,64235,53,allow,209,110,99,2,30,1,1
49927,53,25486,53,allow,763,102,661,2,30,1,1
56929,53,14776,53,allow,177,94,83,2,30,1,1
57074,53,22735,53,allow,195,102,93,2,30,1,1
56357,53,35688,53,allow,270,110,160,2,30,1,1
65256,53,14067,53,allow,213,102,111,2,30,1,1
64016,53,18748,53,allow,184,94,90,2,31,1,1
57019,53,31067,53,allow,193,102,91,2,31,1,1
55705,53,13969,53,allow,281,101,180,4,58,2,2
64064,53,52675,53,allow,257,94,163,2,30,1,1
64114,53,8208,53,allow,251,102,149,2,30,1,1
55668,80,57634,80,allow,70,70,0,1,5,1,0
56035,53,24305,53,allow,173,94,79,2,30,1,1
64524,53,53824,53,allow,235,102,133,2,30,1,1
56986,53,7478,53,allow,259,87,172,4,37,2,2
55705,53,27815,53,allow,281,101,180,4,59,2,2
56681,53,26694,53,allow,195,102,93,2,30,1,1
55938,53,44450,53,allow,209,110,99,2,30,1,1
50411,53,28874,53,allow,86,86,0,1,30,1,0
55770,53,9659,53,allow,177,94,83,2,30,1,1
65266,53,21692,53,allow,216,110,106,2,30,1,1
64313,53,9214,53,allow,226,110,116,2,30,1,1
64556,53,40982,53,allow,195,102,93,2,30,1,1
55019,53,16750,53,allow,299,110,189,4,31,2,2
49557,53,61895,53,allow,1298,100,1198,4,32,2,2
60204,80,20326,80,allow,70,70,0,2,8,2,0
55846,53,27827,53,allow,198,102,96,2,30,1,1
49774,53,49900,53,allow,225,110,115,2,30,1,1
56755,53,26920,53,allow,184,94,90,2,31,1,1
57201,53,17693,53,allow,195,102,93,2,31,1,1
53757,1,5970,1,allow,70,70,0,1,5,1,0
55475,80,10225,80,allow,350,210,140,6,27,4,2
62904,80,35309,80,allow,1515,481,1034,11,16,6,5
49518,53,34385,53,allow,299,90,209,4,49,2,2
65180,53,7905,53,allow,199,102,97,2,30,1,1
55968,53,21608,53,allow,243,94,149,2,30,1,1
57143,53,17926,53,allow,184,94,90,2,30,1,1
56929,53,47625,53,allow,177,94,83,2,30,1,1
56654,53,22372,53,allow,209,110,99,2,30,1,1
64191,53,5419,53,allow,197,94,103,2,30,1,1
49536,53,5228,53,allow,239,94,145,2,30,1,1
64690,445,0,0,drop,70,70,0,1,0,1,0
60104,445,0,0,drop,66,66,0,1,0,1,0
64684,445,0,0,drop,70,70,0,1,0,1,0
60100,445,0,0,drop,66,66,0,1,0,1,0
59848,445,0,0,drop,70,70,0,1,0,1,0
60097,445,0,0,drop,66,66,0,1,0,1,0
60098,445,0,0,drop,66,66,0,1,0,1,0
60095,445,0,0,drop,66,66,0,1,0,1,0
59841,445,0,0,drop,70,70,0,1,0,1,0
59840,445,0,0,drop,70,70,0,1,0,1,0
64669,445,0,0,drop,70,70,0,1,0,1,0
59834,445,0,0,drop,70,70,0,1,0,1,0
59833,445,0,0,drop,70,70,0,1,0,1,0
60085,445,0,0,drop,66,66,0,1,0,1,0
59829,445,0,0,drop,70,70,0,1,0,1,0
60077,445,0,0,drop,66,66,0,1,0,1,0
64659,445,0,0,drop,70,70,0,1,0,1,0
59828,445,0,0,drop,70,70,0,1,0,1,0
60075,445,0,0,drop,66,66,0,1,0,1,0
59823,445,0,0,drop,70,70,0,1,0,1,0
60066,445,0,0,drop,66,66,0,1,0,1,0
60059,445,0,0,drop,66,66,0,1,0,1,0
64646,445,0,0,drop,70,70,0,1,0,1,0
64645,445,0,0,drop,70,70,0,1,0,1,0
64644,445,0,0,drop,70,70,0,1,0,1,0
60052,445,0,0,drop,66,66,0,1,0,1,0
60049,445,0,0,drop,66,66,0,1,0,1,0
60051,445,0,0,drop,66,66,0,1,0,1,0
60048,445,0,0,drop,66,66,0,1,0,1,0
60046,445,0,0,drop,66,66,0,1,0,1,0
60045,445,0,0,drop,66,66,0,1,0,1,0
60050,445,0,0,drop,66,66,0,1,0,1,0
60044,445,0,0,drop,66,66,0,1,0,1,0
59810,445,0,0,drop,70,70,0,1,0,1,0
59807,445,0,0,drop,70,70,0,1,0,1,0
64640,445,0,0,drop,70,70,0,1,0,1,0
64641,445,0,0,drop,70,70,0,1,0,1,0
64634,445,0,0,drop,70,70,0,1,0,1,0
64629,445,0,0,drop,70,70,0,1,0,1,0
59802,445,0,0,drop,70,70,0,1,0,1,0
59801,445,0,0,drop,70,70,0,1,0,1,0
60030,445,0,0,drop,66,66,0,1,0,1,0
60032,445,0,0,drop,66,66,0,1,0,1,0
60029,445,0,0,drop,66,66,0,1,0,1,0
59799,445,0,0,drop,70,70,0,1,0,1,0
64624,445,0,0,drop,70,70,0,1,0,1,0
64616,445,0,0,drop,70,70,0,1,0,1,0
64612,445,0,0,drop,70,70,0,1,0,1,0
59792,445,0,0,drop,70,70,0,1,0,1,0
59790,445,0,0,drop,70,70,0,1,0,1,0
59789,445,0,0,drop,70,70,0,1,0,1,0
59788,445,0,0,drop,70,70,0,1,0,1,0
59787,445,0,0,drop,70,70,0,1,0,1,0
59785,445,0,0,drop,70,70,0,1,0,1,0
59783,445,0,0,drop,70,70,0,1,0,1,0
64606,445,0,0,drop,70,70,0,1,0,1,0
64600,445,0,0,drop,70,70,0,1,0,1,0
60020,445,0,0,drop,66,66,0,1,0,1,0
59769,445,0,0,drop,70,70,0,1,0,1,0
59767,445,0,0,drop,70,70,0,1,0,1,0
59763,445,0,0,drop,70,70,0,1,0,1,0
59758,445,0,0,drop,70,70,0,1,0,1,0
59759,445,0,0,drop,70,70,0,1,0,1,0
64598,445,0,0,drop,70,70,0,1,0,1,0
60002,445,0,0,drop,66,66,0,1,0,1,0
60001,445,0,0,drop,66,66,0,1,0,1,0
59747,445,0,0,drop,70,70,0,1,0,1,0
56203,53,21719,53,allow,751,95,656,2,30,1,1
64892,53,1067,53,allow,751,95,656,2,30,1,1
61488,53,0,0,allow,314,93,221,2,30,1,1
64154,53,29072,53,allow,188,96,92,2,30,1,1
56563,53,31162,53,allow,751,95,656,2,30,1,1
55962,53,39113,53,allow,186,95,91,2,31,1,1
49966,80,31375,80,allow,1210,788,422,9,33,5,4
58060,80,29313,80,allow,1854,735,1119,8,16,5,3
36361,80,36361,80,allow,514,246,268,9,76,5,4
55081,80,13620,80,allow,1680,697,983,10,52,6,4
36548,80,36548,80,allow,514,246,268,9,76,5,4
36132,80,36132,80,allow,514,246,268,9,76,5,4
56579,53,34186,53,allow,711,87,624,2,30,1,1
56929,53,5055,53,allow,170,87,83,2,30,1,1
56717,53,51715,53,allow,172,88,84,2,31,1,1
36084,80,36084,80,allow,514,246,268,9,76,5,4
56811,53,1928,53,allow,762,97,665,2,30,1,1
49009,53,49009,53,allow,172,76,96,2,30,1,1
57074,53,56571,53,allow,190,97,93,2,30,1,1
56417,53,44124,53,allow,752,93,659,2,30,1,1
65491,53,39082,53,allow,186,95,91,2,30,1,1
55840,53,25093,53,allow,711,87,624,2,30,1,1
57385,53,40272,53,allow,194,99,95,2,31,1,1
56422,53,35593,53,allow,716,95,621,2,30,1,1
55343,53,13186,53,allow,770,101,669,2,31,1,1
55752,53,35033,53,allow,170,87,83,2,31,1,1
55192,53,1273,53,allow,760,97,663,2,31,1,1
50209,53,45881,53,allow,780,104,676,2,31,1,1
57365,53,10039,53,allow,780,104,676,2,31,1,1
55890,53,50894,53,allow,186,95,91,2,31,1,1
65485,53,57081,53,allow,184,94,90,2,31,1,1
49949,53,60223,53,allow,186,95,91,2,31,1,1
65220,53,55552,53,allow,172,88,84,2,31,1,1
57122,53,5518,53,allow,295,101,194,4,31,2,2
57128,53,45410,53,allow,755,93,662,2,31,1,1
55197,53,53428,53,allow,701,88,613,2,31,1,1
55808,53,19839,53,allow,182,93,89,2,31,1,1
64786,53,39238,53,allow,810,108,702,2,31,1,1
56529,53,60444,53,allow,711,87,624,2,31,1,1
65303,53,22620,53,allow,760,96,664,2,31,1,1
64793,53,59763,53,allow,168,86,82,2,31,1,1
55064,53,40731,53,allow,774,101,673,2,31,1,1
55934,53,55732,53,allow,192,98,94,2,31,1,1
55878,53,54979,53,allow,760,97,663,2,31,1,1
49421,53,15245,53,allow,744,89,655,2,31,1,1
57043,53,5828,53,allow,735,88,647,2,31,1,1
64582,445,0,0,drop,70,70,0,1,0,1,0
64580,445,0,0,drop,70,70,0,1,0,1,0
59997,445,0,0,drop,66,66,0,1,0,1,0
59743,445,0,0,drop,70,70,0,1,0,1,0
59991,445,0,0,drop,66,66,0,1,0,1,0
65047,53,39231,53,allow,645,185,460,6,40,3,3
50552,53,61704,53,allow,757,102,655,2,30,1,1
65206,53,7490,53,allow,816,102,714,2,30,1,1
56929,53,59011,53,allow,177,94,83,2,30,1,1
64950,53,10318,53,allow,765,102,663,2,30,1,1
64977,53,18612,53,allow,334,94,240,2,30,1,1
65443,53,21010,53,allow,164,86,78,2,30,1,1
55727,53,48303,53,allow,177,94,83,2,30,1,1
64227,53,63621,53,allow,302,92,210,4,30,2,2
65123,53,59199,53,allow,816,102,714,2,29,1,1
65474,53,42125,53,allow,197,94,103,2,29,1,1
57424,53,63565,53,allow,197,102,95,2,30,1,1
55476,80,7666,80,allow,498,280,218,8,26,5,3
57051,53,10858,53,allow,354,90,264,4,50,2,2
55477,80,28863,80,allow,498,280,218,8,26,5,3
64556,53,11651,53,allow,195,102,93,2,29,1,1
55337,53,41001,53,allow,198,102,96,2,29,1,1
57424,53,59355,53,allow,197,102,95,2,29,1,1
55846,53,44796,53,allow,821,102,719,2,29,1,1
50001,53,34185,53,allow,239,94,145,2,29,1,1
56755,53,13799,53,allow,184,94,90,2,29,1,1
64741,53,21274,53,allow,198,86,112,2,29,1,1
57444,53,35555,53,allow,177,94,83,2,29,1,1
64255,53,12895,53,allow,200,94,106,2,29,1,1
55593,53,62454,53,allow,193,102,91,2,30,1,1
49607,53,13201,53,allow,259,102,157,2,29,1,1
65266,53,57275,53,allow,216,110,106,2,29,1,1
56496,53,21788,53,allow,164,86,78,2,30,1,1
36731,80,36731,80,allow,514,246,268,9,75,5,4
65180,53,35991,53,allow,199,102,97,2,30,1,1
49393,53,14583,53,allow,183,86,97,2,30,1,1
65213,53,57292,53,allow,198,94,104,2,30,1,1
64257,53,4953,53,allow,261,94,167,2,30,1,1
49675,53,53697,53,allow,199,102,97,2,30,1,1
55444,53,60851,53,allow,193,102,91,2,30,1,1
48436,53,48436,53,allow,216,82,134,2,32,1,1
65206,53,37251,53,allow,193,102,91,2,30,1,1
64714,53,3550,53,allow,168,86,82,2,31,1,1
64433,53,29795,53,allow,214,102,112,2,30,1,1
59788,443,42215,443,allow,162,102,60,2,5,1,1
56814,53,9627,53,allow,193,102,91,2,30,1,1
55962,53,37019,53,allow,193,102,91,2,30,1,1
65330,53,53724,53,allow,723,102,621,2,30,1,1
64385,53,21883,53,allow,307,105,202,4,47,2,2
49228,53,7287,53,allow,193,102,91,2,30,1,1
65443,53,23920,53,allow,172,94,78,2,30,1,1
49876,53,41654,53,allow,199,102,97,2,30,1,1
65280,53,36660,53,allow,213,102,111,2,30,1,1
49228,53,30182,53,allow,193,102,91,2,30,1,1
55727,53,61818,53,allow,177,94,83,2,30,1,1
56138,53,42749,53,allow,259,86,173,2,30,1,1
61128,80,61128,80,allow,1382,855,527,11,20,6,5
50086,53,16389,53,allow,193,102,91,2,30,1,1
49876,53,54830,53,allow,199,102,97,2,30,1,1
55043,53,56264,53,allow,274,110,164,2,30,1,1
49555,53,24625,53,allow,193,102,91,2,30,1,1
65024,53,20074,53,allow,199,102,97,2,30,1,1
64569,53,52034,53,allow,258,102,156,2,30,1,1
64154,53,27741,53,allow,194,102,92,2,31,1,1
64892,53,50035,53,allow,252,102,150,2,29,1,1
55593,53,42641,53,allow,193,102,91,2,29,1,1
55562,53,27476,53,allow,239,94,145,2,29,1,1
65123,53,3182,53,allow,193,102,91,2,29,1,1
56884,53,31028,53,allow,177,94,83,2,30,1,1
56884,53,27069,53,allow,177,94,83,2,30,1,1
54996,53,30248,53,allow,252,102,150,2,29,1,1
49687,53,63012,53,allow,241,94,147,2,29,1,1
64154,53,35293,53,allow,194,102,92,2,29,1,1
64195,53,9148,53,allow,270,110,160,2,29,1,1
65180,53,28162,53,allow,199,102,97,2,30,1,1
65491,53,7417,53,allow,193,102,91,2,30,1,1
65266,53,39575,53,allow,216,110,106,2,30,1,1
57029,53,63160,53,allow,246,94,152,2,30,1,1
49555,53,29992,53,allow,193,102,91,2,30,1,1
56521,53,59104,53,allow,310,126,184,2,30,1,1
49876,53,33233,53,allow,199,102,97,2,30,1,1
56212,53,11758,53,allow,168,86,82,2,31,1,1
55742,53,55832,53,allow,193,102,91,2,30,1,1
64491,53,54856,53,allow,244,94,150,2,30,1,1
55752,53,39716,53,allow,177,94,83,2,30,1,1
49355,53,45330,53,allow,184,102,82,2,30,1,1
55580,53,57711,53,allow,195,102,93,2,31,1,1
65061,53,60210,53,allow,733,204,529,6,40,3,3
62896,993,54480,993,allow,178,118,60,2,15,1,1
49961,53,12419,53,allow,377,107,270,4,45,2,2
50011,53,8163,53,allow,272,110,162,2,30,1,1
65416,53,1423,53,allow,758,102,656,2,30,1,1
57385,53,34809,53,allow,197,102,95,2,30,1,1
56393,53,59869,53,allow,197,94,103,2,30,1,1
49696,53,15575,53,allow,200,94,106,2,30,1,1
55133,53,36178,53,allow,184,102,82,2,31,1,1
65485,53,34553,53,allow,184,94,90,2,31,1,1
63919,80,26463,80,allow,314,192,122,6,15,4,2
49359,53,64327,53,allow,412,122,290,4,45,2,2
64940,53,17775,53,allow,758,102,656,2,30,1,1
49684,53,44986,53,allow,265,110,155,2,30,1,1
57074,53,64644,53,allow,195,102,93,2,30,1,1
49291,53,21649,53,allow,771,102,669,2,30,1,1
55444,53,54146,53,allow,193,102,91,2,30,1,1
55742,53,11069,53,allow,193,102,91,2,31,1,1
55358,53,28706,53,allow,183,94,89,2,31,1,1
64540,53,29410,53,allow,94,94,0,1,30,1,0
50086,53,18970,53,allow,816,102,714,2,30,1,1
56814,53,30689,53,allow,816,102,714,2,30,1,1
57201,53,63092,53,allow,195,102,93,2,30,1,1
55898,53,25351,53,allow,757,102,655,2,30,1,1
51261,53,15838,53,allow,259,86,173,2,30,1,1
55890,53,43973,53,allow,193,102,91,2,30,1,1
63970,53,14367,53,allow,200,94,106,2,30,1,1
49229,53,47924,53,allow,183,94,89,2,30,1,1
65466,53,32995,53,allow,200,102,98,2,30,1,1
55962,53,28186,53,allow,193,102,91,2,30,1,1
56755,53,24589,53,allow,184,94,90,2,30,1,1
55580,53,20402,53,allow,195,102,93,2,30,1,1
57385,53,56308,53,allow,197,102,95,2,30,1,1
56212,53,23655,53,allow,184,102,82,2,30,1,1
57275,53,22195,53,allow,199,102,97,2,31,1,1
49966,53,5626,53,allow,168,78,90,2,30,1,1
55890,53,44710,53,allow,193,102,91,2,31,1,1
57226,53,39140,53,allow,178,94,84,2,31,1,1
64955,53,63777,53,allow,210,110,100,2,30,1,1
55752,53,65323,53,allow,177,94,83,2,30,1,1
64526,53,11461,53,allow,377,94,283,2,30,1,1
55337,53,8844,53,allow,198,102,96,2,31,1,1
55391,53,35560,53,allow,210,110,100,2,31,1,1
56892,53,51389,53,allow,199,102,97,2,31,1,1
56004,53,52519,53,allow,178,94,84,2,31,1,1
65304,53,24960,53,allow,195,102,93,2,31,1,1
64016,53,59779,53,allow,184,94,90,2,31,1,1
65491,53,33767,53,allow,193,102,91,2,31,1,1
55441,53,20150,53,allow,216,110,106,2,31,1,1
55776,53,14354,53,allow,271,93,178,4,31,2,2
57228,53,47856,53,allow,199,102,97,2,31,1,1
52441,53,0,0,allow,86,86,0,1,30,1,0
56704,53,49275,53,allow,177,94,83,2,31,1,1
57591,53,13897,53,allow,165,78,87,2,31,1,1
55934,53,39869,53,allow,196,102,94,2,31,1,1
59982,445,0,0,drop,66,66,0,1,0,1,0
59989,445,0,0,drop,66,66,0,1,0,1,0
59986,445,0,0,drop,66,66,0,1,0,1,0
59985,445,0,0,drop,66,66,0,1,0,1,0
59984,445,0,0,drop,66,66,0,1,0,1,0
59979,445,0,0,drop,66,66,0,1,0,1,0
64573,445,0,0,drop,70,70,0,1,0,1,0
59734,445,0,0,drop,70,70,0,1,0,1,0
59732,445,0,0,drop,70,70,0,1,0,1,0
59733,445,0,0,drop,70,70,0,1,0,1,0
64569,445,0,0,drop,70,70,0,1,0,1,0
64567,445,0,0,drop,70,70,0,1,0,1,0
64565,445,0,0,drop,70,70,0,1,0,1,0
59728,445,0,0,drop,70,70,0,1,0,1,0
59726,445,0,0,drop,70,70,0,1,0,1,0
64561,445,0,0,drop,70,70,0,1,0,1,0
36237,23,0,0,deny,60,60,0,1,0,1,0
59718,445,0,0,drop,70,70,0,1,0,1,0
59974,445,0,0,drop,66,66,0,1,0,1,0
64556,445,0,0,drop,70,70,0,1,0,1,0
59970,445,0,0,drop,66,66,0,1,0,1,0
59969,445,0,0,drop,66,66,0,1,0,1,0
59967,445,0,0,drop,66,66,0,1,0,1,0
59965,445,0,0,drop,66,66,0,1,0,1,0
59711,445,0,0,drop,70,70,0,1,0,1,0
59710,445,0,0,drop,70,70,0,1,0,1,0
64540,445,0,0,drop,70,70,0,1,0,1,0
59705,445,0,0,drop,70,70,0,1,0,1,0
59703,445,0,0,drop,70,70,0,1,0,1,0
59954,445,0,0,drop,66,66,0,1,0,1,0
54351,23,0,0,deny,60,60,0,1,0,1,0
59699,445,0,0,drop,70,70,0,1,0,1,0
59698,445,0,0,drop,70,70,0,1,0,1,0
59947,445,0,0,drop,66,66,0,1,0,1,0
64530,445,0,0,drop,70,70,0,1,0,1,0
59944,445,0,0,drop,66,66,0,1,0,1,0
59693,445,0,0,drop,70,70,0,1,0,1,0
44466,443,54385,443,allow,466,392,74,4,0,3,1
59936,445,0,0,drop,66,66,0,1,0,1,0
59935,445,0,0,drop,66,66,0,1,0,1,0
59680,445,0,0,drop,70,70,0,1,0,1,0
64518,445,0,0,deny,70,70,0,1,0,1,0
64516,445,0,0,drop,70,70,0,1,0,1,0
64517,445,0,0,drop,70,70,0,1,0,1,0
59919,445,0,0,drop,66,66,0,1,0,1,0
59922,445,0,0,drop,66,66,0,1,0,1,0
59917,445,0,0,drop,66,66,0,1,0,1,0
59920,445,0,0,drop,66,66,0,1,0,1,0
59921,445,0,0,drop,66,66,0,1,0,1,0
59918,445,0,0,drop,66,66,0,1,0,1,0
59916,445,0,0,drop,66,66,0,1,0,1,0
59914,445,0,0,drop,66,66,0,1,0,1,0
59677,445,0,0,drop,70,70,0,1,0,1,0
58371,23,0,0,deny,60,60,0,1,0,1,0
59673,445,0,0,drop,70,70,0,1,0,1,0
59671,445,0,0,drop,70,70,0,1,0,1,0
64511,445,0,0,drop,70,70,0,1,0,1,0
64509,445,0,0,drop,70,70,0,1,0,1,0
57538,23,0,0,deny,60,60,0,1,0,1,0
64504,445,0,0,drop,70,70,0,1,0,1,0
59669,445,0,0,drop,70,70,0,1,0,1,0
59900,445,0,0,drop,66,66,0,1,0,1,0
59902,445,0,0,drop,66,66,0,1,0,1,0
59899,445,0,0,drop,66,66,0,1,0,1,0
64497,445,0,0,drop,70,70,0,1,0,1,0
64485,445,0,0,drop,70,70,0,1,0,1,0
59662,445,0,0,drop,70,70,0,1,0,1,0
59660,445,0,0,drop,70,70,0,1,0,1,0
59659,445,0,0,drop,70,70,0,1,0,1,0
59658,445,0,0,drop,70,70,0,1,0,1,0
59657,445,0,0,drop,70,70,0,1,0,1,0
59654,445,0,0,drop,70,70,0,1,0,1,0
59651,445,0,0,drop,70,70,0,1,0,1,0
64478,445,0,0,drop,70,70,0,1,0,1,0
64477,445,0,0,drop,70,70,0,1,0,1,0
64474,445,0,0,drop,70,70,0,1,0,1,0
59889,445,0,0,drop,66,66,0,1,0,1,0
59639,445,0,0,drop,70,70,0,1,0,1,0
59638,445,0,0,drop,70,70,0,1,0,1,0
59634,445,0,0,drop,70,70,0,1,0,1,0
59628,445,0,0,drop,70,70,0,1,0,1,0
56766,53,34150,53,allow,204,104,100,2,30,1,1
55022,53,30402,53,allow,772,103,669,2,30,1,1
56004,53,42302,53,allow,172,88,84,2,30,1,1
64068,53,64068,53,allow,1184,83,1101,4,59,2,2
55742,53,41755,53,allow,186,95,91,2,31,1,1
57321,53,34343,53,allow,762,98,664,2,30,1,1
49177,53,53466,53,allow,735,88,647,2,30,1,1
65264,53,2001,53,allow,738,86,652,2,30,1,1
64810,53,33589,53,allow,272,93,179,4,33,2,2
49759,53,54195,53,allow,164,84,80,2,31,1,1
50299,53,31351,53,allow,770,102,668,2,30,1,1
55580,53,25974,53,allow,190,97,93,2,30,1,1
49742,53,64012,53,allow,731,91,640,2,30,1,1
64172,53,18592,53,allow,194,99,95,2,30,1,1
57226,53,4215,53,allow,88,88,0,1,30,1,0
55187,53,20282,53,allow,256,93,163,2,30,1,1
55337,53,28465,53,allow,196,100,96,2,30,1,1
65304,53,37771,53,allow,190,97,93,2,30,1,1
56974,53,21612,53,allow,814,110,704,2,30,1,1
55238,53,7598,53,allow,168,86,82,2,31,1,1
55776,53,13718,53,allow,182,93,89,3,33,2,1
56829,53,58561,53,allow,170,87,83,2,30,1,1
64711,53,23065,53,allow,760,97,663,2,30,1,1
55211,53,19820,53,allow,760,97,663,2,30,1,1
64902,53,48255,53,allow,762,98,664,2,30,1,1
56509,53,41875,53,allow,747,90,657,2,31,1,1
57307,53,57558,53,allow,170,87,83,2,31,1,1
56128,53,30035,53,allow,744,89,655,2,31,1,1
55820,53,6966,53,allow,168,86,82,2,31,1,1
56470,53,21021,53,allow,196,100,96,2,31,1,1
64421,53,64542,53,allow,172,88,84,2,31,1,1
56204,53,35079,53,allow,190,97,93,2,31,1,1
50324,53,1643,53,allow,754,94,660,2,31,1,1
57907,53,57907,53,allow,228,97,131,2,31,1,1
56180,53,48216,53,allow,757,98,659,2,31,1,1
49918,53,24031,53,allow,196,100,96,2,31,1,1
56892,53,3600,53,allow,198,101,97,2,31,1,1
55067,53,2725,53,allow,164,84,80,2,31,1,1
57302,53,18711,53,allow,770,102,668,2,31,1,1
55413,53,9671,53,allow,216,110,106,2,31,1,1
64976,53,22301,53,allow,186,95,91,2,31,1,1
55912,53,49501,53,allow,198,101,97,2,31,1,1
56310,53,55159,53,allow,760,97,663,2,31,1,1
55283,53,5653,53,allow,754,94,660,2,31,1,1
64628,53,57301,53,allow,198,101,97,2,31,1,1
55970,53,39090,53,allow,810,108,702,2,31,1,1
49410,53,65177,53,allow,172,88,84,2,31,1,1
56152,53,61194,53,allow,190,97,93,2,31,1,1
55808,53,45901,53,allow,738,86,652,2,31,1,1
64692,53,27620,53,allow,760,97,663,2,31,1,1
55399,53,7515,53,allow,176,90,86,2,31,1,1
56330,53,30393,53,allow,198,101,97,2,31,1,1
56461,53,50926,53,allow,760,96,664,2,31,1,1
57363,53,6725,53,allow,172,88,84,2,31,1,1
49451,53,46529,53,allow,757,98,659,2,31,1,1
50010,53,39739,53,allow,756,95,661,2,31,1,1
57418,53,27035,53,allow,758,96,662,2,31,1,1
55969,53,43128,53,allow,731,91,640,2,31,1,1
65515,53,32592,53,allow,204,104,100,2,31,1,1
50518,53,60220,53,allow,802,104,698,2,31,1,1
59629,445,0,0,drop,70,70,0,1,0,1,0
64467,445,0,0,drop,70,70,0,1,0,1,0
59617,445,0,0,drop,70,70,0,1,0,1,0
49298,53,53447,53,allow,230,102,128,2,30,1,1
64366,53,57312,53,allow,234,94,140,2,30,1,1
49773,53,59337,53,allow,225,110,115,2,30,1,1
64559,53,24538,53,allow,182,94,88,2,30,1,1
56004,53,58058,53,allow,178,94,84,2,30,1,1
49953,53,45166,53,allow,214,110,104,2,30,1,1
60863,443,14093,443,allow,134,60,74,3,5,2,1
64391,53,9777,53,allow,209,102,107,2,29,1,1
56204,53,35086,53,allow,195,102,93,2,30,1,1
64665,53,19631,53,allow,181,94,87,2,31,1,1
56470,53,41515,53,allow,198,102,96,2,30,1,1
56984,53,20901,53,allow,199,102,97,2,29,1,1
49906,53,24653,53,allow,200,94,106,2,29,1,1
57122,53,4958,53,allow,199,102,97,2,29,1,1
45862,443,6882,443,allow,234,234,0,4,11,4,0
49229,53,40938,53,allow,183,94,89,2,29,1,1
55358,53,38932,53,allow,183,94,89,2,29,1,1
65430,53,43606,53,allow,305,94,211,2,29,1,1
57122,53,16456,53,allow,199,102,97,2,29,1,1
56984,53,7040,53,allow,199,102,97,2,29,1,1
56984,53,53152,53,allow,199,102,97,2,29,1,1
49949,53,18474,53,allow,193,102,91,2,30,1,1
57275,53,57643,53,allow,199,102,97,2,30,1,1
55752,53,32253,53,allow,177,94,83,2,30,1,1
37565,123,4980,123,allow,184,94,90,2,30,1,1
50581,53,22242,53,allow,177,94,83,2,30,1,1
65273,53,64303,53,allow,226,102,124,2,30,1,1
49181,53,18919,53,allow,184,102,82,2,30,1,1
49167,53,55211,53,allow,258,94,164,2,30,1,1
36368,80,54133,80,allow,78,78,0,1,5,1,0
56766,53,19363,53,allow,210,110,100,2,30,1,1
52914,443,10656,443,allow,70,70,0,1,5,1,0
56894,53,27064,53,allow,178,94,84,2,30,1,1
64949,53,27960,53,allow,472,124,348,4,39,2,2
55489,53,44022,53,allow,185,102,83,2,30,1,1
57590,53,59223,53,allow,260,86,174,2,30,1,1
60462,80,40235,80,allow,1588,553,1035,10,75,6,4
56422,53,41175,53,allow,199,102,97,2,30,1,1
55808,53,32888,53,allow,183,94,89,2,30,1,1
64445,53,20808,53,allow,269,94,175,2,30,1,1
55808,53,36895,53,allow,183,94,89,2,30,1,1
56646,80,51204,80,allow,234,234,0,4,12,4,0
64559,53,29849,53,allow,198,110,88,2,30,1,1
64172,53,61363,53,allow,361,99,262,4,54,2,2
56766,53,15187,53,allow,210,110,100,2,30,1,1
49812,53,48839,53,allow,392,101,291,4,39,2,2
56236,53,43042,53,allow,241,94,147,2,30,1,1
55934,53,48489,53,allow,196,102,94,2,30,1,1
55934,53,60885,53,allow,196,102,94,2,30,1,1
49181,53,64897,53,allow,168,86,82,2,30,1,1
49364,53,61056,53,allow,779,86,693,2,30,1,1
56766,53,59139,53,allow,210,110,100,2,30,1,1
56892,53,6597,53,allow,199,102,97,2,30,1,1
64579,53,56844,53,allow,178,94,84,2,30,1,1
49837,53,44716,53,allow,734,86,648,2,30,1,1
49734,53,20221,53,allow,216,110,106,2,30,1,1
55391,53,33139,53,allow,210,110,100,2,30,1,1
55912,53,11122,53,allow,199,102,97,2,30,1,1
57385,53,7964,53,allow,197,102,95,2,30,1,1
65491,53,31323,53,allow,193,102,91,2,33,1,1
50700,80,7007,80,allow,142,142,0,1,5,1,0
64276,53,63257,53,allow,398,105,293,4,46,2,2
50195,53,23918,53,allow,199,102,97,2,30,1,1
64879,53,48255,53,allow,356,118,238,2,30,1,1
50581,53,15550,53,allow,185,102,83,2,30,1,1
64579,53,27350,53,allow,178,94,84,2,30,1,1
50168,53,56159,53,allow,211,78,133,2,30,1,1
64867,53,35181,53,allow,184,86,98,2,30,1,1
56829,53,52849,53,allow,185,102,83,2,30,1,1
55133,53,13417,53,allow,168,86,82,2,30,1,1
37027,53,20580,53,allow,168,78,90,2,30,1,1
56152,53,29649,53,allow,195,102,93,2,30,1,1
56704,53,2195,53,allow,177,94,83,2,30,1,1
53221,53,3242,53,allow,165,78,87,2,30,1,1
64421,53,34149,53,allow,178,94,84,2,30,1,1
49174,53,10014,53,allow,323,107,216,4,47,2,2
65304,53,22589,53,allow,308,97,211,4,33,2,2
53721,443,43069,443,allow,70,70,0,2,7,2,0
49577,53,58264,53,allow,389,134,255,2,29,1,1
49734,53,21745,53,allow,216,110,106,2,30,1,1
55238,53,10880,53,allow,168,86,82,2,30,1,1
65304,53,31926,53,allow,195,102,93,2,29,1,1
50347,53,2188,53,allow,756,94,662,2,29,1,1
49675,53,62598,53,allow,199,102,97,2,29,1,1
56496,53,36684,53,allow,164,86,78,2,29,1,1
55776,53,26753,53,allow,271,93,178,4,30,2,2
56004,53,60416,53,allow,178,94,84,2,29,1,1
49355,53,6777,53,allow,168,86,82,2,29,1,1
49825,53,24008,53,allow,814,110,704,2,29,1,1
55890,53,15703,53,allow,193,102,91,2,29,1,1
57122,53,57720,53,allow,199,102,97,2,29,1,1
56717,53,63655,53,allow,178,94,84,2,30,1,1
56416,53,40943,53,allow,969,86,883,2,29,1,1
64955,53,3638,53,allow,210,110,100,2,29,1,1
55238,53,60752,53,allow,168,86,82,2,29,1,1
49734,53,34033,53,allow,216,110,106,2,30,1,1
55489,53,35095,53,allow,177,94,83,2,30,1,1
56263,53,57632,53,allow,214,110,104,2,31,1,1
55884,53,23694,53,allow,438,180,258,6,30,3,3
57307,53,5441,53,allow,177,94,83,2,30,1,1
57057,53,64992,53,allow,194,102,92,2,31,1,1
55820,53,20613,53,allow,168,86,82,2,30,1,1
64810,53,44808,53,allow,272,93,179,4,33,2,2
49986,53,46060,53,allow,779,110,669,2,30,1,1
55808,53,41787,53,allow,183,94,89,2,30,1,1
49935,53,57757,53,allow,775,102,673,2,30,1,1
49949,53,15582,53,allow,193,102,91,2,30,1,1
55441,53,20729,53,allow,216,110,106,2,30,1,1
55337,53,58173,53,allow,198,102,96,2,30,1,1
49610,53,48262,53,allow,241,94,147,2,30,1,1
50195,53,43781,53,allow,199,102,97,2,30,1,1
64016,53,52366,53,allow,184,94,90,2,30,1,1
64985,53,37843,53,allow,194,102,92,2,30,1,1
49759,53,54239,53,allow,166,86,80,2,30,1,1
65018,53,21026,53,allow,168,94,74,2,31,1,1
55912,53,4881,53,allow,199,102,97,2,31,1,1
57363,53,22472,53,allow,178,94,84,2,30,1,1
50187,53,34456,53,allow,168,78,90,2,30,1,1
65220,53,55029,53,allow,178,94,84,2,30,1,1
55441,53,33231,53,allow,216,110,106,2,30,1,1
49953,53,46343,53,allow,214,110,104,2,30,1,1
56422,53,18940,53,allow,199,102,97,2,30,1,1
64956,53,29274,53,allow,196,102,94,2,30,1,1
64814,53,26949,53,allow,165,86,79,2,31,1,1
65485,53,26521,53,allow,184,94,90,2,31,1,1
65238,53,15919,53,allow,168,86,82,2,31,1,1
65275,53,14086,53,allow,168,86,82,2,31,1,1
55413,53,59906,53,allow,216,110,106,2,31,1,1
41886,53,64973,53,allow,168,78,90,2,31,1,1
65249,53,43445,53,allow,733,94,639,2,30,1,1
56330,53,49598,53,allow,199,102,97,2,30,1,1
50340,53,17641,53,allow,189,102,87,2,31,1,1
64450,53,63147,53,allow,196,94,102,2,31,1,1
55051,53,44193,53,allow,167,86,81,2,31,1,1
49532,53,18389,53,allow,443,182,261,6,31,3,3
56979,53,43376,53,allow,180,94,86,2,31,1,1
57307,53,15696,53,allow,177,94,83,2,30,1,1
56979,53,3476,53,allow,180,94,86,2,30,1,1
64964,53,59512,53,allow,197,102,95,2,31,1,1
56470,53,54674,53,allow,198,102,96,2,31,1,1
57142,53,22612,53,allow,165,86,79,2,31,1,1
56152,53,5986,53,allow,195,102,93,2,31,1,1
49849,53,33985,53,allow,173,94,79,2,31,1,1
50167,53,41841,53,allow,260,86,174,2,30,1,1
56770,53,31600,53,allow,779,86,693,2,30,1,1
55962,53,7744,53,allow,193,102,91,2,30,1,1
49626,53,39799,53,allow,969,86,883,2,30,1,1
64592,53,28124,53,allow,197,94,103,2,30,1,1
64154,53,43771,53,allow,194,102,92,2,30,1,1
55238,53,27709,53,allow,168,86,82,2,31,1,1
64956,53,26166,53,allow,196,102,94,2,30,1,1
56101,53,38415,53,allow,194,102,92,2,31,1,1
64814,53,35715,53,allow,173,94,79,2,30,1,1
57228,53,47428,53,allow,199,102,97,2,30,1,1
55399,53,9206,53,allow,180,94,86,2,31,1,1
65039,53,20269,53,allow,258,94,164,2,31,1,1
64976,53,40742,53,allow,193,102,91,2,31,1,1
56892,53,32986,53,allow,199,102,97,2,31,1,1
49918,53,25518,53,allow,198,102,96,2,31,1,1
64547,53,28372,53,allow,367,102,265,2,31,1,1
56063,53,29074,53,allow,196,102,94,2,31,1,1
55580,53,4575,53,allow,195,102,93,2,31,1,1
55392,53,27900,53,allow,195,102,93,2,31,1,1
64624,53,46919,53,allow,228,94,134,2,30,1,1
49918,53,41805,53,allow,198,102,96,2,30,1,1
49410,53,54828,53,allow,178,94,84,2,30,1,1
56330,53,48273,53,allow,199,102,97,2,30,1,1
49671,53,2651,53,allow,166,86,80,2,31,1,1
64985,53,34087,53,allow,194,102,92,2,30,1,1
50321,53,23352,53,allow,438,180,258,6,30,3,3
65018,53,37688,53,allow,152,78,74,2,30,1,1
56204,53,16211,53,allow,195,102,93,2,30,1,1
55399,53,43504,53,allow,180,94,86,2,30,1,1
59874,445,0,0,drop,66,66,0,1,0,1,0
59871,445,0,0,drop,66,66,0,1,0,1,0
64460,445,0,0,drop,70,70,0,1,0,1,0
64454,445,0,0,drop,70,70,0,1,0,1,0
64452,445,0,0,drop,70,70,0,1,0,1,0
59613,445,0,0,drop,70,70,0,1,0,1,0
59865,445,0,0,drop,66,66,0,1,0,1,0
59862,445,0,0,drop,66,66,0,1,0,1,0
59857,445,0,0,drop,66,66,0,1,0,1,0
59855,445,0,0,drop,66,66,0,1,0,1,0
59861,445,0,0,drop,66,66,0,1,0,1,0
59853,445,0,0,drop,66,66,0,1,0,1,0
59851,445,0,0,drop,66,66,0,1,0,1,0
59850,445,0,0,drop,66,66,0,1,0,1,0
59604,445,0,0,drop,70,70,0,1,0,1,0
59602,445,0,0,drop,70,70,0,1,0,1,0
59601,445,0,0,drop,70,70,0,1,0,1,0
59598,445,0,0,drop,70,70,0,1,0,1,0
64444,445,0,0,drop,70,70,0,1,0,1,0
59597,445,0,0,drop,70,70,0,1,0,1,0
64441,445,0,0,drop,70,70,0,1,0,1,0
64439,445,0,0,drop,70,70,0,1,0,1,0
64437,445,0,0,drop,70,70,0,1,0,1,0
59591,445,0,0,drop,70,70,0,1,0,1,0
64436,445,0,0,drop,70,70,0,1,0,1,0
64432,445,0,0,drop,70,70,0,1,0,1,0
59846,445,0,0,drop,66,66,0,1,0,1,0
64428,445,0,0,drop,70,70,0,1,0,1,0
59841,445,0,0,drop,66,66,0,1,0,1,0
59840,445,0,0,drop,66,66,0,1,0,1,0
59838,445,0,0,drop,66,66,0,1,0,1,0
59583,445,0,0,drop,70,70,0,1,0,1,0
59580,445,0,0,drop,70,70,0,1,0,1,0
59837,445,0,0,drop,66,66,0,1,0,1,0
59576,445,0,0,drop,70,70,0,1,0,1,0
64420,445,0,0,drop,70,70,0,1,0,1,0
59575,445,0,0,drop,70,70,0,1,0,1,0
59571,445,0,0,drop,70,70,0,1,0,1,0
59826,445,0,0,drop,66,66,0,1,0,1,0
59569,445,0,0,drop,70,70,0,1,0,1,0
59818,445,0,0,drop,66,66,0,1,0,1,0
64404,445,0,0,drop,70,70,0,1,0,1,0
59565,445,0,0,drop,70,70,0,1,0,1,0
59815,445,0,0,drop,66,66,0,1,0,1,0
59809,445,0,0,drop,66,66,0,1,0,1,0
59803,445,0,0,drop,66,66,0,1,0,1,0
59552,445,0,0,drop,70,70,0,1,0,1,0
64390,445,0,0,drop,70,70,0,1,0,1,0
64388,445,0,0,drop,70,70,0,1,0,1,0
59549,445,0,0,drop,70,70,0,1,0,1,0
59791,445,0,0,drop,66,66,0,1,0,1,0
59785,445,0,0,drop,66,66,0,1,0,1,0
59789,445,0,0,drop,66,66,0,1,0,1,0
59790,445,0,0,drop,66,66,0,1,0,1,0
59787,445,0,0,drop,66,66,0,1,0,1,0
59792,445,0,0,drop,66,66,0,1,0,1,0
59788,445,0,0,drop,66,66,0,1,0,1,0
59786,445,0,0,drop,66,66,0,1,0,1,0
59544,445,0,0,drop,70,70,0,1,0,1,0
59543,445,0,0,drop,70,70,0,1,0,1,0
59541,445,0,0,drop,70,70,0,1,0,1,0
64381,445,0,0,drop,70,70,0,1,0,1,0
64379,445,0,0,drop,70,70,0,1,0,1,0
64378,445,0,0,drop,70,70,0,1,0,1,0
64375,445,0,0,drop,70,70,0,1,0,1,0
59770,445,0,0,drop,66,66,0,1,0,1,0
59773,445,0,0,drop,66,66,0,1,0,1,0
59771,445,0,0,drop,66,66,0,1,0,1,0
64368,445,0,0,drop,70,70,0,1,0,1,0
59534,445,0,0,drop,70,70,0,1,0,1,0
64361,445,0,0,drop,70,70,0,1,0,1,0
64357,445,0,0,drop,70,70,0,1,0,1,0
59532,445,0,0,drop,70,70,0,1,0,1,0
64091,53,52948,53,allow,172,88,84,2,30,1,1
55006,53,7313,53,allow,711,87,624,2,30,1,1
56330,53,38670,53,allow,760,97,663,2,30,1,1
50562,80,50562,80,allow,1696,996,700,11,22,6,5
64964,53,20852,53,allow,194,99,95,2,31,1,1
55857,53,27164,53,allow,192,98,94,2,30,1,1
37617,443,6093,443,allow,1654,931,723,20,16,11,9
65363,53,16393,53,allow,747,93,654,2,30,1,1
64986,53,36194,53,allow,182,93,89,2,31,1,1
49208,53,22620,53,allow,578,286,292,9,15,5,4
62039,443,46235,443,allow,356,60,296,6,18,2,4
64956,53,25279,53,allow,192,98,94,2,30,1,1
49272,53,25138,53,allow,168,86,82,3,44,2,1
56775,53,1038,53,allow,733,85,648,2,30,1,1
55271,53,11910,53,allow,754,94,660,2,30,1,1
56979,53,36485,53,allow,176,90,86,2,31,1,1
57371,53,32883,53,allow,212,108,104,2,31,1,1
55392,53,38891,53,allow,190,97,93,2,31,1,1
56611,53,54936,53,allow,170,87,83,2,31,1,1
49209,53,10202,53,allow,198,101,97,2,31,1,1
49769,53,37724,53,allow,780,93,687,2,31,1,1
57228,53,5585,53,allow,198,101,97,2,30,1,1
64029,53,31401,53,allow,176,90,86,2,30,1,1
57115,53,15026,53,allow,756,95,661,2,30,1,1
56620,53,43601,53,allow,762,98,664,2,30,1,1
49931,53,19319,53,allow,190,97,93,2,31,1,1
49663,53,12596,53,allow,190,97,93,2,31,1,1
50509,53,14571,53,allow,789,110,679,2,31,1,1
65024,53,56492,53,allow,174,89,85,2,31,1,1
56085,53,59161,53,allow,166,85,81,2,31,1,1
55867,53,4524,53,allow,184,94,90,2,31,1,1
56063,53,65199,53,allow,192,98,94,2,31,1,1
55000,53,30925,53,allow,753,93,660,2,31,1,1
64321,53,31319,53,allow,190,97,93,2,31,1,1
57071,53,61611,53,allow,164,84,80,2,31,1,1
50407,53,51161,53,allow,749,89,660,2,31,1,1
49372,53,17589,53,allow,216,110,106,2,31,1,1
56626,53,22670,53,allow,710,89,621,2,31,1,1
57177,53,5547,53,allow,174,89,85,2,31,1,1
55728,53,39278,53,allow,190,97,93,2,31,1,1
49783,53,20382,53,allow,174,89,85,2,31,1,1
56009,53,7541,53,allow,172,88,84,2,31,1,1
56927,53,57010,53,allow,749,94,655,2,31,1,1
59531,445,0,0,drop,70,70,0,1,0,1,0
59530,445,0,0,drop,70,70,0,1,0,1,0
59529,445,0,0,drop,70,70,0,1,0,1,0
59526,445,0,0,drop,70,70,0,1,0,1,0
59523,445,0,0,drop,70,70,0,1,0,1,0
55153,53,36786,53,allow,733,94,639,2,30,1,1
64351,445,0,0,drop,70,70,0,1,0,1,0
64349,445,0,0,drop,70,70,0,1,0,1,0
59511,445,0,0,drop,70,70,0,1,0,1,0
59510,445,0,0,drop,70,70,0,1,0,1,0
59507,445,0,0,drop,70,70,0,1,0,1,0
59501,445,0,0,drop,70,70,0,1,0,1,0
59500,445,0,0,drop,70,70,0,1,0,1,0
59761,445,0,0,drop,66,66,0,1,0,1,0
64342,445,0,0,drop,70,70,0,1,0,1,0
64338,445,0,0,drop,70,70,0,1,0,1,0
59489,445,0,0,drop,70,70,0,1,0,1,0
50577,53,36248,53,allow,196,102,94,2,30,1,1
49498,53,4790,53,allow,245,102,143,2,30,1,1
49467,53,63815,53,allow,811,94,717,2,30,1,1
55051,53,56758,53,allow,167,86,81,2,30,1,1
65485,53,26681,53,allow,184,94,90,2,29,1,1
64793,53,25945,53,allow,168,86,82,2,29,1,1
55868,53,29665,53,allow,198,110,88,2,29,1,1
64991,53,31407,53,allow,196,94,102,2,29,1,1
50576,53,22318,53,allow,765,102,663,2,29,1,1
55868,53,11909,53,allow,198,110,88,2,29,1,1
65275,53,52488,53,allow,184,102,82,2,29,1,1
55776,53,11984,53,allow,271,93,178,4,32,2,2
65220,53,8622,53,allow,178,94,84,2,29,1,1
64602,53,17194,53,allow,751,94,657,2,29,1,1
55809,443,31063,443,allow,62,62,0,1,4,1,0
56349,53,33887,53,allow,168,86,82,2,29,1,1
50340,53,41286,53,allow,181,94,87,2,29,1,1
56349,53,14775,53,allow,184,102,82,2,29,1,1
50561,80,50561,80,allow,1695,995,700,11,21,6,5
49410,53,7557,53,allow,178,94,84,2,30,1,1
64898,53,53869,53,allow,167,86,81,2,29,1,1
55413,53,38303,53,allow,216,110,106,2,29,1,1
65515,53,42704,53,allow,210,110,100,2,29,1,1
64029,53,34743,53,allow,180,94,86,2,30,1,1
55392,53,8146,53,allow,195,102,93,2,30,1,1
55244,53,26585,53,allow,184,102,82,2,30,1,1
50241,53,50241,53,allow,260,106,154,2,32,1,1
45275,443,27366,443,allow,130,70,60,3,5,2,1
51535,443,45578,443,allow,202,70,132,3,11,1,2
57363,53,32810,53,allow,178,94,84,2,30,1,1
64776,53,62229,53,allow,198,94,104,2,30,1,1
49534,53,49440,53,allow,168,86,82,2,30,1,1
55176,53,23799,53,allow,181,94,87,2,30,1,1
64091,53,16270,53,allow,178,94,84,2,30,1,1
49209,53,59782,53,allow,199,102,97,2,30,1,1
58058,443,59293,443,allow,560,280,280,9,28,5,4
57071,53,59373,53,allow,166,86,80,2,30,1,1
65361,53,5566,53,allow,764,102,662,2,30,1,1
50495,53,24606,53,allow,182,102,80,2,30,1,1
64989,53,13455,53,allow,167,86,81,2,30,1,1
57057,53,25166,53,allow,194,102,92,2,30,1,1
49410,53,12703,53,allow,178,94,84,2,30,1,1
56330,53,26400,53,allow,199,102,97,2,30,1,1
64091,53,24113,53,allow,178,94,84,2,30,1,1
64419,53,6330,53,allow,210,102,108,2,30,1,1
64628,53,28992,53,allow,199,102,97,2,30,1,1
57142,53,15103,53,allow,165,86,79,2,30,1,1
55857,53,49437,53,allow,196,102,94,2,30,1,1
57307,53,14179,53,allow,177,94,83,2,30,1,1
56526,53,41730,53,allow,168,94,74,2,30,1,1
64989,53,9165,53,allow,183,102,81,2,30,1,1
64602,53,26542,53,allow,185,102,83,2,30,1,1
56204,53,48094,53,allow,195,102,93,2,30,1,1
57371,53,64674,53,allow,214,110,104,2,30,1,1
49510,53,7986,53,allow,754,94,660,2,30,1,1
49849,53,18692,53,allow,173,94,79,2,30,1,1
64562,53,22327,53,allow,371,94,277,2,30,1,1
54748,53,4076,53,allow,245,110,135,2,30,1,1
56063,53,52462,53,allow,196,102,94,2,30,1,1
50009,80,24998,80,allow,186,64,122,4,29,2,2
56263,53,42126,53,allow,214,110,104,2,30,1,1
55342,53,5897,53,allow,323,110,213,2,30,1,1
49605,53,37521,53,allow,239,110,129,2,30,1,1
55067,53,28702,53,allow,166,86,80,2,30,1,1
50495,53,55393,53,allow,166,86,80,2,30,1,1
64029,53,26038,53,allow,180,94,86,2,30,1,1
62037,80,19447,80,allow,1670,422,1248,13,17,5,8
37075,80,59950,80,allow,1597,783,814,10,15,5,5
64810,53,55417,53,allow,272,93,179,4,33,2,2
49788,53,26549,53,allow,302,97,205,4,43,2,2
64810,53,65205,53,allow,272,93,179,4,32,2,2
49953,53,27349,53,allow,214,110,104,2,29,1,1
56894,53,54448,53,allow,178,94,84,2,29,1,1
56152,53,35520,53,allow,195,102,93,2,29,1,1
62038,80,20471,80,allow,668,224,444,10,18,4,6
64162,53,51950,53,allow,255,118,137,2,29,1,1
51933,80,57196,80,allow,717,651,66,7,15,6,1
56710,53,63295,53,allow,193,94,99,2,29,1,1
57363,53,20262,53,allow,178,94,84,2,29,1,1
64898,53,30399,53,allow,167,86,81,2,29,1,1
64296,53,31060,53,allow,215,94,121,2,29,1,1
56263,53,62395,53,allow,214,110,104,2,29,1,1
49949,53,12218,53,allow,193,102,91,2,29,1,1
64480,53,30625,53,allow,276,126,150,2,30,1,1
55848,53,34320,53,allow,168,86,82,2,30,1,1
55848,53,45545,53,allow,184,102,82,2,30,1,1
57313,53,1093,53,allow,811,94,717,2,30,1,1
65176,53,36351,53,allow,193,102,91,2,31,1,1
49209,53,48140,53,allow,199,102,97,2,31,1,1
55495,53,27718,53,allow,210,110,100,2,31,1,1
64628,53,1942,53,allow,199,102,97,2,30,1,1
55166,53,22324,53,allow,177,94,83,2,30,1,1
64321,53,62198,53,allow,195,102,93,2,30,1,1
64091,53,62313,53,allow,178,94,84,2,30,1,1
49931,53,55078,53,allow,195,102,93,2,30,1,1
65013,53,26292,53,allow,473,105,368,4,30,2,2
49567,53,30320,53,allow,195,94,101,2,30,1,1
55867,53,6696,53,allow,184,94,90,2,30,1,1
64822,53,9057,53,allow,200,94,106,2,30,1,1
49622,53,6128,53,allow,209,102,107,2,30,1,1
55413,53,32368,53,allow,216,110,106,2,31,1,1
55828,53,29834,53,allow,181,94,87,2,31,1,1
52991,53,52991,53,allow,235,90,145,2,32,1,1
55857,53,19177,53,allow,437,98,339,4,41,2,2
59422,53,43330,53,allow,168,78,90,2,30,1,1
49534,53,53329,53,allow,168,86,82,2,30,1,1
65437,53,6994,53,allow,173,94,79,2,30,1,1
55176,53,15853,53,allow,181,94,87,2,30,1,1
55771,53,22517,53,allow,819,102,717,2,30,1,1
65437,53,4286,53,allow,165,86,79,2,30,1,1
64602,53,18957,53,allow,185,102,83,2,30,1,1
56526,53,17737,53,allow,168,94,74,2,30,1,1
65152,53,2972,53,allow,763,102,661,2,30,1,1
64986,53,9099,53,allow,183,94,89,2,30,1,1
56470,53,63709,53,allow,198,102,96,2,30,1,1
56085,53,41627,53,allow,167,86,81,2,30,1,1
50272,53,61330,53,allow,210,110,100,2,30,1,1
49181,53,15171,53,allow,491,98,393,4,40,2,2
64421,53,53236,53,allow,398,88,310,4,54,2,2
50577,53,42323,53,allow,819,102,717,2,30,1,1
65253,53,8346,53,allow,766,102,664,2,30,1,1
55771,53,25077,53,allow,196,102,94,2,30,1,1
65515,53,3298,53,allow,210,110,100,2,30,1,1
49379,53,52143,53,allow,260,102,158,2,30,1,1
55166,53,19784,53,allow,177,94,83,2,30,1,1
56594,53,5143,53,allow,173,94,79,2,30,1,1
55857,53,31762,53,allow,196,102,94,2,30,1,1
56185,53,13789,53,allow,167,86,81,2,30,1,1
57371,53,5536,53,allow,214,110,104,2,30,1,1
55742,53,18944,53,allow,193,102,91,2,30,1,1
55244,53,24318,53,allow,184,102,82,2,30,1,1
64029,53,40003,53,allow,180,94,86,2,30,1,1
57228,53,13792,53,allow,199,102,97,2,30,1,1
49663,53,65385,53,allow,195,102,93,2,30,1,1
57177,53,13049,53,allow,179,94,85,2,30,1,1
44385,53,19261,53,allow,212,78,134,2,30,1,1
64781,53,27529,53,allow,209,102,107,2,30,1,1
64169,53,50395,53,allow,209,102,107,2,30,1,1
57177,53,17706,53,allow,179,94,85,2,31,1,1
64244,53,63345,53,allow,199,102,97,2,31,1,1
64986,53,17110,53,allow,183,94,89,2,31,1,1
55728,53,24572,53,allow,195,102,93,2,31,1,1
49378,53,42308,53,allow,306,94,212,2,30,1,1
64586,53,9543,53,allow,183,94,89,2,30,1,1
57445,53,50878,53,allow,342,142,200,2,30,1,1
64598,53,46493,53,allow,342,142,200,2,30,1,1
65052,53,39393,53,allow,200,94,106,2,30,1,1
56142,53,42662,53,allow,194,102,92,2,31,1,1
57147,53,3974,53,allow,166,86,80,2,31,1,1
64174,53,10238,53,allow,180,94,86,2,31,1,1
64965,53,42321,53,allow,200,94,106,2,31,1,1
64964,53,28757,53,allow,197,102,95,2,31,1,1
56643,53,21130,53,allow,195,102,93,2,31,1,1
55641,53,24406,53,allow,184,94,90,2,31,1,1
57127,53,61936,53,allow,193,102,91,2,31,1,1
64627,53,3343,53,allow,199,102,97,2,31,1,1
55392,53,19876,53,allow,195,102,93,2,31,1,1
57126,53,6801,53,allow,183,94,89,2,31,1,1
56381,53,14303,53,allow,196,102,94,2,31,1,1
50000,53,12799,53,allow,216,110,106,2,31,1,1
64989,53,29167,53,allow,214,94,120,2,31,1,1
64607,53,58592,53,allow,211,110,101,2,31,1,1
49214,53,64649,53,allow,227,102,125,2,30,1,1
56005,53,41493,53,allow,403,142,261,2,30,1,1
64922,53,2264,53,allow,209,102,107,2,30,1,1
64803,53,18696,53,allow,403,142,261,2,31,1,1
56085,53,39673,53,allow,167,86,81,2,31,1,1
55596,53,25789,53,allow,194,102,92,2,31,1,1
56063,53,23721,53,allow,196,102,94,2,31,1,1
55867,53,63583,53,allow,184,94,90,2,31,1,1
49209,53,27106,53,allow,199,102,97,2,31,1,1
49346,53,44128,53,allow,164,78,86,2,31,1,1
56145,53,42798,53,allow,458,188,270,6,31,3,3
49420,53,64966,53,allow,183,94,89,2,31,1,1
64911,53,26816,53,allow,209,110,99,2,31,1,1
56411,53,33416,53,allow,184,94,90,2,31,1,1
48634,443,39947,443,allow,448,78,370,6,25,1,5
44911,80,13176,80,allow,1052,612,440,10,15,5,5
49968,53,62146,53,allow,1412,94,1318,4,33,2,2
64987,53,36862,53,allow,410,100,310,4,55,2,2
55126,53,10895,53,allow,193,102,91,2,31,1,1
38450,443,8906,443,allow,593,473,120,4,15,2,2
59744,445,0,0,drop,66,66,0,1,0,1,0
59743,445,0,0,drop,66,66,0,1,0,1,0
64332,445,0,0,drop,70,70,0,1,0,1,0
59485,445,0,0,drop,70,70,0,1,0,1,0
64325,445,0,0,drop,70,70,0,1,0,1,0
64324,445,0,0,drop,70,70,0,1,0,1,0
64323,445,0,0,drop,70,70,0,1,0,1,0
59738,445,0,0,drop,66,66,0,1,0,1,0
59476,445,0,0,drop,70,70,0,1,0,1,0
59474,445,0,0,drop,70,70,0,1,0,1,0
59473,445,0,0,drop,70,70,0,1,0,1,0
59472,445,0,0,drop,70,70,0,1,0,1,0
59725,445,0,0,drop,66,66,0,1,0,1,0
59731,445,0,0,drop,66,66,0,1,0,1,0
59733,445,0,0,drop,66,66,0,1,0,1,0
59734,445,0,0,drop,66,66,0,1,0,1,0
59728,445,0,0,drop,66,66,0,1,0,1,0
59724,445,0,0,drop,66,66,0,1,0,1,0
59722,445,0,0,drop,66,66,0,1,0,1,0
59468,445,0,0,drop,70,70,0,1,0,1,0
64314,445,0,0,drop,70,70,0,1,0,1,0
64313,445,0,0,drop,70,70,0,1,0,1,0
64312,445,0,0,drop,70,70,0,1,0,1,0
64309,445,0,0,drop,70,70,0,1,0,1,0
59462,445,0,0,drop,70,70,0,1,0,1,0
64307,445,0,0,drop,70,70,0,1,0,1,0
64306,445,0,0,drop,70,70,0,1,0,1,0
59718,445,0,0,drop,66,66,0,1,0,1,0
59455,445,0,0,drop,70,70,0,1,0,1,0
59714,445,0,0,drop,66,66,0,1,0,1,0
59453,445,0,0,drop,70,70,0,1,0,1,0
59712,445,0,0,drop,66,66,0,1,0,1,0
59710,445,0,0,drop,66,66,0,1,0,1,0
59709,445,0,0,drop,66,66,0,1,0,1,0
59449,445,0,0,drop,70,70,0,1,0,1,0
59447,445,0,0,drop,70,70,0,1,0,1,0
64292,445,0,0,drop,70,70,0,1,0,1,0
64284,445,0,0,drop,70,70,0,1,0,1,0
64282,445,0,0,drop,70,70,0,1,0,1,0
59443,445,0,0,drop,70,70,0,1,0,1,0
59697,445,0,0,drop,66,66,0,1,0,1,0
59441,445,0,0,drop,70,70,0,1,0,1,0
59690,445,0,0,drop,66,66,0,1,0,1,0
64274,445,0,0,drop,70,70,0,1,0,1,0
59437,445,0,0,drop,70,70,0,1,0,1,0
59688,445,0,0,drop,66,66,0,1,0,1,0
59680,445,0,0,drop,66,66,0,1,0,1,0
59673,445,0,0,drop,66,66,0,1,0,1,0
59424,445,0,0,drop,70,70,0,1,0,1,0
59421,445,0,0,drop,70,70,0,1,0,1,0
64263,445,0,0,drop,70,70,0,1,0,1,0
64261,445,0,0,drop,70,70,0,1,0,1,0
64260,445,0,0,drop,70,70,0,1,0,1,0
59662,445,0,0,drop,66,66,0,1,0,1,0
59664,445,0,0,drop,66,66,0,1,0,1,0
59665,445,0,0,drop,66,66,0,1,0,1,0
59658,445,0,0,drop,66,66,0,1,0,1,0
59663,445,0,0,drop,66,66,0,1,0,1,0
59660,445,0,0,drop,66,66,0,1,0,1,0
59661,445,0,0,drop,66,66,0,1,0,1,0
59659,445,0,0,drop,66,66,0,1,0,1,0
42223,67,0,0,deny,60,60,0,1,0,1,0
59416,445,0,0,drop,70,70,0,1,0,1,0
59415,445,0,0,drop,70,70,0,1,0,1,0
59413,445,0,0,drop,70,70,0,1,0,1,0
64249,445,0,0,drop,70,70,0,1,0,1,0
64247,445,0,0,drop,70,70,0,1,0,1,0
64242,445,0,0,drop,70,70,0,1,0,1,0
49323,53,45688,53,allow,192,98,94,2,30,1,1
64627,53,17603,53,allow,198,101,97,2,30,1,1
64244,53,29357,53,allow,198,101,97,2,30,1,1
55938,53,49190,53,allow,780,93,687,2,30,1,1
50012,53,54567,53,allow,208,106,102,2,30,1,1
57189,53,57433,53,allow,174,89,85,2,30,1,1
57187,53,15982,53,allow,782,105,677,2,30,1,1
56991,53,36997,53,allow,748,106,642,2,30,1,1
57204,53,58502,53,allow,182,93,89,2,30,1,1
56381,53,44431,53,allow,192,98,94,2,31,1,1
56411,53,42159,53,allow,184,94,90,2,31,1,1
55641,53,45216,53,allow,184,94,90,2,31,1,1
55593,53,41754,53,allow,749,89,660,2,30,1,1
55596,53,37319,53,allow,188,96,92,2,31,1,1
64534,53,43156,53,allow,212,108,104,2,31,1,1
45259,53,45259,53,allow,176,78,98,2,30,1,1
65176,53,2902,53,allow,186,95,91,2,30,1,1
55006,53,44866,53,allow,789,110,679,2,30,1,1
55514,53,31515,53,allow,747,93,654,2,30,1,1
65294,53,15570,53,allow,710,89,621,2,30,1,1
56489,53,16732,53,allow,208,106,102,2,31,1,1
64911,53,61645,53,allow,202,103,99,2,31,1,1
56643,53,22354,53,allow,190,97,93,2,31,1,1
56661,53,9185,53,allow,297,102,195,4,34,2,2
64837,53,3342,53,allow,190,97,93,2,31,1,1
56171,53,61869,53,allow,756,95,661,2,30,1,1
64987,53,19027,53,allow,196,100,96,2,30,1,1
56690,53,19054,53,allow,802,104,698,2,30,1,1
56142,53,12873,53,allow,188,96,92,2,30,1,1
55828,53,3503,53,allow,178,91,87,2,30,1,1
56415,53,58262,53,allow,174,89,85,2,31,1,1
56094,53,60857,53,allow,764,99,665,2,31,1,1
64588,53,37209,53,allow,186,95,91,2,31,1,1
65246,53,33087,53,allow,174,89,85,2,31,1,1
45590,53,0,0,allow,82,82,0,1,31,1,0
65042,53,25956,53,allow,182,93,89,2,31,1,1
56627,53,42658,53,allow,186,95,91,2,31,1,1
57181,53,65198,53,allow,733,93,640,2,31,1,1
65512,53,60205,53,allow,744,95,649,2,31,1,1
57127,53,59492,53,allow,186,95,91,2,31,1,1
64174,53,49823,53,allow,176,90,86,2,31,1,1
65042,53,41893,53,allow,182,93,89,2,31,1,1
55344,53,18078,53,allow,208,106,102,2,31,1,1
63960,53,41492,53,allow,172,88,84,2,31,1,1
64555,53,55433,53,allow,166,85,81,2,31,1,1
56673,53,13818,53,allow,186,95,91,2,31,1,1
64619,53,54626,53,allow,174,89,85,2,31,1,1
55130,53,9076,53,allow,216,110,106,2,31,1,1
56785,53,64900,53,allow,186,95,91,2,31,1,1
55126,53,24901,53,allow,186,95,91,2,31,1,1
56889,53,27625,53,allow,206,105,101,2,31,1,1
55533,53,56018,53,allow,182,93,89,2,31,1,1
56387,53,9036,53,allow,182,93,89,2,31,1,1
49216,53,25748,53,allow,178,91,87,2,31,1,1
56387,53,7178,53,allow,182,93,89,2,31,1,1
49864,53,25609,53,allow,186,95,91,2,31,1,1
59644,445,0,0,drop,66,66,0,1,0,1,0
59642,445,0,0,drop,66,66,0,1,0,1,0
59641,445,0,0,drop,66,66,0,1,0,1,0
59406,445,0,0,drop,70,70,0,1,0,1,0
64240,445,0,0,drop,70,70,0,1,0,1,0
65410,53,23769,53,allow,216,94,122,2,30,1,1
59404,445,0,0,drop,70,70,0,1,0,1,0
64237,445,0,0,drop,70,70,0,1,0,1,0
63343,53,0,0,deny,74,74,0,1,0,1,0
59403,445,0,0,drop,70,70,0,1,0,1,0
59402,445,0,0,drop,70,70,0,1,0,1,0
59401,445,0,0,drop,70,70,0,1,0,1,0
59397,445,0,0,drop,70,70,0,1,0,1,0
59395,445,0,0,drop,70,70,0,1,0,1,0
59383,445,0,0,drop,70,70,0,1,0,1,0
59382,445,0,0,drop,70,70,0,1,0,1,0
59378,445,0,0,drop,70,70,0,1,0,1,0
59373,445,0,0,drop,70,70,0,1,0,1,0
64221,445,0,0,drop,70,70,0,1,0,1,0
64222,445,0,0,drop,70,70,0,1,0,1,0
64217,445,0,0,drop,70,70,0,1,0,1,0
59630,445,0,0,drop,66,66,0,1,0,1,0
37203,443,4528,443,allow,466,392,74,4,0,3,1
59361,445,0,0,drop,70,70,0,1,0,1,0
64215,445,0,0,drop,70,70,0,1,0,1,0
64213,445,0,0,drop,70,70,0,1,0,1,0
61000,1,0,0,deny,146,146,0,1,0,1,0
65322,53,28599,53,allow,395,102,293,2,30,1,1
64987,53,43588,53,allow,198,102,96,2,30,1,1
50575,53,21343,53,allow,184,94,90,2,30,1,1
49663,53,58279,53,allow,195,102,93,2,30,1,1
56269,53,36395,53,allow,102,102,0,1,30,1,0
50000,53,33265,53,allow,216,110,106,2,30,1,1
49420,53,61159,53,allow,183,94,89,2,30,1,1
50156,53,6756,53,allow,186,102,84,2,30,1,1
51111,80,8917,80,allow,366,240,126,7,21,5,2
64976,53,53844,53,allow,193,102,91,2,29,1,1
64421,53,32983,53,allow,178,94,84,2,29,1,1
56661,53,3079,53,allow,297,102,195,4,34,2,2
55912,53,45004,53,allow,199,102,97,2,29,1,1
57371,53,14687,53,allow,321,108,213,4,33,2,2
55350,53,27984,53,allow,177,94,83,2,29,1,1
56594,53,50396,53,allow,165,86,79,2,29,1,1
64507,53,28479,53,allow,382,102,280,2,29,1,1
57096,53,49643,53,allow,443,182,261,6,29,3,3
56611,53,17951,53,allow,177,94,83,2,29,1,1
64898,53,46183,53,allow,209,94,115,2,29,1,1
50440,53,52778,53,allow,458,188,270,6,29,3,3
55350,53,12521,53,allow,185,102,83,2,29,1,1
49312,53,33674,53,allow,306,94,212,2,29,1,1
49561,53,39252,53,allow,754,94,660,2,30,1,1
56611,53,12492,53,allow,177,94,83,2,29,1,1
55649,53,24364,53,allow,216,110,106,2,30,1,1
57189,53,16894,53,allow,179,94,85,2,30,1,1
55495,53,17025,53,allow,210,110,100,2,30,1,1
49746,53,8872,53,allow,290,102,188,2,30,1,1
49786,53,59022,53,allow,752,110,642,2,30,1,1
63943,53,44134,53,allow,196,94,102,2,30,1,1
50012,53,27557,53,allow,212,110,102,2,30,1,1
55641,53,38684,53,allow,184,94,90,2,30,1,1
55911,53,35640,53,allow,211,110,101,2,30,1,1
56489,53,43327,53,allow,212,110,102,2,30,1,1
56009,53,53982,53,allow,178,94,84,2,30,1,1
56381,53,54551,53,allow,196,102,94,2,30,1,1
57204,53,58516,53,allow,183,94,89,2,30,1,1
55533,53,40009,53,allow,183,94,89,2,30,1,1
38517,53,38517,53,allow,214,82,132,2,32,1,1
51485,443,20455,443,allow,828,390,438,11,40,4,7
49404,53,23314,53,allow,200,94,106,2,30,1,1
50209,53,30899,53,allow,749,94,655,2,30,1,1
65024,53,47698,53,allow,179,94,85,2,30,1,1
63929,53,15311,53,allow,195,94,101,2,30,1,1
57204,53,35848,53,allow,183,94,89,2,30,1,1
50575,53,41966,53,allow,184,94,90,2,30,1,1
57126,53,50266,53,allow,183,94,89,2,30,1,1
55621,53,47829,53,allow,453,186,267,6,30,3,3
49372,53,37424,53,allow,216,110,106,2,30,1,1
49254,53,55219,53,allow,265,110,155,2,30,1,1
49797,53,5232,53,allow,787,110,677,2,30,1,1
56269,53,62645,53,allow,816,102,714,2,30,1,1
56643,53,48653,53,allow,195,102,93,2,30,1,1
56415,53,51829,53,allow,179,94,85,2,30,1,1
49323,53,61963,53,allow,196,102,94,2,30,1,1
57127,53,64638,53,allow,193,102,91,2,30,1,1
47662,80,15716,80,allow,1067,697,370,8,63,5,3
64896,53,50820,53,allow,195,94,101,2,30,1,1
55495,53,27673,53,allow,210,110,100,2,30,1,1
36851,53,31171,53,allow,86,86,0,1,30,1,0
55828,53,17599,53,allow,181,94,87,2,30,1,1
64707,53,47683,53,allow,258,102,156,2,30,1,1
64607,53,1706,53,allow,211,110,101,2,30,1,1
56415,53,6950,53,allow,179,94,85,2,30,1,1
55464,53,43920,53,allow,216,94,122,2,30,1,1
64457,53,27221,53,allow,261,102,159,2,30,1,1
65146,53,65321,53,allow,335,102,233,2,30,1,1
56009,53,46044,53,allow,178,94,84,2,30,1,1
49420,53,47944,53,allow,183,94,89,2,30,1,1
64964,53,38711,53,allow,197,102,95,2,30,1,1
57071,53,6792,53,allow,166,86,80,2,30,1,1
56411,53,39978,53,allow,184,94,90,2,30,1,1
56645,80,11255,80,allow,234,234,0,4,12,4,0
56661,53,53473,53,allow,297,102,195,4,34,2,2
49323,53,40976,53,allow,196,102,94,2,31,1,1
56142,53,19071,53,allow,194,102,92,2,29,1,1
57071,53,20542,53,allow,166,86,80,2,29,1,1
55031,443,21855,443,allow,134,60,74,3,5,2,1
56185,53,12663,53,allow,183,102,81,2,29,1,1
64987,53,27930,53,allow,198,102,96,2,29,1,1
49384,53,28867,53,allow,305,93,212,4,48,2,2
64976,53,29065,53,allow,193,102,91,2,29,1,1
56979,53,50155,53,allow,180,94,86,2,29,1,1
64628,53,58574,53,allow,199,102,97,2,29,1,1
49671,53,15823,53,allow,166,86,80,2,29,1,1
64586,53,51199,53,allow,183,94,89,2,29,1,1
49811,53,52504,53,allow,300,118,182,2,29,1,1
50272,53,52496,53,allow,210,110,100,2,29,1,1
55728,53,18036,53,allow,195,102,93,2,29,1,1
50272,53,35628,53,allow,210,110,100,2,29,1,1
57147,53,63811,53,allow,166,86,80,2,29,1,1
57204,53,13761,53,allow,183,94,89,2,30,1,1
57131,53,26066,53,allow,168,78,90,2,30,1,1
55596,53,31644,53,allow,194,102,92,2,30,1,1
49783,53,25868,53,allow,179,94,85,2,30,1,1
64496,53,57419,53,allow,196,94,102,2,30,1,1
56889,53,27210,53,allow,211,110,101,2,30,1,1
56009,53,38515,53,allow,178,94,84,2,30,1,1
64619,53,25912,53,allow,179,94,85,2,31,1,1
55649,53,62328,53,allow,216,110,106,2,30,1,1
55728,53,52425,53,allow,195,102,93,2,30,1,1
64555,53,59391,53,allow,167,86,81,2,30,1,1
50037,53,65320,53,allow,195,102,93,2,31,1,1
64321,53,56788,53,allow,195,102,93,2,31,1,1
64321,53,14158,53,allow,296,97,199,4,53,2,2
65240,53,20571,53,allow,453,186,267,6,30,3,3
64986,53,34295,53,allow,183,94,89,2,30,1,1
64837,53,36950,53,allow,195,102,93,2,30,1,1
56085,53,34233,53,allow,167,86,81,2,30,1,1
55155,53,1843,53,allow,183,94,89,2,30,1,1
64872,53,21895,53,allow,166,86,80,2,31,1,1
56142,53,56422,53,allow,194,102,92,2,31,1,1
65489,53,57940,53,allow,531,97,434,4,35,2,2
57117,80,29144,80,allow,1049,679,370,8,16,5,3
64273,53,19409,53,allow,256,102,154,2,30,1,1
49931,53,2557,53,allow,195,102,93,2,30,1,1
56104,53,55768,53,allow,210,110,100,2,30,1,1
55830,53,41012,53,allow,184,94,90,2,30,1,1
55237,53,14253,53,allow,193,102,91,2,30,1,1
55159,53,57486,53,allow,168,86,82,2,30,1,1
56611,53,45220,53,allow,177,94,83,2,30,1,1
43176,53,34266,53,allow,168,78,90,2,30,1,1
56166,53,15271,53,allow,193,102,91,2,30,1,1
49730,53,58094,53,allow,767,102,665,2,30,1,1
64534,53,37006,53,allow,214,110,104,2,30,1,1
55237,53,28991,53,allow,193,102,91,2,30,1,1
55644,53,20547,53,allow,184,94,90,2,30,1,1
55808,53,26919,53,allow,179,94,85,2,30,1,1
55911,53,54432,53,allow,211,110,101,2,30,1,1
49845,53,42421,53,allow,168,86,82,2,30,1,1
56627,53,14624,53,allow,193,102,91,2,30,1,1
55130,53,35650,53,allow,216,110,106,2,30,1,1
49162,53,33354,53,allow,183,94,89,2,30,1,1
49563,53,27987,53,allow,200,102,98,2,31,1,1
55644,53,33807,53,allow,184,94,90,2,31,1,1
56104,53,51847,53,allow,210,110,100,2,31,1,1
56627,53,7670,53,allow,193,102,91,2,31,1,1
64174,53,11186,53,allow,180,94,86,2,31,1,1
65176,53,48862,53,allow,193,102,91,2,31,1,1
64244,53,1570,53,allow,199,102,97,2,31,1,1
64627,53,39841,53,allow,199,102,97,2,31,1,1
55344,53,62039,53,allow,212,110,102,2,30,1,1
56643,53,25715,53,allow,195,102,93,2,31,1,1
55596,53,30266,53,allow,194,102,92,2,31,1,1
64911,53,46196,53,allow,209,110,99,2,31,1,1
56166,53,32897,53,allow,193,102,91,2,31,1,1
56411,53,48736,53,allow,184,94,90,2,31,1,1
57127,53,17390,53,allow,193,102,91,2,31,1,1
64837,53,35241,53,allow,195,102,93,2,31,1,1
56426,53,37263,53,allow,184,94,90,2,31,1,1
57038,53,5859,53,allow,186,102,84,2,31,1,1
56041,53,17868,53,allow,179,94,85,2,31,1,1
49235,53,6024,53,allow,164,86,78,2,31,1,1
56381,53,46735,53,allow,196,102,94,2,31,1,1
55641,53,35786,53,allow,184,94,90,2,31,1,1
64428,53,26819,53,allow,299,97,202,4,44,2,2
59617,445,0,0,drop,66,66,0,1,0,1,0
59616,445,0,0,drop,66,66,0,1,0,1,0
59357,445,0,0,drop,70,70,0,1,0,1,0
64194,445,0,0,drop,70,70,0,1,0,1,0
59347,445,0,0,drop,70,70,0,1,0,1,0
59346,445,0,0,drop,70,70,0,1,0,1,0
59345,445,0,0,drop,70,70,0,1,0,1,0
59609,445,0,0,drop,66,66,0,1,0,1,0
59342,445,0,0,drop,70,70,0,1,0,1,0
59340,445,0,0,drop,70,70,0,1,0,1,0
59594,445,0,0,drop,66,66,0,1,0,1,0
59593,445,0,0,drop,66,66,0,1,0,1,0
59605,445,0,0,drop,66,66,0,1,0,1,0
59599,445,0,0,drop,66,66,0,1,0,1,0
59601,445,0,0,drop,66,66,0,1,0,1,0
59600,445,0,0,drop,66,66,0,1,0,1,0
59597,445,0,0,drop,66,66,0,1,0,1,0
64190,445,0,0,drop,70,70,0,1,0,1,0
64185,445,0,0,drop,70,70,0,1,0,1,0
64183,445,0,0,drop,70,70,0,1,0,1,0
64181,445,0,0,drop,70,70,0,1,0,1,0
59334,445,0,0,drop,70,70,0,1,0,1,0
59327,445,0,0,drop,70,70,0,1,0,1,0
64173,445,0,0,drop,70,70,0,1,0,1,0
59326,445,0,0,drop,70,70,0,1,0,1,0
59587,445,0,0,drop,66,66,0,1,0,1,0
59585,445,0,0,drop,66,66,0,1,0,1,0
59583,445,0,0,drop,66,66,0,1,0,1,0
59582,445,0,0,drop,66,66,0,1,0,1,0
59579,445,0,0,drop,66,66,0,1,0,1,0
59321,445,0,0,drop,70,70,0,1,0,1,0
59319,445,0,0,drop,70,70,0,1,0,1,0
64164,445,0,0,drop,70,70,0,1,0,1,0
59315,445,0,0,drop,70,70,0,1,0,1,0
64156,445,0,0,drop,70,70,0,1,0,1,0
59313,445,0,0,drop,70,70,0,1,0,1,0
59569,445,0,0,drop,66,66,0,1,0,1,0
59309,445,0,0,drop,70,70,0,1,0,1,0
59561,445,0,0,drop,66,66,0,1,0,1,0
64144,445,0,0,drop,70,70,0,1,0,1,0
59559,445,0,0,deny,66,66,0,1,0,1,0
59552,445,0,0,drop,66,66,0,1,0,1,0
59543,445,0,0,drop,66,66,0,1,0,1,0
59296,445,0,0,drop,70,70,0,1,0,1,0
59293,445,0,0,drop,70,70,0,1,0,1,0
64134,445,0,0,drop,70,70,0,1,0,1,0
64133,445,0,0,drop,70,70,0,1,0,1,0
64132,445,0,0,drop,70,70,0,1,0,1,0
59530,445,0,0,drop,66,66,0,1,0,1,0
55644,53,49999,53,allow,184,94,90,2,30,1,1
56104,53,14895,53,allow,204,104,100,2,30,1,1
56751,53,17361,53,allow,752,93,659,2,30,1,1
49563,53,8253,53,allow,200,102,98,2,30,1,1
56879,53,15562,53,allow,744,95,649,2,30,1,1
59904,443,14583,443,allow,694,370,324,12,34,7,5
65262,53,47231,53,allow,216,110,106,2,30,1,1
64862,53,32776,53,allow,206,105,101,2,30,1,1
64872,53,35777,53,allow,164,84,80,2,30,1,1
49247,53,6509,53,allow,478,196,282,6,64,3,3
57364,53,57364,53,allow,213,79,134,2,32,1,1
55808,53,62686,53,allow,174,89,85,2,30,1,1
55184,53,64437,53,allow,182,93,89,2,31,1,1
57629,80,39284,80,allow,1115,534,581,12,16,7,5
49245,53,3951,53,allow,190,97,93,2,31,1,1
64200,53,60467,53,allow,186,95,91,2,30,1,1
51107,80,61498,80,allow,366,240,126,7,21,5,2
49692,53,19952,53,allow,208,106,102,2,30,1,1
49845,53,59006,53,allow,168,86,82,2,30,1,1
56166,53,15904,53,allow,186,95,91,2,30,1,1
56730,53,51057,53,allow,733,86,647,2,30,1,1
65451,53,6208,53,allow,188,96,92,2,31,1,1
56426,53,19941,53,allow,184,94,90,2,31,1,1
64460,53,62568,53,allow,192,98,94,2,31,1,1
56041,53,27459,53,allow,174,89,85,2,31,1,1
49480,53,49480,53,allow,213,79,134,2,32,1,1
55000,443,17337,443,allow,134,60,74,3,10,2,1
48885,53,48885,53,allow,215,80,135,2,32,1,1
36307,80,3965,80,allow,1368,920,448,12,20,7,5
49162,53,42033,53,allow,182,93,89,2,30,1,1
55159,53,17196,53,allow,168,86,82,2,30,1,1
49825,53,42990,53,allow,168,86,82,2,30,1,1
49621,53,22875,53,allow,182,93,89,2,31,1,1
55630,53,58025,53,allow,194,99,95,2,31,1,1
64473,53,45182,53,allow,184,94,90,2,31,1,1
50037,53,57358,53,allow,190,97,93,2,30,1,1
57416,53,52623,53,allow,186,95,91,2,30,1,1
65107,53,21629,53,allow,186,95,91,2,31,1,1
64036,53,10774,53,allow,182,93,89,2,31,1,1
64475,53,56794,53,allow,184,94,90,2,31,1,1
51957,53,51957,53,allow,825,99,726,2,31,1,1
65144,53,52237,53,allow,204,104,100,2,31,1,1
49188,53,21489,53,allow,777,87,690,2,31,1,1
57397,53,25863,53,allow,182,93,89,2,31,1,1
56144,53,58343,53,allow,176,90,86,2,31,1,1
65049,53,59454,53,allow,184,94,90,2,31,1,1
59534,445,0,0,drop,66,66,0,1,0,1,0
59532,445,0,0,drop,66,66,0,1,0,1,0
59527,445,0,0,drop,66,66,0,1,0,1,0
59535,445,0,0,drop,66,66,0,1,0,1,0
59528,445,0,0,drop,66,66,0,1,0,1,0
59531,445,0,0,drop,66,66,0,1,0,1,0
59529,445,0,0,drop,66,66,0,1,0,1,0
59288,445,0,0,drop,70,70,0,1,0,1,0
59287,445,0,0,drop,70,70,0,1,0,1,0
59285,445,0,0,drop,70,70,0,1,0,1,0
55644,53,55094,53,allow,184,94,90,2,30,1,1
55444,23,0,0,deny,60,60,0,1,0,1,0
64131,445,0,0,drop,70,70,0,1,0,1,0
64122,445,0,0,drop,70,70,0,1,0,1,0
64123,445,0,0,drop,70,70,0,1,0,1,0
64121,445,0,0,drop,70,70,0,1,0,1,0
59514,445,0,0,drop,66,66,0,1,0,1,0
59513,445,0,0,drop,66,66,0,1,0,1,0
59512,445,0,0,drop,66,66,0,1,0,1,0
59278,445,0,0,drop,70,70,0,1,0,1,0
59276,445,0,0,drop,70,70,0,1,0,1,0
64112,445,0,0,drop,70,70,0,1,0,1,0
59275,445,0,0,drop,70,70,0,1,0,1,0
56413,53,33044,53,allow,338,110,228,2,30,1,1
56785,53,32079,53,allow,193,102,91,2,30,1,1
57416,53,15222,53,allow,193,102,91,2,30,1,1
64862,53,5762,53,allow,211,110,101,2,30,1,1
49552,80,31507,80,allow,1963,1067,896,11,15,6,5
49663,53,4720,53,allow,195,102,93,2,29,1,1
55828,53,62076,53,allow,181,94,87,2,29,1,1
55344,53,42459,53,allow,212,110,102,2,29,1,1
64534,53,57803,53,allow,214,110,104,2,30,1,1
56317,53,56317,53,allow,216,82,134,2,32,1,1
39326,53,39326,53,allow,233,90,143,2,32,1,1
51962,1024,18199,1024,allow,316,136,180,6,5,3,3
65189,53,21618,53,allow,734,94,640,2,29,1,1
49162,53,39735,53,allow,183,94,89,2,29,1,1
58997,443,10081,443,allow,70,70,0,1,4,1,0
64588,53,11970,53,allow,193,102,91,2,29,1,1
42847,443,14614,443,allow,162,102,60,2,4,1,1
65246,53,9355,53,allow,179,94,85,2,29,1,1
56444,53,36861,53,allow,730,102,628,2,29,1,1
63960,53,45995,53,allow,178,94,84,2,30,1,1
55830,53,49103,53,allow,184,94,90,2,29,1,1
56415,53,18388,53,allow,179,94,85,2,29,1,1
55155,53,2864,53,allow,183,94,89,2,29,1,1
50156,53,35377,53,allow,178,94,84,2,29,1,1
55533,53,54545,53,allow,183,94,89,2,29,1,1
64244,53,64721,53,allow,199,102,97,2,29,1,1
55155,53,64785,53,allow,183,94,89,2,29,1,1
55130,53,39778,53,allow,216,110,106,2,29,1,1
65042,53,26467,53,allow,183,94,89,2,29,1,1
55822,53,10353,53,allow,324,126,198,2,30,1,1
64837,53,39780,53,allow,195,102,93,2,30,1,1
53853,53,0,0,allow,139,70,69,2,30,1,1
65262,53,31670,53,allow,216,110,106,2,30,1,1
56426,53,49161,53,allow,184,94,90,2,30,1,1
64818,53,61380,53,allow,260,102,158,2,30,1,1
64473,53,9936,53,allow,184,94,90,2,30,1,1
64862,53,39051,53,allow,211,110,101,2,30,1,1
49563,53,27885,53,allow,200,102,98,2,30,1,1
64460,53,29713,53,allow,196,102,94,2,30,1,1
64416,53,56387,53,allow,291,110,181,2,30,1,1
56889,53,22522,53,allow,211,110,101,2,30,1,1
56358,53,65243,53,allow,210,110,100,2,33,1,1
49310,53,37425,53,allow,239,102,137,2,30,1,1
58058,80,25761,80,allow,318,192,126,6,21,4,2
65246,53,26370,53,allow,179,94,85,2,30,1,1
56673,53,10759,53,allow,193,102,91,2,30,1,1
64534,53,35373,53,allow,214,110,104,2,30,1,1
64795,53,2622,53,allow,338,110,228,2,30,1,1
65451,53,62075,53,allow,194,102,92,2,30,1,1
64897,53,54215,53,allow,312,94,218,2,30,1,1
49245,53,24840,53,allow,195,102,93,2,30,1,1
49419,53,29016,53,allow,252,102,150,2,30,1,1
65512,53,38019,53,allow,265,102,163,2,30,1,1
55533,53,2426,53,allow,183,94,89,2,30,1,1
56673,53,26407,53,allow,193,102,91,2,30,1,1
49692,53,65365,53,allow,212,110,102,2,30,1,1
64666,53,52653,53,allow,226,102,124,2,30,1,1
51109,80,7098,80,allow,366,240,126,7,20,5,2
64200,53,27722,53,allow,193,102,91,2,30,1,1
64200,53,25588,53,allow,193,102,91,2,30,1,1
65107,53,27622,53,allow,193,102,91,2,30,1,1
49692,53,33543,53,allow,212,110,102,2,30,1,1
64041,53,42434,53,allow,198,94,104,2,30,1,1
49692,53,30173,53,allow,212,110,102,2,30,1,1
63960,53,27823,53,allow,178,94,84,2,30,1,1
56532,53,37108,53,allow,164,86,78,2,30,1,1
49671,53,34167,53,allow,242,110,132,2,30,1,1
49551,80,48076,80,allow,1769,873,896,11,15,6,5
57436,66,13833,66,allow,70,70,0,2,7,2,0
56661,53,7946,53,allow,297,102,195,4,33,2,2
64627,53,53750,53,allow,305,101,204,4,44,2,2
49828,53,44800,53,allow,733,86,647,2,29,1,1
56166,53,54206,53,allow,193,102,91,2,29,1,1
41764,53,7946,53,allow,168,78,90,2,29,1,1
64872,53,24466,53,allow,730,102,628,2,29,1,1
51110,80,59490,80,allow,1524,1028,496,10,20,7,3
57177,53,20677,53,allow,179,94,85,2,29,1,1
49372,53,4796,53,allow,527,208,319,6,64,3,3
56627,53,58271,53,allow,193,102,91,2,29,1,1
55867,53,51725,53,allow,184,94,90,2,29,1,1
49216,53,14364,53,allow,181,94,87,2,30,1,1
49162,53,33526,53,allow,183,94,89,2,30,1,1
49940,53,16387,53,allow,257,110,147,2,29,1,1
55126,53,61612,53,allow,193,102,91,2,29,1,1
55184,53,59449,53,allow,183,94,89,2,30,1,1
56889,53,49457,53,allow,211,110,101,2,30,1,1
49372,53,58789,53,allow,216,110,106,2,30,1,1
56104,53,19874,53,allow,210,110,100,2,30,1,1
65262,53,52236,53,allow,216,110,106,2,30,1,1
49864,53,63965,53,allow,193,102,91,2,30,1,1
64460,53,42311,53,allow,196,102,94,2,31,1,1
49825,53,56726,53,allow,168,86,82,2,30,1,1
64036,53,20328,53,allow,183,94,89,2,30,1,1
65144,53,10538,53,allow,210,110,100,2,30,1,1
49669,53,30235,53,allow,197,94,103,2,30,1,1
49435,53,45474,53,allow,720,94,626,2,30,1,1
42846,443,19024,443,allow,162,102,60,2,5,1,1
49247,53,7662,53,allow,478,196,282,6,63,3,3
56673,53,29686,53,allow,193,102,91,2,30,1,1
56041,53,26244,53,allow,179,94,85,2,30,1,1
57416,53,53787,53,allow,193,102,91,2,30,1,1
64417,53,10923,53,allow,231,102,129,2,30,1,1
64555,53,55605,53,allow,167,86,81,2,30,1,1
65262,53,62763,53,allow,216,110,106,2,30,1,1
49216,53,15355,53,allow,181,94,87,2,30,1,1
65176,53,39241,53,allow,193,102,91,2,30,1,1
64862,53,53283,53,allow,211,110,101,2,30,1,1
49770,80,9129,80,allow,254,128,126,5,15,3,2
65246,53,35369,53,allow,179,94,85,2,30,1,1
55126,53,18152,53,allow,193,102,91,2,30,1,1
64911,53,45523,53,allow,209,110,99,2,30,1,1
65523,53,26977,53,allow,228,94,134,2,30,1,1
64200,53,53095,53,allow,193,102,91,2,30,1,1
44158,443,51060,443,allow,232,172,60,3,5,2,1
55130,53,20364,53,allow,216,110,106,2,30,1,1
55344,53,59156,53,allow,212,110,102,2,30,1,1
57038,53,2434,53,allow,186,102,84,2,30,1,1
56387,53,17582,53,allow,183,94,89,2,30,1,1
49235,53,22418,53,allow,172,94,78,2,30,1,1
63960,53,31296,53,allow,178,94,84,2,30,1,1
64514,53,1734,53,allow,209,102,107,2,30,1,1
55630,53,39473,53,allow,197,102,95,2,30,1,1
49864,53,57559,53,allow,193,102,91,2,30,1,1
56041,53,56903,53,allow,179,94,85,2,30,1,1
64473,53,39348,53,allow,184,94,90,2,31,1,1
55184,53,63377,53,allow,183,94,89,2,30,1,1
65025,53,23591,53,allow,347,94,253,2,30,1,1
53829,53,12567,53,allow,258,86,172,2,31,1,1
65451,53,9650,53,allow,194,102,92,2,31,1,1
65107,53,31681,53,allow,193,102,91,2,31,1,1
64319,53,34050,53,allow,193,102,91,2,31,1,1
65251,53,39893,53,allow,179,94,85,2,31,1,1
64619,53,39601,53,allow,179,94,85,2,31,1,1
64872,53,64528,53,allow,166,86,80,2,31,1,1
50037,53,63751,53,allow,195,102,93,2,31,1,1
49501,53,63385,53,allow,193,102,91,2,31,1,1
50037,53,12005,53,allow,195,102,93,2,30,1,1
55630,53,11814,53,allow,197,102,95,2,30,1,1
64070,53,32128,53,allow,243,94,149,2,31,1,1
55184,53,41873,53,allow,183,94,89,2,31,1,1
49216,53,46478,53,allow,316,91,225,4,32,2,2
42317,443,11761,443,allow,416,210,206,7,27,4,3
64103,445,0,0,drop,70,70,0,1,0,1,0
59274,445,0,0,drop,70,70,0,1,0,1,0
59273,445,0,0,drop,70,70,0,1,0,1,0
59271,445,0,0,drop,70,70,0,1,0,1,0
59267,445,0,0,drop,70,70,0,1,0,1,0
59255,445,0,0,drop,70,70,0,1,0,1,0
59254,445,0,0,drop,70,70,0,1,0,1,0
59251,445,0,0,drop,70,70,0,1,0,1,0
59244,445,0,0,drop,70,70,0,1,0,1,0
59245,445,0,0,drop,70,70,0,1,0,1,0
64094,445,0,0,drop,70,70,0,1,0,1,0
64093,445,0,0,drop,70,70,0,1,0,1,0
64092,445,0,0,drop,70,70,0,1,0,1,0
59503,445,0,0,drop,66,66,0,1,0,1,0
62143,23,0,0,deny,60,60,0,1,0,1,0
59233,445,0,0,drop,70,70,0,1,0,1,0
64087,445,0,0,drop,70,70,0,1,0,1,0
64084,445,0,0,drop,70,70,0,1,0,1,0
59487,445,0,0,drop,66,66,0,1,0,1,0
59486,445,0,0,drop,66,66,0,1,0,1,0
59228,445,0,0,drop,70,70,0,1,0,1,0
59220,445,0,0,drop,70,70,0,1,0,1,0
59219,445,0,0,drop,70,70,0,1,0,1,0
59218,445,0,0,drop,70,70,0,1,0,1,0
64073,445,0,0,drop,70,70,0,1,0,1,0
59215,445,0,0,drop,70,70,0,1,0,1,0
59213,445,0,0,drop,70,70,0,1,0,1,0
64068,445,0,0,drop,70,70,0,1,0,1,0
64067,445,0,0,drop,70,70,0,1,0,1,0
59481,445,0,0,drop,66,66,0,1,0,1,0
59476,445,0,0,drop,66,66,0,1,0,1,0
59475,445,0,0,drop,66,66,0,1,0,1,0
59474,445,0,0,drop,66,66,0,1,0,1,0
59466,445,0,0,drop,66,66,0,1,0,1,0
59470,445,0,0,drop,66,66,0,1,0,1,0
59467,445,0,0,drop,66,66,0,1,0,1,0
59465,445,0,0,drop,66,66,0,1,0,1,0
64059,445,0,0,drop,70,70,0,1,0,1,0
64057,445,0,0,drop,70,70,0,1,0,1,0
64056,445,0,0,drop,70,70,0,1,0,1,0
64053,445,0,0,drop,70,70,0,1,0,1,0
59206,445,0,0,drop,70,70,0,1,0,1,0
59199,445,0,0,drop,70,70,0,1,0,1,0
59197,445,0,0,drop,70,70,0,1,0,1,0
59458,445,0,0,drop,66,66,0,1,0,1,0
64044,445,0,0,drop,70,70,0,1,0,1,0
59456,445,0,0,drop,66,66,0,1,0,1,0
59193,445,0,0,drop,70,70,0,1,0,1,0
59454,445,0,0,drop,66,66,0,1,0,1,0
59452,445,0,0,drop,66,66,0,1,0,1,0
59191,445,0,0,drop,70,70,0,1,0,1,0
59450,445,0,0,drop,66,66,0,1,0,1,0
36893,67,0,0,deny,60,60,0,1,0,1,0
59187,445,0,0,drop,70,70,0,1,0,1,0
64037,445,0,0,drop,70,70,0,1,0,1,0
59186,445,0,0,drop,70,70,0,1,0,1,0
59440,445,0,0,drop,66,66,0,1,0,1,0
59181,445,0,0,drop,70,70,0,1,0,1,0
59432,445,0,0,drop,66,66,0,1,0,1,0
64017,445,0,0,drop,70,70,0,1,0,1,0
59429,445,0,0,drop,66,66,0,1,0,1,0
59168,445,0,0,drop,70,70,0,1,0,1,0
59422,445,0,0,drop,66,66,0,1,0,1,0
50272,443,27135,443,allow,772,432,340,12,18,7,5
43311,80,24777,80,allow,811,671,140,6,31,4,2
56572,53,56572,53,allow,253,99,154,2,32,1,1
54319,53,54319,53,allow,253,99,154,2,32,1,1
64912,53,12678,53,allow,182,93,89,2,31,1,1
56468,53,8242,53,allow,176,90,86,2,30,1,1
60380,443,29465,443,allow,70,70,0,1,5,1,0
64319,53,16100,53,allow,186,95,91,2,30,1,1
49501,53,44593,53,allow,186,95,91,2,31,1,1
39232,53,39232,53,allow,215,80,135,2,32,1,1
49837,53,8590,53,allow,176,90,86,2,30,1,1
64357,53,4119,53,allow,182,93,89,2,31,1,1
58467,53,16449,53,allow,235,95,140,2,31,1,1
49274,53,46367,53,allow,194,99,95,2,31,1,1
49312,53,34351,53,allow,767,102,665,2,31,1,1
56395,53,20688,53,allow,170,87,83,2,31,1,1
65524,53,51364,53,allow,182,93,89,2,31,1,1
59414,445,0,0,drop,66,66,0,1,0,1,0
59165,445,0,0,drop,70,70,0,1,0,1,0
64006,445,0,0,drop,70,70,0,1,0,1,0
64005,445,0,0,drop,70,70,0,1,0,1,0
64004,445,0,0,drop,70,70,0,1,0,1,0
59161,445,0,0,drop,70,70,0,1,0,1,0
59402,445,0,0,drop,66,66,0,1,0,1,0
59403,445,0,0,drop,66,66,0,1,0,1,0
59404,445,0,0,drop,66,66,0,1,0,1,0
59401,445,0,0,drop,66,66,0,1,0,1,0
59405,445,0,0,drop,66,66,0,1,0,1,0
59398,445,0,0,drop,66,66,0,1,0,1,0
59399,445,0,0,drop,66,66,0,1,0,1,0
59400,445,0,0,drop,66,66,0,1,0,1,0
59159,445,0,0,drop,70,70,0,1,0,1,0
54825,444,0,0,deny,60,60,0,1,0,1,0
49245,53,23757,53,allow,195,102,93,2,30,1,1
65107,53,53716,53,allow,193,102,91,2,30,1,1
64619,53,61367,53,allow,438,89,349,4,44,2,2
62348,443,31303,443,allow,1592,965,627,15,20,7,8
49621,53,6731,53,allow,501,188,313,6,33,3,3
49621,53,59180,53,allow,287,93,194,4,56,2,2
49864,53,49733,53,allow,193,102,91,2,29,1,1
57397,53,11845,53,allow,183,94,89,2,29,1,1
64172,53,13713,53,allow,197,102,95,2,29,1,1
49621,53,9845,53,allow,183,94,89,2,29,1,1
49825,53,31559,53,allow,168,86,82,2,29,1,1
59402,53,59402,53,allow,216,90,126,2,29,1,1
65332,53,1654,53,allow,226,86,140,2,29,1,1
49563,53,41117,53,allow,200,102,98,2,29,1,1
49837,53,4839,53,allow,180,94,86,2,29,1,1
57397,53,24712,53,allow,183,94,89,2,30,1,1
56426,53,8485,53,allow,184,94,90,2,30,1,1
56936,80,5916,80,allow,1490,886,604,10,75,6,4
63896,80,57609,80,allow,314,192,122,6,15,4,2
64319,53,2772,53,allow,193,102,91,2,30,1,1
49164,53,54796,53,allow,226,102,124,2,30,1,1
64912,53,47656,53,allow,183,94,89,2,30,1,1
55229,53,60362,53,allow,720,94,626,2,30,1,1
57397,53,3449,53,allow,183,94,89,2,30,1,1
49337,53,51649,53,allow,258,126,132,2,30,1,1
64365,53,55898,53,allow,196,94,102,2,30,1,1
65049,53,51039,53,allow,184,94,90,2,30,1,1
64460,53,1617,53,allow,196,102,94,2,30,1,1
56497,443,18628,443,allow,1343,763,580,14,26,8,6
56468,53,30389,53,allow,180,94,86,2,30,1,1
50270,443,3425,443,allow,868,514,354,13,18,8,5
55630,53,24833,53,allow,197,102,95,2,30,1,1
56144,53,26768,53,allow,180,94,86,2,30,1,1
64592,53,20935,53,allow,177,94,83,2,30,1,1
65007,53,25080,53,allow,180,86,94,2,30,1,1
56935,80,54520,80,allow,1482,878,604,10,75,6,4
65144,53,24637,53,allow,210,110,100,2,30,1,1
64678,53,43744,53,allow,289,102,187,2,30,1,1
49180,53,37264,53,allow,314,97,217,4,34,2,2
56644,80,27121,80,allow,234,234,0,4,12,4,0
56498,443,11650,443,allow,1343,763,580,14,26,8,6
64036,53,28611,53,allow,360,93,267,4,57,2,2
49876,53,42623,53,allow,211,102,109,2,30,1,1
56468,53,1634,53,allow,180,94,86,2,30,1,1
56938,80,50995,80,allow,1403,841,562,10,75,6,4
53455,53,0,0,allow,82,82,0,2,40,2,0
53757,1,21144,1,allow,70,70,0,2,8,2,0
49247,53,56867,53,allow,478,196,282,6,63,3,3
36386,443,8343,443,allow,1209,709,500,14,28,8,6
57416,53,53137,53,allow,193,102,91,2,29,1,1
49323,53,47360,53,allow,196,102,94,2,29,1,1
64872,53,61410,53,allow,166,86,80,2,29,1,1
49510,53,6465,53,allow,329,118,211,2,29,1,1
49355,53,58716,53,allow,193,102,91,2,29,1,1
49825,53,18724,53,allow,168,86,82,2,29,1,1
56532,53,65053,53,allow,164,86,78,2,29,1,1
64319,53,63281,53,allow,193,102,91,2,29,1,1
64475,53,62342,53,allow,184,94,90,2,29,1,1
64095,53,51473,53,allow,269,110,159,2,30,1,1
64105,53,29112,53,allow,300,102,198,2,30,1,1
64473,53,45476,53,allow,184,94,90,2,30,1,1
43702,443,33020,443,allow,1201,707,494,12,26,7,5
58050,80,17128,80,allow,318,192,126,6,20,4,2
49197,53,3341,53,allow,249,94,155,2,30,1,1
50275,443,24781,443,allow,708,362,346,11,18,6,5
55668,80,2182,80,allow,70,70,0,2,8,2,0
60995,443,4422,443,allow,1351,846,505,12,19,7,5
64592,53,18733,53,allow,177,94,83,2,30,1,1
64026,53,2303,53,allow,244,94,150,2,31,1,1
43701,443,61661,443,allow,1201,707,494,12,26,7,5
50279,443,26201,443,allow,1128,654,474,17,18,10,7
44861,443,14296,443,allow,1625,1038,587,14,27,8,6
49355,53,27262,53,allow,193,102,91,2,30,1,1
64475,53,56537,53,allow,184,94,90,2,30,1,1
56771,53,12754,53,allow,261,94,167,2,30,1,1
56675,53,13397,53,allow,254,94,160,2,30,1,1
65251,53,45927,53,allow,183,98,85,3,31,2,1
57179,53,11960,53,allow,325,94,231,2,30,1,1
64912,53,33217,53,allow,183,94,89,2,31,1,1
49654,53,58880,53,allow,214,110,104,2,31,1,1
52788,53,56727,53,allow,196,94,102,2,30,1,1
64357,53,36127,53,allow,183,94,89,2,30,1,1
49274,53,14620,53,allow,197,102,95,2,30,1,1
50562,53,50562,53,allow,216,82,134,2,32,1,1
64813,53,4341,53,allow,180,94,86,2,30,1,1
49569,53,17630,53,allow,213,94,119,2,30,1,1
49654,53,53040,53,allow,214,110,104,2,30,1,1
49501,53,46075,53,allow,343,92,251,4,32,2,2
49355,53,60733,53,allow,193,102,91,2,30,1,1
56468,53,3693,53,allow,180,94,86,2,30,1,1
54826,444,0,0,deny,60,60,0,1,0,1,0
59155,445,0,0,drop,70,70,0,1,0,1,0
63997,445,0,0,drop,70,70,0,1,0,1,0
63987,445,0,0,drop,70,70,0,1,0,1,0
59148,445,0,0,drop,70,70,0,1,0,1,0
59383,445,0,0,drop,66,66,0,1,0,1,0
59384,445,0,0,drop,66,66,0,1,0,1,0
59386,445,0,0,drop,66,66,0,1,0,1,0
59146,445,0,0,drop,70,70,0,1,0,1,0
59145,445,0,0,drop,70,70,0,1,0,1,0
59144,445,0,0,drop,70,70,0,1,0,1,0
63984,445,0,0,drop,70,70,0,1,0,1,0
59143,445,0,0,drop,70,70,0,1,0,1,0
59139,445,0,0,drop,70,70,0,1,0,1,0
59141,445,0,0,drop,70,70,0,1,0,1,0
63983,445,0,0,drop,70,70,0,1,0,1,0
63981,445,0,0,drop,70,70,0,1,0,1,0
63980,445,0,0,drop,70,70,0,1,0,1,0
59125,445,0,0,drop,70,70,0,1,0,1,0
59124,445,0,0,drop,70,70,0,1,0,1,0
59119,445,0,0,drop,70,70,0,1,0,1,0
59114,445,0,0,drop,70,70,0,1,0,1,0
59115,445,0,0,drop,70,70,0,1,0,1,0
63966,445,0,0,drop,70,70,0,1,0,1,0
63964,445,0,0,drop,70,70,0,1,0,1,0
59373,445,0,0,drop,66,66,0,1,0,1,0
54242,443,22470,443,allow,499,425,74,4,0,3,1
54241,443,12202,443,allow,499,425,74,4,0,3,1
59103,445,0,0,drop,70,70,0,1,0,1,0
63958,445,0,0,drop,70,70,0,1,0,1,0
63957,445,0,0,drop,70,70,0,1,0,1,0
59099,445,0,0,drop,70,70,0,1,0,1,0
59357,445,0,0,drop,66,66,0,1,0,1,0
59355,445,0,0,drop,66,66,0,1,0,1,0
59090,445,0,0,drop,70,70,0,1,0,1,0
59089,445,0,0,drop,70,70,0,1,0,1,0
59087,445,0,0,drop,70,70,0,1,0,1,0
59084,445,0,0,drop,70,70,0,1,0,1,0
59082,445,0,0,drop,70,70,0,1,0,1,0
63945,445,0,0,drop,70,70,0,1,0,1,0
63939,445,0,0,drop,70,70,0,1,0,1,0
63942,445,0,0,drop,70,70,0,1,0,1,0
63940,445,0,0,drop,70,70,0,1,0,1,0
59350,445,0,0,drop,66,66,0,1,0,1,0
59335,445,0,0,drop,66,66,0,1,0,1,0
59336,445,0,0,drop,66,66,0,1,0,1,0
59341,445,0,0,drop,66,66,0,1,0,1,0
59343,445,0,0,drop,66,66,0,1,0,1,0
59339,445,0,0,drop,66,66,0,1,0,1,0
59338,445,0,0,drop,66,66,0,1,0,1,0
59345,445,0,0,drop,66,66,0,1,0,1,0
63931,445,0,0,drop,70,70,0,1,0,1,0
59077,445,0,0,drop,70,70,0,1,0,1,0
63929,445,0,0,drop,70,70,0,1,0,1,0
63928,445,0,0,drop,70,70,0,1,0,1,0
63925,445,0,0,drop,70,70,0,1,0,1,0
59069,445,0,0,drop,70,70,0,1,0,1,0
59067,445,0,0,drop,70,70,0,1,0,1,0
63919,445,0,0,drop,70,70,0,1,0,1,0
59328,445,0,0,drop,66,66,0,1,0,1,0
59062,445,0,0,drop,70,70,0,1,0,1,0
59061,445,0,0,drop,70,70,0,1,0,1,0
59326,445,0,0,drop,66,66,0,1,0,1,0
49286,23,0,0,deny,60,60,0,1,0,1,0
59325,445,0,0,drop,66,66,0,1,0,1,0
59324,445,0,0,drop,66,66,0,1,0,1,0
59321,445,0,0,drop,66,66,0,1,0,1,0
59057,445,0,0,drop,70,70,0,1,0,1,0
59055,445,0,0,drop,70,70,0,1,0,1,0
63909,445,0,0,drop,70,70,0,1,0,1,0
63898,445,0,0,drop,70,70,0,1,0,1,0
59310,445,0,0,drop,66,66,0,1,0,1,0
59051,445,0,0,drop,70,70,0,1,0,1,0
54986,53,11167,53,allow,212,108,104,2,31,1,1
54379,80,23086,80,allow,1466,729,737,12,16,7,5
56594,53,29926,53,allow,788,108,680,2,30,1,1
64813,53,27372,53,allow,176,90,86,2,30,1,1
65238,53,13271,53,allow,86,86,0,1,30,1,0
41577,53,15196,53,allow,168,78,90,2,30,1,1
57354,53,55769,53,allow,767,102,665,2,30,1,1
52460,53,0,0,allow,82,82,0,1,30,1,0
51876,443,3089,443,allow,1852,1103,749,16,32,9,7
56413,53,30670,53,allow,224,94,130,2,30,1,1
49201,53,5443,53,allow,200,102,98,2,31,1,1
36767,53,36767,53,allow,237,93,144,2,31,1,1
47000,53,0,0,allow,82,82,0,1,31,1,0
42190,53,42190,53,allow,639,86,553,2,31,1,1
65428,53,7407,53,allow,731,85,646,2,31,1,1
49621,53,49621,53,allow,231,90,141,2,31,1,1
59303,445,0,0,drop,66,66,0,1,0,1,0
63888,445,0,0,drop,70,70,0,1,0,1,0
59301,445,0,0,drop,66,66,0,1,0,1,0
64606,53,40619,53,allow,278,118,160,2,30,1,1
54986,53,26600,53,allow,214,110,104,2,30,1,1
59053,53,2855,53,allow,227,86,141,2,30,1,1
65524,53,59878,53,allow,183,94,89,2,30,1,1
43523,53,26419,53,allow,168,78,90,2,30,1,1
64036,53,62200,53,allow,183,94,89,2,29,1,1
65049,53,41682,53,allow,184,94,90,2,29,1,1
56221,53,31091,53,allow,177,94,83,2,29,1,1
64334,53,61866,53,allow,311,94,217,2,30,1,1
64093,53,55556,53,allow,213,94,119,2,30,1,1
56522,80,49102,80,allow,798,401,397,7,17,5,2
49520,80,52279,80,allow,2011,975,1036,13,70,7,6
49540,80,39259,80,allow,374,192,182,7,42,4,3
49516,80,21754,80,allow,1256,746,510,11,70,6,5
49690,53,14782,53,allow,790,110,680,2,29,1,1
63317,53,0,0,allow,181,86,95,2,30,1,1
56395,53,28310,53,allow,177,94,83,2,30,1,1
65049,53,38762,53,allow,184,94,90,2,30,1,1
49245,53,64738,53,allow,195,102,93,2,30,1,1
56221,53,42617,53,allow,177,94,83,2,29,1,1
50345,80,27840,80,allow,736,670,66,6,15,5,1
55559,53,14649,53,allow,1026,292,734,8,50,4,4
55464,53,8236,53,allow,214,110,104,2,30,1,1
54986,53,42487,53,allow,214,110,104,2,30,1,1
55695,53,46724,53,allow,209,102,107,2,30,1,1
64554,53,57103,53,allow,498,204,294,6,30,3,3
55479,53,49461,53,allow,232,94,138,2,30,1,1
41246,443,27215,443,allow,234,234,0,4,12,4,0
51834,80,36073,80,allow,366,240,126,7,32,5,2
60297,53,6955,53,allow,227,86,141,2,30,1,1
56120,53,36940,53,allow,212,102,110,2,30,1,1
40050,53,42804,53,allow,168,78,90,2,30,1,1
48966,53,48747,53,allow,168,78,90,2,30,1,1
64357,53,13293,53,allow,183,94,89,2,30,1,1
55495,53,24897,53,allow,305,94,211,2,30,1,1
65236,53,60243,53,allow,247,118,129,2,30,1,1
56252,53,46494,53,allow,531,90,441,4,41,2,2
65377,53,55727,53,allow,207,86,121,2,30,1,1
49793,53,56349,53,allow,271,102,169,2,30,1,1
56470,53,27427,53,allow,168,78,90,2,30,1,1
65194,53,9315,53,allow,265,91,174,4,36,2,2
37790,443,42788,443,allow,448,78,370,6,25,1,5
50347,80,44018,80,allow,1671,862,809,10,15,5,5
46492,80,56877,80,allow,1967,1133,834,12,45,7,5
49539,80,49460,80,allow,378,192,186,7,42,4,3
49911,53,26669,53,allow,258,110,148,2,30,1,1
65238,53,22542,53,allow,168,86,82,2,29,1,1
64813,53,44563,53,allow,180,94,86,2,30,1,1
56181,53,2631,53,allow,784,94,690,2,29,1,1
65144,53,2841,53,allow,210,110,100,2,29,1,1
49762,53,15647,53,allow,195,94,101,2,30,1,1
49703,53,48424,53,allow,198,86,112,2,30,1,1
55158,53,38311,53,allow,212,102,110,2,30,1,1
64357,53,57507,53,allow,271,85,186,4,30,2,2
49574,53,12004,53,allow,337,110,227,2,30,1,1
55756,53,23922,53,allow,311,94,217,2,30,1,1
51451,80,37614,80,allow,214,140,74,4,15,3,1
65463,53,27388,53,allow,210,102,108,2,30,1,1
59627,53,32997,53,allow,290,102,188,2,30,1,1
49935,53,2977,53,allow,370,94,276,2,30,1,1
55464,53,12452,53,allow,214,110,104,2,30,1,1
56263,53,57350,53,allow,385,134,251,2,31,1,1
64374,53,45440,53,allow,239,102,137,2,30,1,1
64912,53,24794,53,allow,183,94,89,2,30,1,1
64384,53,2219,53,allow,333,94,239,2,30,1,1
56680,53,8517,53,allow,211,102,109,2,30,1,1
64813,53,11826,53,allow,335,90,245,4,35,2,2
64298,53,48284,53,allow,311,118,193,2,30,1,1
56395,53,7674,53,allow,177,94,83,2,30,1,1
55204,53,12205,53,allow,263,94,169,2,30,1,1
56451,53,25472,53,allow,322,102,220,2,30,1,1
64588,53,18701,53,allow,211,102,109,2,30,1,1
65146,53,35272,53,allow,763,102,661,2,31,1,1
49936,53,28353,53,allow,211,102,109,2,31,1,1
49501,53,50847,53,allow,193,102,91,2,31,1,1
56035,53,29824,53,allow,337,94,243,2,30,1,1
55242,53,7339,53,allow,373,126,247,2,30,1,1
55333,123,5768,123,allow,184,94,90,2,30,1,1
55634,53,46753,53,allow,308,102,206,2,30,1,1
54986,53,61995,53,allow,214,110,104,2,30,1,1
51918,80,52022,80,allow,426,240,186,8,29,5,3
57165,53,7622,53,allow,498,204,294,6,30,3,3
56125,53,56568,53,allow,311,118,193,2,30,1,1
65524,53,37598,53,allow,183,94,89,2,30,1,1
56684,53,21413,53,allow,301,94,207,2,31,1,1
64281,53,45768,53,allow,214,110,104,2,31,1,1
53501,443,53501,443,allow,960,539,421,9,36,5,4
51900,80,40398,80,allow,366,240,126,7,29,5,2
50337,80,47050,80,allow,1083,653,430,8,16,5,3
51913,80,58997,80,allow,366,240,126,7,29,5,2
51841,443,41534,443,allow,1686,984,702,15,32,8,7
49675,53,62009,53,allow,78,78,0,1,30,1,0
65252,53,49878,53,allow,249,102,147,2,30,1,1
59038,445,0,0,drop,70,70,0,1,0,1,0
59293,445,0,0,drop,66,66,0,1,0,1,0
59035,445,0,0,drop,70,70,0,1,0,1,0
59290,445,0,0,drop,66,66,0,1,0,1,0
59030,445,0,0,drop,70,70,0,1,0,1,0
59029,445,0,0,drop,70,70,0,1,0,1,0
63878,445,0,0,drop,70,70,0,1,0,1,0
63876,445,0,0,drop,70,70,0,1,0,1,0
59271,445,0,0,drop,66,66,0,1,0,1,0
59275,445,0,0,drop,66,66,0,1,0,1,0
59277,445,0,0,drop,66,66,0,1,0,1,0
59276,445,0,0,drop,66,66,0,1,0,1,0
59272,445,0,0,drop,66,66,0,1,0,1,0
59270,445,0,0,drop,66,66,0,1,0,1,0
59274,445,0,0,drop,66,66,0,1,0,1,0
59269,445,0,0,drop,66,66,0,1,0,1,0
59027,445,0,0,drop,70,70,0,1,0,1,0
59020,445,0,0,drop,70,70,0,1,0,1,0
63868,445,0,0,drop,70,70,0,1,0,1,0
63871,445,0,0,drop,70,70,0,1,0,1,0
63860,445,0,0,drop,70,70,0,1,0,1,0
59018,445,0,0,drop,70,70,0,1,0,1,0
59257,445,0,0,drop,66,66,0,1,0,1,0
59254,445,0,0,drop,66,66,0,1,0,1,0
59255,445,0,0,drop,66,66,0,1,0,1,0
59017,445,0,0,drop,70,70,0,1,0,1,0
59016,445,0,0,drop,70,70,0,1,0,1,0
59015,445,0,0,drop,70,70,0,1,0,1,0
59013,445,0,0,drop,70,70,0,1,0,1,0
59009,445,0,0,drop,70,70,0,1,0,1,0
63851,445,0,0,drop,70,70,0,1,0,1,0
63852,445,0,0,drop,70,70,0,1,0,1,0
63849,445,0,0,drop,70,70,0,1,0,1,0
58997,445,0,0,drop,70,70,0,1,0,1,0
58996,445,0,0,drop,70,70,0,1,0,1,0
54240,443,62221,443,allow,499,425,74,4,0,3,1
54239,443,8377,443,allow,499,425,74,4,0,3,1
54238,443,21116,443,allow,499,425,74,4,0,3,1
54236,443,22668,443,allow,499,425,74,4,0,3,1
54237,443,5337,443,allow,499,425,74,4,0,3,1
58993,445,0,0,drop,70,70,0,1,0,1,0
58986,445,0,0,drop,70,70,0,1,0,1,0
58987,445,0,0,drop,70,70,0,1,0,1,0
63839,445,0,0,drop,70,70,0,1,0,1,0
63838,445,0,0,drop,70,70,0,1,0,1,0
63836,445,0,0,drop,70,70,0,1,0,1,0
59245,445,0,0,drop,66,66,0,1,0,1,0
58975,445,0,0,drop,70,70,0,1,0,1,0
36665,23,0,0,deny,60,60,0,1,0,1,0
63831,445,0,0,drop,70,70,0,1,0,1,0
63830,445,0,0,drop,70,70,0,1,0,1,0
58971,445,0,0,drop,70,70,0,1,0,1,0
58961,445,0,0,drop,70,70,0,1,0,1,0
58960,445,0,0,drop,70,70,0,1,0,1,0
58959,445,0,0,drop,70,70,0,1,0,1,0
59230,445,0,0,drop,66,66,0,1,0,1,0
59228,445,0,0,drop,66,66,0,1,0,1,0
58958,445,0,0,drop,70,70,0,1,0,1,0
58955,445,0,0,drop,70,70,0,1,0,1,0
59796,23,0,0,deny,60,60,0,1,0,1,0
63815,445,0,0,drop,70,70,0,1,0,1,0
63811,445,0,0,drop,70,70,0,1,0,1,0
59222,445,0,0,drop,66,66,0,1,0,1,0
59211,445,0,0,drop,66,66,0,1,0,1,0
59214,445,0,0,drop,66,66,0,1,0,1,0
59215,445,0,0,drop,66,66,0,1,0,1,0
59213,445,0,0,drop,66,66,0,1,0,1,0
59210,445,0,0,drop,66,66,0,1,0,1,0
59216,445,0,0,drop,66,66,0,1,0,1,0
59208,445,0,0,drop,66,66,0,1,0,1,0
58949,445,0,0,drop,70,70,0,1,0,1,0
63804,445,0,0,drop,70,70,0,1,0,1,0
63801,445,0,0,drop,70,70,0,1,0,1,0
63797,445,0,0,drop,70,70,0,1,0,1,0
63799,445,0,0,drop,70,70,0,1,0,1,0
58941,445,0,0,drop,70,70,0,1,0,1,0
58938,445,0,0,drop,70,70,0,1,0,1,0
58934,445,0,0,drop,70,70,0,1,0,1,0
63795,445,0,0,drop,70,70,0,1,0,1,0
63792,445,0,0,drop,70,70,0,1,0,1,0
63790,445,0,0,drop,70,70,0,1,0,1,0
58933,445,0,0,drop,70,70,0,1,0,1,0
59200,445,0,0,drop,66,66,0,1,0,1,0
63788,445,0,0,drop,70,70,0,1,0,1,0
59198,445,0,0,drop,66,66,0,1,0,1,0
59195,445,0,0,drop,66,66,0,1,0,1,0
59194,445,0,0,drop,66,66,0,1,0,1,0
49223,80,54325,80,allow,1793,1030,763,11,15,6,5
56559,53,15416,53,allow,731,85,646,2,30,1,1
51882,443,57503,443,allow,366,180,186,7,30,4,3
51849,80,48623,80,allow,366,240,126,7,31,5,2
51842,443,3576,443,allow,1503,984,519,13,31,8,5
64281,53,18314,53,allow,212,108,104,2,30,1,1
51846,80,21384,80,allow,366,240,126,7,31,5,2
58049,80,61142,80,allow,378,192,186,7,19,4,3
44368,53,44368,53,allow,233,91,142,2,30,1,1
52265,53,0,0,allow,233,89,144,2,30,1,1
65353,53,60832,53,allow,170,87,83,2,30,1,1
51847,80,28250,80,allow,366,240,126,7,31,5,2
51874,443,24684,443,allow,1852,1103,749,16,31,9,7
51840,443,42990,443,allow,246,120,126,5,32,3,2
53500,443,53500,443,allow,960,539,421,9,35,5,4
55046,53,59080,53,allow,300,102,198,4,40,2,2
57328,53,13021,53,allow,1427,101,1326,4,48,2,2
55886,443,32004,443,allow,161,101,60,2,5,1,1
51877,443,15246,443,allow,1852,1103,749,16,31,9,7
51861,80,40570,80,allow,366,240,126,7,31,5,2
51875,443,48033,443,allow,1852,1103,749,16,31,9,7
51845,80,46640,80,allow,502,310,192,9,31,6,3
63854,53,30633,53,allow,578,286,292,9,15,5,4
50327,80,7970,80,allow,366,180,186,7,47,4,3
55694,53,54062,53,allow,166,85,81,2,31,1,1
49740,53,20655,53,allow,793,101,692,2,31,1,1
65507,53,3795,53,allow,166,85,81,2,31,1,1
58929,445,0,0,drop,70,70,0,1,0,1,0
59192,445,0,0,drop,66,66,0,1,0,1,0
58928,445,0,0,drop,70,70,0,1,0,1,0
63780,445,0,0,drop,70,70,0,1,0,1,0
50523,53,31491,53,allow,199,102,97,2,30,1,1
51871,443,4793,443,allow,554,310,244,10,30,6,4
51837,80,11115,80,allow,242,120,122,5,31,3,2
49769,80,36678,80,allow,254,128,126,5,15,3,2
56138,53,30181,53,allow,284,94,190,2,29,1,1
65353,53,4050,53,allow,177,94,83,2,29,1,1
56311,53,2296,53,allow,311,94,217,2,30,1,1
50047,80,4097,80,allow,1455,349,1106,10,15,5,5
51830,80,53910,80,allow,486,300,186,9,31,6,3
51826,443,55412,443,allow,682,370,312,12,32,7,5
53502,443,53502,443,allow,960,539,421,9,35,5,4
51915,443,2041,443,allow,362,180,182,7,28,4,3
56203,53,18895,53,allow,283,102,181,2,29,1,1
56395,53,26847,53,allow,177,94,83,2,29,1,1
49274,53,51381,53,allow,197,102,95,2,29,1,1
56907,53,38903,53,allow,293,102,191,2,29,1,1
49243,53,19778,53,allow,212,102,110,2,30,1,1
56569,53,35579,53,allow,199,102,97,2,30,1,1
56513,53,43170,53,allow,184,86,98,2,30,1,1
65115,53,32763,53,allow,167,86,81,2,30,1,1
59653,80,58858,80,allow,1139,609,530,10,34,6,4
64028,53,51007,53,allow,293,134,159,2,30,1,1
64651,53,19265,53,allow,196,94,102,2,30,1,1
49201,53,3474,53,allow,200,102,98,2,30,1,1
64028,53,50736,53,allow,263,134,129,2,30,1,1
50523,53,17417,53,allow,199,102,97,2,30,1,1
64281,53,42063,53,allow,214,110,104,2,30,1,1
56526,53,57484,53,allow,210,102,108,2,30,1,1
45063,80,24999,80,allow,1892,1014,878,10,21,6,4
50329,80,27783,80,allow,1550,728,822,13,47,7,6
65237,53,3519,53,allow,225,94,131,2,30,1,1
49201,53,35149,53,allow,200,102,98,2,30,1,1
51831,80,34274,80,allow,486,300,186,9,31,6,3
51914,80,46843,80,allow,366,240,126,7,28,5,2
51835,443,47905,443,allow,546,300,246,10,31,6,4
51898,80,53700,80,allow,366,240,126,7,28,5,2
51928,80,8868,80,allow,1357,963,394,10,26,7,3
51872,443,26165,443,allow,442,250,192,8,30,5,3
60853,443,17952,443,allow,126,60,66,3,4,2,1
55046,53,5301,53,allow,300,102,198,4,40,2,2
55046,53,27327,53,allow,300,102,198,4,39,2,2
55046,53,20538,53,allow,300,102,198,4,40,2,2
50323,80,57798,80,allow,2074,793,1281,11,48,6,5
49651,53,30768,53,allow,312,94,218,2,29,1,1
55100,53,52662,53,allow,438,94,344,2,29,1,1
64320,53,39088,53,allow,197,94,103,2,29,1,1
65353,53,24740,53,allow,177,94,83,2,30,1,1
55549,53,55549,53,allow,228,90,138,2,30,1,1
49800,53,49800,53,allow,235,90,145,2,33,1,1
43863,80,21010,80,allow,2025,805,1220,12,46,7,5
64471,53,53728,53,allow,264,110,154,2,30,1,1
64998,53,50318,53,allow,214,94,120,2,30,1,1
64281,53,44626,53,allow,214,110,104,2,30,1,1
49591,53,31886,53,allow,198,94,104,2,30,1,1
56007,53,28468,53,allow,197,102,95,2,33,1,1
50333,80,53972,80,allow,442,250,192,8,47,5,3
57355,53,57355,53,allow,242,98,144,2,30,1,1
46002,53,40286,53,allow,168,78,90,2,30,1,1
56569,53,62895,53,allow,199,102,97,2,30,1,1
50334,80,53374,80,allow,442,250,192,8,47,5,3
65115,53,14088,53,allow,167,86,81,2,30,1,1
49401,53,41126,53,allow,258,102,156,2,30,1,1
49201,53,51989,53,allow,200,102,98,2,30,1,1
57368,53,40892,53,allow,167,86,81,2,30,1,1
64073,53,23568,53,allow,199,102,97,2,30,1,1
55694,53,60951,53,allow,167,86,81,2,30,1,1
64951,53,46883,53,allow,224,86,138,2,30,1,1
56642,80,4720,80,allow,234,234,0,4,12,4,0
64073,53,37819,53,allow,520,211,309,6,39,3,3
64669,53,24998,53,allow,198,94,104,2,30,1,1
55694,53,12759,53,allow,167,86,81,2,30,1,1
63775,445,0,0,drop,70,70,0,1,0,1,0
63770,445,0,0,drop,70,70,0,1,0,1,0
58923,445,0,0,drop,70,70,0,1,0,1,0
59180,445,0,0,drop,66,66,0,1,0,1,0
59173,445,0,0,drop,66,66,0,1,0,1,0
63760,445,0,0,drop,70,70,0,1,0,1,0
58910,445,0,0,drop,70,70,0,1,0,1,0
59171,445,0,0,drop,66,66,0,1,0,1,0
58907,445,0,0,drop,70,70,0,1,0,1,0
59162,445,0,0,drop,66,66,0,1,0,1,0
59155,445,0,0,drop,66,66,0,1,0,1,0
58902,445,0,0,drop,70,70,0,1,0,1,0
58901,445,0,0,drop,70,70,0,1,0,1,0
58899,445,0,0,drop,70,70,0,1,0,1,0
42361,23,0,0,deny,60,60,0,1,0,1,0
63751,445,0,0,drop,70,70,0,1,0,1,0
63750,445,0,0,drop,70,70,0,1,0,1,0
63748,445,0,0,drop,70,70,0,1,0,1,0
59148,445,0,0,drop,66,66,0,1,0,1,0
59147,445,0,0,drop,66,66,0,1,0,1,0
59146,445,0,0,drop,66,66,0,1,0,1,0
59142,445,0,0,drop,66,66,0,1,0,1,0
59140,445,0,0,drop,66,66,0,1,0,1,0
59145,445,0,0,drop,66,66,0,1,0,1,0
59143,445,0,0,drop,66,66,0,1,0,1,0
59141,445,0,0,drop,66,66,0,1,0,1,0
58892,445,0,0,drop,70,70,0,1,0,1,0
58890,445,0,0,drop,70,70,0,1,0,1,0
63740,445,0,0,drop,70,70,0,1,0,1,0
63732,445,0,0,drop,70,70,0,1,0,1,0
63730,445,0,0,drop,70,70,0,1,0,1,0
54234,443,2984,443,allow,499,425,74,4,0,3,1
54233,443,10183,443,allow,499,425,74,4,0,3,1
58889,445,0,0,drop,70,70,0,1,0,1,0
59128,445,0,0,drop,66,66,0,1,0,1,0
59127,445,0,0,drop,66,66,0,1,0,1,0
59125,445,0,0,drop,66,66,0,1,0,1,0
58888,445,0,0,drop,70,70,0,1,0,1,0
58887,445,0,0,drop,70,70,0,1,0,1,0
58884,445,0,0,drop,70,70,0,1,0,1,0
58881,445,0,0,drop,70,70,0,1,0,1,0
63728,445,0,0,drop,70,70,0,1,0,1,0
63723,445,0,0,drop,70,70,0,1,0,1,0
63719,445,0,0,drop,70,70,0,1,0,1,0
58869,445,0,0,drop,70,70,0,1,0,1,0
58862,445,0,0,drop,70,70,0,1,0,1,0
58858,445,0,0,drop,70,70,0,1,0,1,0
58859,445,0,0,drop,70,70,0,1,0,1,0
63710,445,0,0,drop,70,70,0,1,0,1,0
50330,53,50330,53,allow,237,93,144,2,0,1,1
49355,53,16925,53,allow,186,95,91,2,0,1,1
63708,445,0,0,drop,70,70,0,1,0,1,0
63709,445,0,0,drop,70,70,0,1,0,1,0
58847,445,0,0,drop,70,70,0,1,0,1,0
59116,445,0,0,drop,66,66,0,1,0,1,0
58842,445,0,0,drop,70,70,0,1,0,1,0
63703,445,0,0,drop,70,70,0,1,0,1,0
63702,445,0,0,drop,70,70,0,1,0,1,0
58834,445,0,0,drop,70,70,0,1,0,1,0
58833,445,0,0,drop,70,70,0,1,0,1,0
58832,445,0,0,drop,70,70,0,1,0,1,0
58830,445,0,0,drop,70,70,0,1,0,1,0
58826,445,0,0,drop,70,70,0,1,0,1,0
59099,445,0,0,drop,66,66,0,1,0,1,0
59101,445,0,0,drop,66,66,0,1,0,1,0
63691,445,0,0,drop,70,70,0,1,0,1,0
63686,445,0,0,drop,70,70,0,1,0,1,0
59094,445,0,0,drop,66,66,0,1,0,1,0
58821,445,0,0,drop,70,70,0,1,0,1,0
59078,445,0,0,drop,66,66,0,1,0,1,0
59083,445,0,0,drop,66,66,0,1,0,1,0
59082,445,0,0,drop,66,66,0,1,0,1,0
59088,445,0,0,drop,66,66,0,1,0,1,0
59086,445,0,0,drop,66,66,0,1,0,1,0
59079,445,0,0,drop,66,66,0,1,0,1,0
59077,445,0,0,drop,66,66,0,1,0,1,0
63676,445,0,0,drop,70,70,0,1,0,1,0
63673,445,0,0,drop,70,70,0,1,0,1,0
63672,445,0,0,drop,70,70,0,1,0,1,0
63669,445,0,0,drop,70,70,0,1,0,1,0
58813,445,0,0,drop,70,70,0,1,0,1,0
58812,445,0,0,drop,70,70,0,1,0,1,0
37920,53,0,0,allow,82,82,0,1,30,1,0
64073,53,57961,53,allow,304,101,203,4,38,2,2
65194,53,10314,53,allow,178,91,87,2,31,1,1
42108,23,0,0,deny,60,60,0,1,0,1,0
58806,445,0,0,drop,70,70,0,1,0,1,0
58805,445,0,0,drop,70,70,0,1,0,1,0
63668,445,0,0,drop,70,70,0,1,0,1,0
63662,445,0,0,drop,70,70,0,1,0,1,0
63665,445,0,0,drop,70,70,0,1,0,1,0
47102,123,23383,123,allow,184,94,90,2,30,1,1
61661,53,61661,53,allow,235,90,145,2,33,1,1
44052,80,38453,80,allow,282,60,222,5,12,2,3
65222,53,8527,53,allow,212,102,110,2,30,1,1
49542,80,57907,80,allow,1012,531,481,8,25,5,3
56504,53,9210,53,allow,195,94,101,2,30,1,1
64940,53,23084,53,allow,250,94,156,2,30,1,1
64673,53,43122,53,allow,213,94,119,2,30,1,1
55694,53,17874,53,allow,274,85,189,4,35,2,2
37567,443,42814,443,allow,214,140,74,4,15,3,1
65507,53,47508,53,allow,167,86,81,2,30,1,1
41636,123,47665,123,allow,184,94,90,2,30,1,1
64410,53,32197,53,allow,286,98,188,4,40,2,2
65445,53,12722,53,allow,254,102,152,2,30,1,1
37568,443,50535,443,allow,214,140,74,4,15,3,1
64073,53,53984,53,allow,304,101,203,4,37,2,2
52247,53,24197,53,allow,216,86,130,2,30,1,1
65507,53,3700,53,allow,167,86,81,2,30,1,1
63973,53,57018,53,allow,346,98,248,4,31,2,2
52793,443,12880,443,allow,130,70,60,2,14,1,1
44890,443,50264,443,allow,232,172,60,3,4,2,1
64704,53,49716,53,allow,213,102,111,2,29,1,1
57368,53,45045,53,allow,167,86,81,2,29,1,1
52435,53,3973,53,allow,216,78,138,2,29,1,1
50871,53,48869,53,allow,86,86,0,1,30,1,0
65295,53,10641,53,allow,212,102,110,2,29,1,1
46704,80,21758,80,allow,1193,451,742,10,15,6,4
65168,53,15649,53,allow,230,110,120,2,30,1,1
56265,53,56216,53,allow,213,94,119,2,30,1,1
37569,443,62678,443,allow,214,140,74,4,15,3,1
49967,53,55984,53,allow,303,100,203,4,40,2,2
53660,443,43128,443,allow,350,210,140,6,24,4,2
37566,443,56010,443,allow,214,140,74,4,15,3,1
63962,53,22978,53,allow,274,93,181,4,64,2,2
65491,53,6276,53,allow,889,404,485,10,30,5,5
64876,53,13922,53,allow,718,94,624,2,31,1,1
65046,53,1859,53,allow,211,94,117,2,31,1,1
55618,53,36676,53,allow,199,94,105,2,30,1,1
43608,53,16507,53,allow,199,94,105,2,30,1,1
50549,53,21467,53,allow,199,94,105,2,30,1,1
63951,53,53032,53,allow,345,106,239,4,38,2,2
59072,445,0,0,drop,66,66,0,1,0,1,0
63660,445,0,0,drop,70,70,0,1,0,1,0
59068,445,0,0,drop,66,66,0,1,0,1,0
58801,445,0,0,drop,70,70,0,1,0,1,0
59066,445,0,0,drop,66,66,0,1,0,1,0
59064,445,0,0,drop,66,66,0,1,0,1,0
59063,445,0,0,drop,66,66,0,1,0,1,0
58799,445,0,0,drop,70,70,0,1,0,1,0
63652,445,0,0,drop,70,70,0,1,0,1,0
63651,445,0,0,drop,70,70,0,1,0,1,0
58795,445,0,0,drop,70,70,0,1,0,1,0
59051,445,0,0,drop,66,66,0,1,0,1,0
59044,445,0,0,drop,66,66,0,1,0,1,0
63633,445,0,0,drop,70,70,0,1,0,1,0
58782,445,0,0,drop,70,70,0,1,0,1,0
59042,445,0,0,drop,66,66,0,1,0,1,0
58779,445,0,0,drop,70,70,0,1,0,1,0
59035,445,0,0,drop,66,66,0,1,0,1,0
59027,445,0,0,drop,66,66,0,1,0,1,0
58774,445,0,0,drop,70,70,0,1,0,1,0
58773,445,0,0,drop,70,70,0,1,0,1,0
58771,445,0,0,drop,70,70,0,1,0,1,0
63622,445,0,0,drop,70,70,0,1,0,1,0
63620,445,0,0,drop,70,70,0,1,0,1,0
59018,445,0,0,drop,66,66,0,1,0,1,0
59019,445,0,0,drop,66,66,0,1,0,1,0
59016,445,0,0,drop,66,66,0,1,0,1,0
59013,445,0,0,drop,66,66,0,1,0,1,0
59014,445,0,0,drop,66,66,0,1,0,1,0
59017,445,0,0,drop,66,66,0,1,0,1,0
59011,445,0,0,drop,66,66,0,1,0,1,0
59015,445,0,0,drop,66,66,0,1,0,1,0
58764,445,0,0,drop,70,70,0,1,0,1,0
58762,445,0,0,drop,70,70,0,1,0,1,0
58761,445,0,0,drop,70,70,0,1,0,1,0
63617,445,0,0,drop,70,70,0,1,0,1,0
63618,445,0,0,drop,70,70,0,1,0,1,0
63610,445,0,0,drop,70,70,0,1,0,1,0
63602,445,0,0,drop,70,70,0,1,0,1,0
58760,445,0,0,drop,70,70,0,1,0,1,0
58759,445,0,0,drop,70,70,0,1,0,1,0
58757,445,0,0,drop,70,70,0,1,0,1,0
58754,445,0,0,drop,70,70,0,1,0,1,0
58999,445,0,0,drop,66,66,0,1,0,1,0
58998,445,0,0,drop,66,66,0,1,0,1,0
58996,445,0,0,drop,66,66,0,1,0,1,0
58741,445,0,0,drop,70,70,0,1,0,1,0
58740,445,0,0,drop,70,70,0,1,0,1,0
58736,445,0,0,drop,70,70,0,1,0,1,0
63600,445,0,0,drop,70,70,0,1,0,1,0
53362,23,0,0,deny,60,60,0,1,0,1,0
58730,445,0,0,drop,70,70,0,1,0,1,0
58731,445,0,0,drop,70,70,0,1,0,1,0
63595,445,0,0,drop,70,70,0,1,0,1,0
63594,445,0,0,drop,70,70,0,1,0,1,0
58719,445,0,0,drop,70,70,0,1,0,1,0
63581,445,0,0,drop,70,70,0,1,0,1,0
63580,445,0,0,drop,70,70,0,1,0,1,0
58986,445,0,0,drop,66,66,0,1,0,1,0
58715,445,0,0,drop,70,70,0,1,0,1,0
54219,443,4628,443,allow,499,425,74,4,0,3,1
54227,443,59982,443,allow,499,425,74,4,0,3,1
54221,443,30528,443,allow,499,425,74,4,0,3,1
54229,443,56153,443,allow,499,425,74,4,0,3,1
54225,443,6300,443,allow,499,425,74,4,0,3,1
54226,443,4295,443,allow,499,425,74,4,0,3,1
54224,443,19866,443,allow,499,425,74,4,0,3,1
54228,443,39518,443,allow,499,425,74,4,0,3,1
54223,443,38222,443,allow,499,425,74,4,0,3,1
54218,443,2874,443,allow,499,425,74,4,0,3,1
54222,443,54407,443,allow,499,425,74,4,0,3,1
54220,443,37468,443,allow,499,425,74,4,0,3,1
58706,445,0,0,drop,70,70,0,1,0,1,0
58703,445,0,0,drop,70,70,0,1,0,1,0
63573,445,0,0,drop,70,70,0,1,0,1,0
63574,445,0,0,drop,70,70,0,1,0,1,0
58701,445,0,0,drop,70,70,0,1,0,1,0
58699,445,0,0,drop,70,70,0,1,0,1,0
58971,445,0,0,drop,66,66,0,1,0,1,0
58968,445,0,0,drop,66,66,0,1,0,1,0
40367,80,26121,80,allow,2119,808,1311,12,16,7,5
56336,53,36932,53,allow,198,93,105,2,30,1,1
59896,443,22952,443,allow,1537,934,603,14,32,7,7
51916,80,61338,80,allow,182,60,122,4,26,2,2
47677,80,49789,80,allow,1304,850,454,11,31,6,5
55553,53,10197,53,allow,711,87,624,2,30,1,1
60118,53,0,0,allow,216,84,132,2,30,1,1
59895,443,59498,443,allow,1537,934,603,14,32,7,7
59894,443,37643,443,allow,1537,934,603,14,33,7,7
59897,443,7806,443,allow,1743,934,809,15,32,7,8
56611,80,8801,80,allow,1114,534,580,12,16,7,5
59899,443,64399,443,allow,1401,864,537,12,30,6,6
45119,443,35597,443,allow,2227,1018,1209,17,16,8,9
58039,80,32642,80,allow,318,192,126,6,21,4,2
57339,53,43284,53,allow,184,80,104,2,30,1,1
48371,53,57320,53,allow,198,93,105,2,30,1,1
62875,53,0,0,allow,205,80,125,2,30,1,1
51594,53,61639,53,allow,172,80,92,2,31,1,1
63563,445,0,0,drop,70,70,0,1,0,1,0
58692,445,0,0,drop,70,70,0,1,0,1,0
63558,445,0,0,drop,70,70,0,1,0,1,0
63554,445,0,0,drop,70,70,0,1,0,1,0
58963,445,0,0,drop,66,66,0,1,0,1,0
58959,445,0,0,drop,66,66,0,1,0,1,0
58956,445,0,0,drop,66,66,0,1,0,1,0
58958,445,0,0,drop,66,66,0,1,0,1,0
58955,445,0,0,drop,66,66,0,1,0,1,0
58952,445,0,0,drop,66,66,0,1,0,1,0
58949,445,0,0,drop,66,66,0,1,0,1,0
58948,445,0,0,drop,66,66,0,1,0,1,0
58685,445,0,0,drop,70,70,0,1,0,1,0
63547,445,0,0,drop,70,70,0,1,0,1,0
58683,445,0,0,drop,70,70,0,1,0,1,0
63545,445,0,0,drop,70,70,0,1,0,1,0
63544,445,0,0,drop,70,70,0,1,0,1,0
63542,445,0,0,drop,70,70,0,1,0,1,0
58678,445,0,0,drop,70,70,0,1,0,1,0
58677,445,0,0,drop,70,70,0,1,0,1,0
49253,53,0,0,allow,218,78,140,2,30,1,1
60771,80,37890,80,allow,254,128,126,5,15,3,2
49558,53,61665,53,allow,423,104,319,4,39,2,2
65507,53,22060,53,allow,167,86,81,2,29,1,1
64096,53,55413,53,allow,197,94,103,2,29,1,1
64768,53,30558,53,allow,394,102,292,2,29,1,1
58025,80,19163,80,allow,708,384,324,12,23,7,5
64656,53,17241,53,allow,387,102,285,2,29,1,1
57012,53,13483,53,allow,230,86,144,2,29,1,1
55131,53,55323,53,allow,244,94,150,2,30,1,1
64410,53,3799,53,allow,196,102,94,2,35,1,1
55062,80,41792,80,allow,486,240,246,9,28,5,4
58044,80,31147,80,allow,2742,1116,1626,11,20,6,5
58042,80,52870,80,allow,318,192,126,6,20,4,2
51418,53,32808,53,allow,168,78,90,2,30,1,1
64215,53,28280,53,allow,196,94,102,2,30,1,1
49593,53,25320,53,allow,253,102,151,2,30,1,1
60287,80,11423,80,allow,130,70,60,2,15,1,1
65115,53,63102,53,allow,301,95,206,4,36,2,2
65090,53,43740,53,allow,209,102,107,2,30,1,1
50400,53,28411,53,allow,177,94,83,2,30,1,1
50400,53,9416,53,allow,177,94,83,2,30,1,1
64025,53,10807,53,allow,199,94,105,2,30,1,1
41739,53,41739,53,allow,235,90,145,2,32,1,1
43817,53,43817,53,allow,203,82,121,2,30,1,1
55933,53,17036,53,allow,212,102,110,2,30,1,1
55271,53,16538,53,allow,268,102,166,2,30,1,1
57169,53,0,0,allow,208,86,122,2,30,1,1
48931,53,2346,53,allow,168,78,90,2,30,1,1
64425,53,47922,53,allow,216,94,122,2,30,1,1
46999,53,31962,53,allow,168,78,90,2,30,1,1
56214,53,47113,53,allow,200,102,98,2,33,1,1
55075,53,41245,53,allow,181,94,87,2,33,1,1
42890,80,22504,80,allow,2030,586,1444,10,30,6,4
50050,53,17602,53,allow,253,87,166,4,52,2,2
64050,53,59472,53,allow,389,94,295,2,30,1,1
64765,53,34365,53,allow,195,94,101,2,30,1,1
56214,53,47362,53,allow,200,102,98,2,30,1,1
57225,53,35274,53,allow,177,94,83,2,30,1,1
49352,53,48466,53,allow,214,94,120,2,30,1,1
65453,53,27266,53,allow,251,94,157,2,31,1,1
57045,53,2181,53,allow,177,94,83,2,30,1,1
49295,53,11197,53,allow,280,96,184,4,36,2,2
58043,80,57225,80,allow,378,192,186,7,20,4,3
53650,53,49968,53,allow,199,94,105,2,29,1,1
55384,53,19331,53,allow,94,94,0,1,30,1,0
49683,53,44598,53,allow,262,94,168,2,29,1,1
64283,53,39891,53,allow,337,110,227,2,29,1,1
49308,53,5550,53,allow,195,94,101,2,29,1,1
65097,53,14229,53,allow,718,94,624,2,30,1,1
64420,53,48861,53,allow,294,95,199,4,42,2,2
49686,53,9507,53,allow,343,94,249,2,30,1,1
49805,53,26905,53,allow,296,102,194,2,30,1,1
57349,53,0,0,allow,222,86,136,2,30,1,1
49305,53,42044,53,allow,177,94,83,2,30,1,1
64743,53,57022,53,allow,210,102,108,2,30,1,1
43440,80,5073,80,allow,2093,825,1268,12,45,7,5
54485,80,18876,80,allow,130,70,60,2,15,1,1
55061,80,17010,80,allow,486,240,246,9,28,5,4
57075,53,9642,53,allow,199,94,105,2,30,1,1
55077,53,49404,53,allow,394,94,300,2,30,1,1
55075,53,35995,53,allow,181,94,87,2,30,1,1
49914,53,9646,53,allow,718,94,624,2,30,1,1
51852,80,36581,80,allow,182,60,122,4,29,2,2
51450,80,49507,80,allow,214,140,74,4,15,3,1
50050,53,12626,53,allow,253,87,166,4,51,2,2
49901,53,32175,53,allow,231,102,129,2,30,1,1
64517,53,41461,53,allow,211,102,109,2,30,1,1
57225,53,63764,53,allow,177,94,83,2,30,1,1
49281,53,63913,53,allow,251,102,149,2,30,1,1
37042,53,37042,53,allow,237,98,139,2,30,1,1
56641,80,60111,80,allow,234,234,0,4,12,4,0
64664,53,45386,53,allow,250,86,164,4,33,2,2
63539,445,0,0,drop,70,70,0,1,0,1,0
63537,445,0,0,drop,70,70,0,1,0,1,0
63533,445,0,0,drop,70,70,0,1,0,1,0
58944,445,0,0,drop,66,66,0,1,0,1,0
63532,445,0,0,drop,70,70,0,1,0,1,0
58939,445,0,0,drop,66,66,0,1,0,1,0
58671,445,0,0,drop,70,70,0,1,0,1,0
58936,445,0,0,drop,66,66,0,1,0,1,0
58935,445,0,0,drop,66,66,0,1,0,1,0
58933,445,0,0,drop,66,66,0,1,0,1,0
58667,445,0,0,drop,70,70,0,1,0,1,0
63513,445,0,0,deny,70,70,0,1,0,1,0
58923,445,0,0,drop,66,66,0,1,0,1,0
39230,23,0,0,deny,60,60,0,1,0,1,0
58654,445,0,0,drop,70,70,0,1,0,1,0
58915,445,0,0,drop,66,66,0,1,0,1,0
63504,445,0,0,drop,70,70,0,1,0,1,0
58651,445,0,0,drop,70,70,0,1,0,1,0
58913,445,0,0,drop,66,66,0,1,0,1,0
58904,445,0,0,drop,66,66,0,1,0,1,0
58646,445,0,0,drop,70,70,0,1,0,1,0
58895,445,0,0,drop,66,66,0,1,0,1,0
58645,445,0,0,drop,70,70,0,1,0,1,0
58643,445,0,0,drop,70,70,0,1,0,1,0
63493,445,0,0,drop,70,70,0,1,0,1,0
63492,445,0,0,drop,70,70,0,1,0,1,0
58884,445,0,0,drop,66,66,0,1,0,1,0
58889,445,0,0,drop,66,66,0,1,0,1,0
58885,445,0,0,drop,66,66,0,1,0,1,0
58890,445,0,0,drop,66,66,0,1,0,1,0
58883,445,0,0,drop,66,66,0,1,0,1,0
58887,445,0,0,drop,66,66,0,1,0,1,0
58886,445,0,0,drop,66,66,0,1,0,1,0
58882,445,0,0,drop,66,66,0,1,0,1,0
58636,445,0,0,drop,70,70,0,1,0,1,0
58634,445,0,0,drop,70,70,0,1,0,1,0
58633,445,0,0,drop,70,70,0,1,0,1,0
58632,445,0,0,drop,70,70,0,1,0,1,0
58631,445,0,0,drop,70,70,0,1,0,1,0
58628,445,0,0,drop,70,70,0,1,0,1,0
58626,445,0,0,drop,70,70,0,1,0,1,0
63488,445,0,0,drop,70,70,0,1,0,1,0
63482,445,0,0,drop,70,70,0,1,0,1,0
63480,445,0,0,drop,70,70,0,1,0,1,0
63476,445,0,0,drop,70,70,0,1,0,1,0
58868,445,0,0,drop,66,66,0,1,0,1,0
58869,445,0,0,drop,66,66,0,1,0,1,0
58867,445,0,0,drop,66,66,0,1,0,1,0
58613,445,0,0,drop,70,70,0,1,0,1,0
58612,445,0,0,drop,70,70,0,1,0,1,0
58610,445,0,0,drop,70,70,0,1,0,1,0
58602,445,0,0,drop,70,70,0,1,0,1,0
58603,445,0,0,drop,70,70,0,1,0,1,0
63472,445,0,0,drop,70,70,0,1,0,1,0
63469,445,0,0,drop,70,70,0,1,0,1,0
63467,445,0,0,drop,70,70,0,1,0,1,0
63463,445,0,0,drop,70,70,0,1,0,1,0
58591,445,0,0,drop,70,70,0,1,0,1,0
63453,445,0,0,drop,70,70,0,1,0,1,0
63448,445,0,0,drop,70,70,0,1,0,1,0
58858,445,0,0,drop,66,66,0,1,0,1,0
58587,445,0,0,drop,70,70,0,1,0,1,0
50908,443,7886,443,allow,124,64,60,2,15,1,1
55754,53,32469,53,allow,170,87,83,2,31,1,1
55304,53,64050,53,allow,711,87,624,2,30,1,1
58325,53,35330,53,allow,251,79,172,2,30,1,1
56358,53,16023,53,allow,104,104,0,1,30,1,0
50907,443,12062,443,allow,124,64,60,2,15,1,1
57045,53,27906,53,allow,170,87,83,2,30,1,1
52054,80,49202,80,allow,1682,642,1040,13,54,4,9
55822,80,1122,80,allow,1052,612,440,10,16,5,5
56206,53,48081,53,allow,711,87,624,2,30,1,1
58578,445,0,0,drop,70,70,0,1,0,1,0
58577,445,0,0,drop,70,70,0,1,0,1,0
58576,445,0,0,drop,70,70,0,1,0,1,0
58574,445,0,0,drop,70,70,0,1,0,1,0
58570,445,0,0,drop,70,70,0,1,0,1,0
63446,445,0,0,drop,70,70,0,1,0,1,0
63443,445,0,0,drop,70,70,0,1,0,1,0
53321,443,65410,443,allow,416,210,206,7,28,4,3
58843,445,0,0,drop,66,66,0,1,0,1,0
58839,445,0,0,drop,66,66,0,1,0,1,0
58565,445,0,0,drop,70,70,0,1,0,1,0
63427,445,0,0,drop,70,70,0,1,0,1,0
63425,445,0,0,drop,70,70,0,1,0,1,0
63424,445,0,0,drop,70,70,0,1,0,1,0
58835,445,0,0,drop,66,66,0,1,0,1,0
58555,445,0,0,drop,70,70,0,1,0,1,0
58827,445,0,0,drop,66,66,0,1,0,1,0
58825,445,0,0,drop,66,66,0,1,0,1,0
58818,445,0,0,drop,66,66,0,1,0,1,0
58830,445,0,0,drop,66,66,0,1,0,1,0
58826,445,0,0,drop,66,66,0,1,0,1,0
58819,445,0,0,drop,66,66,0,1,0,1,0
58829,445,0,0,drop,66,66,0,1,0,1,0
58553,445,0,0,drop,70,70,0,1,0,1,0
63419,445,0,0,drop,70,70,0,1,0,1,0
63417,445,0,0,drop,70,70,0,1,0,1,0
63416,445,0,0,drop,70,70,0,1,0,1,0
63413,445,0,0,drop,70,70,0,1,0,1,0
58549,445,0,0,drop,70,70,0,1,0,1,0
58547,445,0,0,drop,70,70,0,1,0,1,0
58543,445,0,0,drop,70,70,0,1,0,1,0
63411,445,0,0,drop,70,70,0,1,0,1,0
63409,445,0,0,drop,70,70,0,1,0,1,0
63405,445,0,0,drop,70,70,0,1,0,1,0
59898,443,27640,443,allow,1265,684,581,13,30,6,7
55675,53,34777,53,allow,287,91,196,4,60,2,2
50470,80,50470,80,allow,2144,900,1244,11,26,7,4
57556,443,56704,443,allow,162,102,60,2,5,1,1
64274,53,5372,53,allow,197,102,95,2,32,1,1
49305,53,59053,53,allow,177,94,83,2,29,1,1
65126,443,41319,443,allow,958,384,574,14,34,7,7
60911,53,23878,53,allow,335,78,257,2,29,1,1
57045,53,5353,53,allow,177,94,83,2,29,1,1
65250,53,12810,53,allow,900,110,790,2,30,1,1
49817,53,29101,53,allow,401,91,310,4,29,2,2
56301,53,2529,53,allow,177,94,83,2,30,1,1
49383,53,44225,53,allow,94,94,0,1,30,1,0
63887,80,15748,80,allow,314,192,122,6,15,4,2
56358,53,42887,53,allow,210,110,100,2,33,1,1
56913,53,62016,53,allow,247,94,153,2,30,1,1
49438,443,56148,443,allow,180,60,120,4,15,2,2
58037,80,32783,80,allow,2339,1122,1217,11,20,6,5
57045,53,16294,53,allow,177,94,83,2,30,1,1
64814,53,63374,53,allow,212,102,110,2,30,1,1
57243,53,28936,53,allow,168,78,90,2,30,1,1
42727,53,0,0,allow,82,82,0,2,40,2,0
60476,80,59400,80,allow,613,539,74,7,15,6,1
50873,443,51953,443,allow,350,210,140,6,26,4,2
56283,53,17978,53,allow,315,102,213,2,30,1,1
64809,53,47769,53,allow,312,78,234,2,30,1,1
52539,80,47321,80,allow,1152,712,440,10,15,5,5
50061,80,3362,80,allow,405,285,120,5,15,3,2
49839,53,21176,53,allow,315,102,213,2,30,1,1
56222,53,43289,53,allow,168,78,90,2,30,1,1
65409,53,62247,53,allow,200,94,106,2,30,1,1
51595,443,19980,443,allow,632,158,474,2,30,1,1
58362,53,30634,53,allow,167,78,89,2,30,1,1
56706,80,18045,80,allow,214,140,74,4,25,3,1
46812,80,23325,80,allow,1137,679,458,10,15,6,4
58052,80,61267,80,allow,1550,853,697,9,15,5,4
56478,53,6625,53,allow,177,94,83,2,29,1,1
56007,53,24693,53,allow,197,102,95,2,35,1,1
56478,53,29572,53,allow,177,94,83,2,29,1,1
55754,53,35474,53,allow,177,94,83,2,30,1,1
64082,53,61850,53,allow,329,102,227,2,30,1,1
49266,53,8623,53,allow,86,86,0,1,30,1,0
55754,53,39478,53,allow,177,94,83,2,30,1,1
58364,53,50367,53,allow,167,78,89,2,30,1,1
58363,53,45299,53,allow,167,78,89,2,30,1,1
64731,53,43372,53,allow,241,110,131,2,30,1,1
64723,53,15149,53,allow,229,110,119,2,30,1,1
55704,53,8827,53,allow,177,94,83,2,31,1,1
49477,53,44035,53,allow,168,78,90,2,30,1,1
65350,53,62383,53,allow,168,86,82,2,30,1,1
65350,53,48988,53,allow,168,86,82,2,30,1,1
56388,53,23027,53,allow,186,95,91,3,34,2,1
45726,443,40256,443,allow,130,70,60,3,6,2,1
50284,443,28484,443,allow,208,60,148,4,12,2,2
37264,443,41734,443,allow,130,70,60,3,5,2,1
50565,443,52646,443,allow,1313,876,437,11,27,6,5
50562,443,27211,443,allow,1313,876,437,11,27,6,5
55761,53,38695,53,allow,168,78,90,2,30,1,1
58665,53,16877,53,allow,260,86,174,2,30,1,1
55704,53,43154,53,allow,177,94,83,2,30,1,1
64179,53,19210,53,allow,212,102,110,2,30,1,1
65350,53,48602,53,allow,168,86,82,2,31,1,1
58813,445,0,0,drop,66,66,0,1,0,1,0
58542,445,0,0,drop,70,70,0,1,0,1,0
63404,445,0,0,drop,70,70,0,1,0,1,0
58809,445,0,0,deny,66,66,0,1,0,1,0
63342,53,0,0,deny,72,72,0,1,0,1,0
58808,445,0,0,drop,66,66,0,1,0,1,0
58807,445,0,0,drop,66,66,0,1,0,1,0
58805,445,0,0,drop,66,66,0,1,0,1,0
58537,445,0,0,drop,70,70,0,1,0,1,0
63391,445,0,0,drop,70,70,0,1,0,1,0
58793,445,0,0,drop,66,66,0,1,0,1,0
58524,445,0,0,drop,70,70,0,1,0,1,0
58786,445,0,0,drop,66,66,0,1,0,1,0
63376,445,0,0,drop,70,70,0,1,0,1,0
58521,445,0,0,drop,70,70,0,1,0,1,0
58784,445,0,0,drop,66,66,0,1,0,1,0
58516,445,0,0,drop,70,70,0,1,0,1,0
58515,445,0,0,drop,70,70,0,1,0,1,0
58775,445,0,0,drop,66,66,0,1,0,1,0
58773,445,0,0,drop,66,66,0,1,0,1,0
58513,445,0,0,drop,70,70,0,1,0,1,0
64438,23,0,0,deny,60,60,0,1,0,1,0
63367,445,0,0,drop,70,70,0,1,0,1,0
63365,445,0,0,drop,70,70,0,1,0,1,0
63364,445,0,0,drop,70,70,0,1,0,1,0
58506,445,0,0,drop,70,70,0,1,0,1,0
58758,445,0,0,drop,66,66,0,1,0,1,0
58760,445,0,0,drop,66,66,0,1,0,1,0
58755,445,0,0,drop,66,66,0,1,0,1,0
58761,445,0,0,drop,66,66,0,1,0,1,0
58756,445,0,0,drop,66,66,0,1,0,1,0
58759,445,0,0,drop,66,66,0,1,0,1,0
58754,445,0,0,drop,66,66,0,1,0,1,0
58753,445,0,0,drop,66,66,0,1,0,1,0
58504,445,0,0,drop,70,70,0,1,0,1,0
58503,445,0,0,drop,70,70,0,1,0,1,0
58502,445,0,0,drop,70,70,0,1,0,1,0
58501,445,0,0,drop,70,70,0,1,0,1,0
58497,445,0,0,drop,70,70,0,1,0,1,0
58499,445,0,0,drop,70,70,0,1,0,1,0
63360,445,0,0,drop,70,70,0,1,0,1,0
63352,445,0,0,drop,70,70,0,1,0,1,0
63348,445,0,0,drop,70,70,0,1,0,1,0
58483,445,0,0,drop,70,70,0,1,0,1,0
58741,445,0,0,drop,66,66,0,1,0,1,0
58739,445,0,0,drop,66,66,0,1,0,1,0
58738,445,0,0,drop,66,66,0,1,0,1,0
58482,445,0,0,drop,70,70,0,1,0,1,0
58476,445,0,0,drop,70,70,0,1,0,1,0
58472,445,0,0,drop,70,70,0,1,0,1,0
58473,445,0,0,drop,70,70,0,1,0,1,0
63344,445,0,0,drop,70,70,0,1,0,1,0
63343,445,0,0,drop,70,70,0,1,0,1,0
63339,445,0,0,drop,70,70,0,1,0,1,0
58461,445,0,0,drop,70,70,0,1,0,1,0
55704,53,24414,53,allow,170,87,83,2,30,1,1
50561,80,19741,80,allow,318,192,126,6,26,4,2
50573,80,11289,80,allow,318,192,126,6,26,4,2
64274,53,57250,53,allow,104,104,0,2,35,2,0
50571,80,62731,80,allow,318,192,126,6,26,4,2
65350,53,19451,53,allow,75,75,0,1,30,1,0
50559,80,62420,80,allow,318,192,126,6,26,4,2
56810,53,59842,53,allow,751,95,656,2,30,1,1
37134,53,0,0,allow,82,82,0,1,30,1,0
50254,53,7590,53,allow,749,94,655,2,30,1,1
64379,53,64379,53,allow,235,90,145,2,33,1,1
38674,80,36626,80,allow,1114,534,580,12,16,7,5
56721,53,12920,53,allow,711,87,624,2,30,1,1
55721,53,57546,53,allow,170,87,83,2,31,1,1
50572,80,10361,80,allow,318,192,126,6,26,4,2
60380,443,8139,443,allow,70,70,0,2,8,2,0
50570,80,64078,80,allow,318,192,126,6,26,4,2
50568,80,17182,80,allow,318,192,126,6,26,4,2
50569,80,5164,80,allow,318,192,126,6,26,4,2
50560,80,54497,80,allow,318,192,126,6,26,4,2
57051,53,59033,53,allow,711,87,624,2,30,1,1
38834,53,64506,53,allow,168,78,90,2,30,1,1
55094,53,26727,53,allow,754,94,660,2,31,1,1
56559,53,54246,53,allow,711,87,624,2,31,1,1
62293,53,18482,53,allow,232,88,144,2,31,1,1
63325,445,0,0,drop,70,70,0,1,0,1,0
63324,445,0,0,drop,70,70,0,1,0,1,0
63322,445,0,0,drop,70,70,0,1,0,1,0
58457,445,0,0,drop,70,70,0,1,0,1,0
58728,445,0,0,drop,66,66,0,1,0,1,0
58447,445,0,0,drop,70,70,0,1,0,1,0
58446,445,0,0,drop,70,70,0,1,0,1,0
58444,445,0,0,drop,70,70,0,1,0,1,0
58443,445,0,0,drop,70,70,0,1,0,1,0
58439,445,0,0,drop,70,70,0,1,0,1,0
63318,445,0,0,drop,70,70,0,1,0,1,0
63316,445,0,0,drop,70,70,0,1,0,1,0
38637,22,0,0,deny,60,60,0,1,0,1,0
58713,445,0,0,drop,66,66,0,1,0,1,0
58710,445,0,0,drop,66,66,0,1,0,1,0
58434,445,0,0,drop,70,70,0,1,0,1,0
49159,53,5839,53,allow,195,86,109,2,30,1,1
56905,53,61024,53,allow,239,110,129,2,30,1,1
56301,53,31707,53,allow,177,94,83,2,29,1,1
65171,53,52756,53,allow,194,94,100,2,29,1,1
50591,80,63944,80,allow,318,192,126,6,25,4,2
50563,443,65476,443,allow,1313,876,437,11,26,6,5
50564,443,57456,443,allow,1313,876,437,11,26,6,5
50700,80,35384,80,allow,142,142,0,1,4,1,0
59470,53,45081,53,allow,184,86,98,2,29,1,1
49250,53,39996,53,allow,225,110,115,2,29,1,1
55704,53,10411,53,allow,177,94,83,2,31,1,1
56356,53,26889,53,allow,277,118,159,2,30,1,1
49715,53,39049,53,allow,807,94,713,2,30,1,1
50556,80,38454,80,allow,378,192,186,7,26,4,3
58029,80,1723,80,allow,374,192,182,7,21,4,3
55457,53,12461,53,allow,177,94,83,2,30,1,1
65104,53,46686,53,allow,311,94,217,2,30,1,1
56726,53,58672,53,allow,223,102,121,2,30,1,1
55457,53,25879,53,allow,177,94,83,2,30,1,1
50557,80,9717,80,allow,318,192,126,6,26,4,2
64364,53,34718,53,allow,323,110,213,2,30,1,1
57270,53,35020,53,allow,211,102,109,2,30,1,1
49487,53,45596,53,allow,267,102,165,2,30,1,1
50577,80,17204,80,allow,2350,896,1454,13,25,7,6
54985,53,45907,53,allow,177,94,83,2,30,1,1
55280,53,18692,53,allow,258,110,148,2,30,1,1
51195,123,46436,123,allow,184,94,90,2,30,1,1
52426,443,50838,443,allow,782,428,354,12,28,7,5
50575,80,13060,80,allow,318,192,126,6,25,4,2
50555,80,24136,80,allow,318,192,126,6,26,4,2
41371,53,41371,53,allow,220,90,130,2,30,1,1
56613,53,57106,53,allow,307,134,173,2,30,1,1
54985,53,30088,53,allow,177,94,83,2,30,1,1
57195,53,47926,53,allow,195,102,93,2,33,1,1
64838,53,23821,53,allow,338,110,228,2,30,1,1
57201,53,57201,53,allow,220,90,130,2,30,1,1
60186,53,47856,53,allow,199,94,105,2,30,1,1
50552,53,38940,53,allow,164,78,86,2,30,1,1
49195,53,13959,53,allow,239,110,129,2,30,1,1
55721,53,26269,53,allow,177,94,83,2,30,1,1
49606,53,17957,53,allow,258,110,148,2,30,1,1
57340,53,43547,53,allow,370,94,276,2,30,1,1
49272,53,30273,53,allow,168,86,82,2,31,1,1
50550,80,15717,80,allow,374,192,182,7,26,4,3
50551,80,44425,80,allow,374,192,182,7,26,4,3
57436,53,11754,53,allow,728,102,626,2,29,1,1
64807,53,32139,53,allow,246,118,128,2,29,1,1
55754,53,48167,53,allow,177,94,83,2,29,1,1
58666,53,17306,53,allow,167,78,89,2,29,1,1
58026,80,26240,80,allow,454,262,192,8,21,5,3
59181,53,28620,53,allow,260,86,174,2,29,1,1
49962,53,32122,53,allow,402,118,284,2,30,1,1
56682,53,9242,53,allow,196,86,110,2,30,1,1
58860,53,53609,53,allow,209,102,107,2,29,1,1
64510,53,63517,53,allow,280,118,162,2,29,1,1
60053,53,50009,53,allow,199,94,105,2,30,1,1
44921,53,22635,53,allow,168,78,90,2,30,1,1
56682,53,37640,53,allow,168,86,82,2,30,1,1
37840,53,37840,53,allow,216,90,126,2,30,1,1
55721,53,41720,53,allow,177,94,83,2,30,1,1
57309,53,41723,53,allow,316,110,206,2,30,1,1
49715,53,16817,53,allow,184,94,90,2,30,1,1
39154,80,25294,80,allow,1504,926,578,15,36,9,6
50553,80,13843,80,allow,378,192,186,7,26,4,3
50554,80,7103,80,allow,378,192,186,7,26,4,3
50558,80,10581,80,allow,318,192,126,6,26,4,2
65003,53,32396,53,allow,94,94,0,1,30,1,0
57195,53,17608,53,allow,195,102,93,2,30,1,1
53105,53,53105,53,allow,216,90,126,2,30,1,1
65509,53,55791,53,allow,321,102,219,2,30,1,1
47625,53,55385,53,allow,168,78,90,2,30,1,1
50574,80,28738,80,allow,318,192,126,6,25,4,2
64430,53,25685,53,allow,245,118,127,2,30,1,1
64913,53,34114,53,allow,211,102,109,2,30,1,1
55286,53,26564,53,allow,268,87,181,4,35,2,2
56914,53,35890,53,allow,100,100,0,2,35,2,0
51457,443,49898,443,allow,642,582,60,2,15,1,1
55286,53,17426,53,allow,268,87,181,4,35,2,2
50052,53,23158,53,allow,789,102,687,2,30,1,1
64805,53,48699,53,allow,278,102,176,2,31,1,1
63297,445,0,0,drop,70,70,0,1,0,1,0
63296,445,0,0,drop,70,70,0,1,0,1,0
58426,445,0,0,drop,70,70,0,1,0,1,0
58708,445,0,0,drop,66,66,0,1,0,1,0
58425,445,0,0,drop,70,70,0,1,0,1,0
58700,445,0,0,drop,66,66,0,1,0,1,0
58692,445,0,0,drop,66,66,0,1,0,1,0
58698,445,0,0,drop,66,66,0,1,0,1,0
58690,445,0,0,drop,66,66,0,1,0,1,0
58702,445,0,0,drop,66,66,0,1,0,1,0
58691,445,0,0,drop,66,66,0,1,0,1,0
58701,445,0,0,drop,66,66,0,1,0,1,0
63291,445,0,0,drop,70,70,0,1,0,1,0
58420,445,0,0,drop,70,70,0,1,0,1,0
63289,445,0,0,drop,70,70,0,1,0,1,0
63288,445,0,0,drop,70,70,0,1,0,1,0
63286,445,0,0,drop,70,70,0,1,0,1,0
58418,445,0,0,drop,70,70,0,1,0,1,0
58414,445,0,0,drop,70,70,0,1,0,1,0
58413,445,0,0,drop,70,70,0,1,0,1,0
63284,445,0,0,drop,70,70,0,1,0,1,0
63280,445,0,0,drop,70,70,0,1,0,1,0
63278,445,0,0,drop,70,70,0,1,0,1,0
58685,445,0,0,drop,66,66,0,1,0,1,0
63276,445,0,0,drop,70,70,0,1,0,1,0
58682,445,0,0,drop,66,66,0,1,0,1,0
58678,445,0,0,drop,66,66,0,1,0,1,0
58680,445,0,0,drop,66,66,0,1,0,1,0
58676,445,0,0,drop,66,66,0,1,0,1,0
58408,445,0,0,drop,70,70,0,1,0,1,0
63272,445,0,0,drop,70,70,0,1,0,1,0
63266,445,0,0,drop,70,70,0,1,0,1,0
63265,445,0,0,drop,70,70,0,1,0,1,0
58665,445,0,0,drop,66,66,0,1,0,1,0
58395,445,0,0,drop,70,70,0,1,0,1,0
58392,445,0,0,drop,70,70,0,1,0,1,0
58658,445,0,0,drop,66,66,0,1,0,1,0
63248,445,0,0,drop,70,70,0,1,0,1,0
58655,445,0,0,drop,66,66,0,1,0,1,0
58387,445,0,0,drop,70,70,0,1,0,1,0
58386,445,0,0,drop,70,70,0,1,0,1,0
58384,445,0,0,drop,70,70,0,1,0,1,0
58648,445,0,0,drop,66,66,0,1,0,1,0
58642,445,0,0,drop,66,66,0,1,0,1,0
58377,445,0,0,drop,70,70,0,1,0,1,0
63236,445,0,0,drop,70,70,0,1,0,1,0
58375,445,0,0,drop,70,70,0,1,0,1,0
58629,445,0,0,drop,66,66,0,1,0,1,0
58633,445,0,0,drop,66,66,0,1,0,1,0
58628,445,0,0,drop,66,66,0,1,0,1,0
58632,445,0,0,drop,66,66,0,1,0,1,0
58631,445,0,0,drop,66,66,0,1,0,1,0
58630,445,0,0,drop,66,66,0,1,0,1,0
58627,445,0,0,drop,66,66,0,1,0,1,0
58625,445,0,0,drop,66,66,0,1,0,1,0
58374,445,0,0,drop,70,70,0,1,0,1,0
58373,445,0,0,drop,70,70,0,1,0,1,0
58372,445,0,0,drop,70,70,0,1,0,1,0
58367,445,0,0,drop,70,70,0,1,0,1,0
58366,445,0,0,drop,70,70,0,1,0,1,0
63226,445,0,0,drop,70,70,0,1,0,1,0
63220,445,0,0,drop,70,70,0,1,0,1,0
58353,445,0,0,drop,70,70,0,1,0,1,0
58352,445,0,0,drop,70,70,0,1,0,1,0
58349,445,0,0,drop,70,70,0,1,0,1,0
65114,53,6427,53,allow,253,87,166,4,31,2,2
56568,53,15733,53,allow,711,87,624,2,30,1,1
42278,443,42278,443,allow,1916,1121,795,19,69,10,9
56280,53,50135,53,allow,1335,87,1248,4,59,2,2
55286,53,19401,53,allow,268,87,181,4,35,2,2
49295,53,50273,53,allow,280,96,184,4,34,2,2
56007,53,3946,53,allow,99,99,0,1,30,1,0
56896,53,19605,53,allow,256,87,169,2,30,1,1
59530,53,58720,53,allow,578,286,292,9,15,5,4
64303,53,50389,53,allow,253,87,166,4,31,2,2
56214,53,17373,53,allow,200,102,98,2,30,1,1
55075,53,29760,53,allow,178,91,87,2,30,1,1
55060,80,45377,80,allow,1289,724,565,11,26,6,5
50283,443,36964,443,allow,290,142,148,5,11,3,2
45847,443,35477,443,allow,1134,490,644,18,42,8,10
38163,53,38163,53,allow,216,89,127,2,30,1,1
50460,53,9714,53,allow,751,95,656,2,30,1,1
55168,53,23617,53,allow,816,97,719,2,31,1,1
64664,53,51475,53,allow,168,86,82,2,34,1,1
49569,53,48621,53,allow,91,91,0,2,37,2,0
40786,53,0,0,allow,82,82,0,1,30,1,0
65026,53,20362,53,allow,188,96,92,2,30,1,1
54653,53,54653,53,allow,231,90,141,2,30,1,1
49788,53,44900,53,allow,196,100,96,2,30,1,1
53727,53,60009,53,allow,172,72,100,2,30,1,1
56835,53,37097,53,allow,170,87,83,2,31,1,1
58342,445,0,0,drop,70,70,0,1,0,1,0
58343,445,0,0,drop,70,70,0,1,0,1,0
58612,445,0,0,drop,66,66,0,1,0,1,0
58611,445,0,0,drop,66,66,0,1,0,1,0
58610,445,0,0,drop,66,66,0,1,0,1,0
63214,445,0,0,drop,70,70,0,1,0,1,0
63210,445,0,0,drop,70,70,0,1,0,1,0
56509,53,49839,53,allow,1165,94,1071,2,30,1,1
64813,53,46374,53,allow,177,94,83,2,30,1,1
55872,123,4281,123,allow,184,94,90,2,30,1,1
56590,53,44528,53,allow,305,94,211,2,30,1,1
57062,80,49519,80,allow,864,507,357,8,38,5,3
56640,80,54626,80,allow,234,234,0,4,11,4,0
65479,53,45836,53,allow,728,102,626,2,29,1,1
65095,53,43220,53,allow,718,94,624,2,30,1,1
42281,443,42281,443,allow,1530,817,713,17,68,9,8
58021,80,10301,80,allow,318,192,126,6,20,4,2
56694,53,2840,53,allow,427,88,339,4,55,2,2
64559,53,32115,53,allow,193,102,91,2,29,1,1
55313,53,17189,53,allow,198,94,104,2,29,1,1
57086,53,59882,53,allow,228,102,126,2,29,1,1
55780,53,61304,53,allow,322,134,188,2,29,1,1
65327,53,49765,53,allow,822,102,720,2,29,1,1
50565,53,50708,53,allow,707,94,613,2,30,1,1
64413,53,4808,53,allow,209,102,107,2,30,1,1
65026,53,1071,53,allow,194,102,92,2,30,1,1
57330,53,57913,53,allow,177,94,83,2,30,1,1
49538,53,59762,53,allow,754,94,660,2,30,1,1
49937,53,46761,53,allow,718,94,624,2,30,1,1
64361,53,3934,53,allow,194,94,100,2,30,1,1
64868,53,56069,53,allow,216,102,114,2,30,1,1
56138,53,23162,53,allow,177,94,83,2,30,1,1
42853,443,44169,443,allow,130,70,60,3,5,2,1
58824,53,47620,53,allow,358,96,262,4,50,2,2
37297,443,46820,443,allow,232,172,60,3,5,2,1
56206,53,31271,53,allow,211,102,109,2,30,1,1
40001,53,40001,53,allow,218,90,128,2,30,1,1
55059,80,26318,80,allow,306,180,126,6,26,4,2
64647,53,15086,53,allow,718,94,624,2,30,1,1
58024,80,1081,80,allow,318,192,126,6,20,4,2
49461,53,60884,53,allow,314,102,212,2,30,1,1
39057,53,39057,53,allow,222,90,132,2,30,1,1
55442,53,42681,53,allow,177,94,83,2,30,1,1
37614,53,37614,53,allow,209,98,111,2,30,1,1
55300,53,49492,53,allow,308,94,214,2,30,1,1
57377,53,64833,53,allow,1165,94,1071,2,30,1,1
49558,53,18984,53,allow,177,94,83,2,30,1,1
49558,53,29414,53,allow,177,94,83,2,30,1,1
55057,80,24701,80,allow,306,180,126,6,26,4,2
41738,53,43971,53,allow,168,78,90,2,30,1,1
49930,53,6830,53,allow,361,94,267,2,30,1,1
63924,53,40615,53,allow,214,102,112,2,30,1,1
51459,443,47605,443,allow,379,259,120,4,16,2,2
51500,443,60787,443,allow,451,259,192,5,23,2,3
55657,53,56154,53,allow,101,101,0,2,34,2,0
42934,443,24809,443,allow,232,172,60,3,5,2,1
55075,53,54293,53,allow,181,94,87,2,33,1,1
49788,53,45773,53,allow,198,102,96,2,33,1,1
58016,80,61881,80,allow,378,192,186,7,21,4,3
65317,53,60723,53,allow,195,102,93,2,29,1,1
64559,53,14656,53,allow,816,102,714,2,29,1,1
55721,53,12194,53,allow,177,94,83,2,29,1,1
61980,53,64563,53,allow,374,104,270,4,50,2,2
64969,53,18068,53,allow,329,118,211,2,30,1,1
64408,53,53381,53,allow,199,94,105,2,29,1,1
50207,53,4187,53,allow,195,102,93,2,29,1,1
65113,53,56187,53,allow,232,102,130,2,29,1,1
64813,53,49645,53,allow,177,94,83,2,30,1,1
41093,53,34774,53,allow,78,78,0,1,30,1,0
48565,53,48565,53,allow,197,90,107,2,30,1,1
57330,53,61035,53,allow,177,94,83,2,30,1,1
49272,53,51922,53,allow,266,94,172,2,30,1,1
49841,53,36944,53,allow,227,110,117,2,30,1,1
49569,53,65331,53,allow,181,94,87,2,32,1,1
64670,53,9827,53,allow,183,86,97,2,30,1,1
49741,53,44929,53,allow,177,94,83,2,30,1,1
64449,53,62626,53,allow,249,94,155,2,30,1,1
62843,53,62843,53,allow,235,90,145,2,32,1,1
56214,53,46867,53,allow,200,102,98,2,33,1,1
51503,443,56151,443,allow,887,635,252,7,23,3,4
54828,443,7869,443,allow,150,150,0,1,5,1,0
55045,53,21912,53,allow,261,102,159,2,30,1,1
55286,53,22881,53,allow,268,87,181,4,35,2,2
55056,80,26189,80,allow,306,180,126,6,26,4,2
55055,80,30882,80,allow,306,180,126,6,26,4,2
49741,53,17465,53,allow,177,94,83,2,30,1,1
50223,53,39269,53,allow,165,86,79,2,30,1,1
50223,53,61828,53,allow,173,94,79,2,30,1,1
55442,53,12898,53,allow,177,94,83,2,30,1,1
49998,53,44432,53,allow,94,94,0,1,30,1,0
64055,53,9885,53,allow,265,91,174,4,37,2,2
56138,53,22955,53,allow,177,94,83,2,30,1,1
56518,53,3673,53,allow,177,94,83,2,31,1,1
55256,53,58019,53,allow,79,79,0,2,35,2,0
49989,443,4666,443,allow,300,168,132,4,6,2,2
56307,53,64603,53,allow,168,78,90,2,30,1,1
55156,53,44381,53,allow,194,102,92,2,30,1,1
60293,53,33499,53,allow,312,78,234,2,30,1,1
56298,53,17699,53,allow,173,94,79,2,30,1,1
51189,53,6847,53,allow,312,78,234,2,30,1,1
55156,53,26617,53,allow,194,102,92,2,31,1,1
63206,445,0,0,drop,70,70,0,1,0,1,0
58331,445,0,0,drop,70,70,0,1,0,1,0
50116,22,0,0,deny,60,60,0,1,0,1,0
58327,445,0,0,drop,70,70,0,1,0,1,0
63197,445,0,0,drop,70,70,0,1,0,1,0
63194,445,0,0,drop,70,70,0,1,0,1,0
63192,445,0,0,drop,70,70,0,1,0,1,0
58599,445,0,0,drop,66,66,0,1,0,1,0
58318,445,0,0,drop,70,70,0,1,0,1,0
58317,445,0,0,drop,70,70,0,1,0,1,0
58316,445,0,0,drop,70,70,0,1,0,1,0
58314,445,0,0,drop,70,70,0,1,0,1,0
58311,445,0,0,drop,70,70,0,1,0,1,0
63190,445,0,0,drop,70,70,0,1,0,1,0
58305,445,0,0,drop,70,70,0,1,0,1,0
58583,445,0,0,drop,66,66,0,1,0,1,0
58582,445,0,0,drop,66,66,0,1,0,1,0
41916,53,0,0,deny,60,60,0,1,0,1,0
63179,445,0,0,drop,70,70,0,1,0,1,0
58297,445,0,0,drop,70,70,0,1,0,1,0
58295,445,0,0,drop,70,70,0,1,0,1,0
63174,445,0,0,drop,70,70,0,1,0,1,0
63172,445,0,0,drop,70,70,0,1,0,1,0
58580,445,0,0,drop,66,66,0,1,0,1,0
58570,445,0,0,drop,66,66,0,1,0,1,0
58574,445,0,0,drop,66,66,0,1,0,1,0
58572,445,0,0,drop,66,66,0,1,0,1,0
58567,445,0,0,drop,66,66,0,1,0,1,0
58569,445,0,0,drop,66,66,0,1,0,1,0
58568,445,0,0,drop,66,66,0,1,0,1,0
58564,445,0,0,drop,66,66,0,1,0,1,0
58290,445,0,0,drop,70,70,0,1,0,1,0
58289,445,0,0,drop,70,70,0,1,0,1,0
63161,445,0,0,drop,70,70,0,1,0,1,0
63160,445,0,0,drop,70,70,0,1,0,1,0
63157,445,0,0,drop,70,70,0,1,0,1,0
58285,445,0,0,drop,70,70,0,1,0,1,0
58284,445,0,0,drop,70,70,0,1,0,1,0
63153,445,0,0,drop,70,70,0,1,0,1,0
63151,445,0,0,drop,70,70,0,1,0,1,0
58556,445,0,0,drop,66,66,0,1,0,1,0
63148,445,0,0,drop,70,70,0,1,0,1,0
58553,445,0,0,drop,66,66,0,1,0,1,0
58279,445,0,0,drop,70,70,0,1,0,1,0
58552,445,0,0,drop,66,66,0,1,0,1,0
58550,445,0,0,drop,66,66,0,1,0,1,0
58549,445,0,0,drop,66,66,0,1,0,1,0
63147,445,0,0,drop,70,70,0,1,0,1,0
63137,445,0,0,drop,70,70,0,1,0,1,0
63133,445,0,0,drop,70,70,0,1,0,1,0
58266,445,0,0,drop,70,70,0,1,0,1,0
58537,445,0,0,drop,66,66,0,1,0,1,0
58263,445,0,0,drop,70,70,0,1,0,1,0
63196,445,0,0,deny,62,62,0,1,0,1,0
58530,445,0,0,drop,66,66,0,1,0,1,0
63122,445,0,0,drop,70,70,0,1,0,1,0
58259,445,0,0,drop,70,70,0,1,0,1,0
58257,445,0,0,drop,70,70,0,1,0,1,0
58528,445,0,0,drop,66,66,0,1,0,1,0
58255,445,0,0,drop,70,70,0,1,0,1,0
58519,445,0,0,drop,66,66,0,1,0,1,0
58510,445,0,0,drop,66,66,0,1,0,1,0
58248,445,0,0,drop,70,70,0,1,0,1,0
58246,445,0,0,drop,70,70,0,1,0,1,0
63113,445,0,0,drop,70,70,0,1,0,1,0
63109,445,0,0,drop,70,70,0,1,0,1,0
63108,445,0,0,drop,70,70,0,1,0,1,0
58500,445,0,0,drop,66,66,0,1,0,1,0
58504,445,0,0,drop,66,66,0,1,0,1,0
58505,445,0,0,drop,66,66,0,1,0,1,0
52425,80,64946,80,allow,1630,918,712,12,16,7,5
49483,53,49626,53,allow,172,88,84,2,30,1,1
49907,53,29279,53,allow,308,92,216,2,30,1,1
57997,80,61005,80,allow,318,192,126,6,21,4,2
56637,53,42734,53,allow,711,87,624,2,30,1,1
55340,53,32896,53,allow,184,94,90,2,31,1,1
64251,53,51222,53,allow,170,87,83,2,31,1,1
55924,53,5985,53,allow,711,87,624,2,31,1,1
49701,53,52830,53,allow,488,110,378,4,32,2,2
56518,53,9053,53,allow,170,87,83,2,30,1,1
51349,80,65226,80,allow,1056,682,374,10,15,6,4
49629,53,32885,53,allow,742,88,654,2,30,1,1
55156,53,61392,53,allow,188,96,92,2,30,1,1
56775,53,28683,53,allow,170,87,83,2,30,1,1
49472,53,22827,53,allow,751,95,656,2,31,1,1
49453,53,4294,53,allow,763,101,662,2,31,1,1
56567,53,47104,53,allow,701,88,613,2,30,1,1
50615,443,36645,443,allow,1577,949,628,16,71,9,7
58782,53,58782,53,allow,310,94,216,2,30,1,1
57998,80,49916,80,allow,318,192,126,6,21,4,2
58007,80,40862,80,allow,318,192,126,6,21,4,2
64958,53,27605,53,allow,216,94,122,2,30,1,1
56509,53,27088,53,allow,1164,93,1071,2,30,1,1
62912,53,42026,53,allow,214,76,138,2,30,1,1
49691,53,43996,53,allow,378,127,251,2,30,1,1
57411,53,38630,53,allow,711,87,624,2,31,1,1
65436,53,35308,53,allow,332,98,234,3,58,2,1
55471,53,40426,53,allow,760,97,663,2,31,1,1
57195,53,29138,53,allow,190,97,93,2,31,1,1
49771,53,11315,53,allow,728,96,632,2,31,1,1
58502,445,0,0,drop,66,66,0,1,0,1,0
58503,445,0,0,drop,66,66,0,1,0,1,0
58498,445,0,0,drop,66,66,0,1,0,1,0
58501,445,0,0,drop,66,66,0,1,0,1,0
58497,445,0,0,drop,66,66,0,1,0,1,0
58245,445,0,0,drop,70,70,0,1,0,1,0
58244,445,0,0,drop,70,70,0,1,0,1,0
58243,445,0,0,drop,70,70,0,1,0,1,0
58238,445,0,0,drop,70,70,0,1,0,1,0
58239,445,0,0,drop,70,70,0,1,0,1,0
42731,23,0,0,deny,60,60,0,1,0,1,0
58225,445,0,0,drop,70,70,0,1,0,1,0
58223,445,0,0,drop,70,70,0,1,0,1,0
58221,445,0,0,drop,70,70,0,1,0,1,0
64870,53,1765,53,allow,200,102,98,2,33,1,1
49712,53,62216,53,allow,178,94,84,2,30,1,1
59904,53,31184,53,allow,312,78,234,2,29,1,1
58215,445,0,0,drop,70,70,0,1,0,1,0
58214,445,0,0,drop,70,70,0,1,0,1,0
63104,445,0,0,drop,70,70,0,1,0,1,0
63095,445,0,0,drop,70,70,0,1,0,1,0
63091,445,0,0,drop,70,70,0,1,0,1,0
58483,445,0,0,drop,66,66,0,1,0,1,0
58485,445,0,0,drop,66,66,0,1,0,1,0
58484,445,0,0,drop,66,66,0,1,0,1,0
63088,445,0,0,drop,70,70,0,1,0,1,0
59236,17,0,0,deny,60,60,0,1,0,1,0
58203,445,0,0,drop,70,70,0,1,0,1,0
63086,445,0,0,drop,70,70,0,1,0,1,0
63084,445,0,0,drop,70,70,0,1,0,1,0
63082,445,0,0,drop,70,70,0,1,0,1,0
58199,445,0,0,drop,70,70,0,1,0,1,0
63069,445,0,0,drop,70,70,0,1,0,1,0
63064,445,0,0,drop,70,70,0,1,0,1,0
58189,445,0,0,drop,70,70,0,1,0,1,0
58190,445,0,0,drop,70,70,0,1,0,1,0
58188,445,0,0,drop,70,70,0,1,0,1,0
58185,445,0,0,drop,70,70,0,1,0,1,0
58472,445,0,0,drop,66,66,0,1,0,1,0
45052,80,23641,80,allow,1539,553,986,10,14,6,4
64303,53,30875,53,allow,298,87,211,4,34,2,2
49988,443,12921,443,allow,214,82,132,4,5,2,2
65114,53,53193,53,allow,177,94,83,2,29,1,1
65333,53,15875,53,allow,197,94,103,2,29,1,1
65026,53,61151,53,allow,194,102,92,2,29,1,1
65194,53,43835,53,allow,181,94,87,2,29,1,1
56509,53,12733,53,allow,1165,94,1071,2,29,1,1
56775,53,64956,53,allow,177,94,83,2,29,1,1
56518,53,42205,53,allow,177,94,83,2,29,1,1
56835,53,60962,53,allow,177,94,83,2,29,1,1
65114,53,14258,53,allow,177,94,83,2,29,1,1
58563,53,4425,53,allow,312,78,234,2,29,1,1
56835,53,48670,53,allow,177,94,83,2,30,1,1
56518,53,9121,53,allow,177,94,83,2,30,1,1
55340,53,17205,53,allow,184,94,90,2,30,1,1
58309,53,16090,53,allow,255,86,169,2,30,1,1
64766,53,54775,53,allow,195,102,93,2,30,1,1
58006,80,48045,80,allow,318,192,126,6,21,4,2
59180,53,28928,53,allow,260,86,174,2,30,1,1
59986,53,15041,53,allow,186,86,100,2,30,1,1
59341,53,56377,53,allow,187,78,109,2,30,1,1
64877,53,52528,53,allow,94,94,0,1,30,1,0
44007,123,12438,123,allow,184,94,90,2,30,1,1
56775,53,53871,53,allow,177,94,83,2,30,1,1
49483,53,48622,53,allow,178,94,84,2,30,1,1
64251,53,6102,53,allow,177,94,83,2,30,1,1
50643,443,60929,443,allow,1512,844,668,16,64,9,7
59199,53,18550,53,allow,228,94,134,2,30,1,1
42479,80,8740,80,allow,696,413,283,7,15,5,2
56596,53,10703,53,allow,194,102,92,2,31,1,1
64524,53,20476,53,allow,274,94,180,4,33,2,2
64086,53,31835,53,allow,241,94,147,2,29,1,1
65264,53,8238,53,allow,256,88,168,4,35,2,2
55631,53,42735,53,allow,422,96,326,4,42,2,2
36368,80,60128,80,allow,78,78,0,1,5,1,0
56298,53,16841,53,allow,173,94,79,2,29,1,1
55340,53,11264,53,allow,184,94,90,2,30,1,1
57319,53,57319,53,allow,198,90,108,2,29,1,1
39252,53,39252,53,allow,197,90,107,2,29,1,1
39583,53,11422,53,allow,86,86,0,1,30,1,0
64303,53,57962,53,allow,177,94,83,2,29,1,1
55547,53,1923,53,allow,339,94,245,2,30,1,1
56950,53,38998,53,allow,183,86,97,2,29,1,1
64251,53,24532,53,allow,177,94,83,2,30,1,1
56775,53,45440,53,allow,177,94,83,2,30,1,1
56896,53,21578,53,allow,177,94,83,2,30,1,1
50263,53,58515,53,allow,771,102,669,2,30,1,1
56509,53,37473,53,allow,1165,94,1071,2,30,1,1
60873,53,0,0,allow,86,86,0,1,30,1,0
56583,53,58946,53,allow,177,94,83,2,31,1,1
49701,53,39669,53,allow,197,102,95,2,31,1,1
56563,53,56693,53,allow,177,94,83,2,30,1,1
60913,80,45601,80,allow,613,539,74,7,15,6,1
57098,53,51101,53,allow,229,94,135,2,30,1,1
50255,53,26984,53,allow,199,102,97,2,30,1,1
64251,53,65162,53,allow,177,94,83,2,30,1,1
56038,53,33876,53,allow,177,94,83,2,30,1,1
50379,53,12803,53,allow,197,102,95,2,30,1,1
58009,80,11441,80,allow,495,192,303,6,21,4,2
56896,53,58642,53,allow,177,94,83,2,30,1,1
64725,53,58713,53,allow,757,102,655,2,30,1,1
55084,53,9496,53,allow,177,94,83,2,31,1,1
56639,80,24086,80,allow,234,234,0,4,12,4,0
37715,53,37715,53,allow,235,90,145,2,32,1,1
51927,80,21213,80,allow,1945,1002,943,11,20,7,4
49310,53,42489,53,allow,816,102,714,2,30,1,1
50447,53,27142,53,allow,765,102,663,2,30,1,1
49230,53,1845,53,allow,168,86,82,2,31,1,1
55340,53,63068,53,allow,184,94,90,2,31,1,1
58183,445,0,0,drop,70,70,0,1,0,1,0
63060,445,0,0,drop,70,70,0,1,0,1,0
63059,445,0,0,drop,70,70,0,1,0,1,0
58176,445,0,0,drop,70,70,0,1,0,1,0
58457,445,0,0,drop,66,66,0,1,0,1,0
58455,445,0,0,drop,66,66,0,1,0,1,0
58169,445,0,0,drop,70,70,0,1,0,1,0
58168,445,0,0,drop,70,70,0,1,0,1,0
63052,445,0,0,drop,70,70,0,1,0,1,0
63046,445,0,0,drop,70,70,0,1,0,1,0
63042,445,0,0,drop,70,70,0,1,0,1,0
58450,445,0,0,drop,66,66,0,1,0,1,0
58163,445,0,0,drop,70,70,0,1,0,1,0
58161,445,0,0,drop,70,70,0,1,0,1,0
58446,445,0,0,drop,66,66,0,1,0,1,0
58442,445,0,0,drop,66,66,0,1,0,1,0
58445,445,0,0,drop,66,66,0,1,0,1,0
58436,445,0,0,drop,66,66,0,1,0,1,0
58439,445,0,0,drop,66,66,0,1,0,1,0
58435,445,0,0,drop,66,66,0,1,0,1,0
58440,445,0,0,drop,66,66,0,1,0,1,0
63036,445,0,0,drop,70,70,0,1,0,1,0
63033,445,0,0,drop,70,70,0,1,0,1,0
63032,445,0,0,drop,70,70,0,1,0,1,0
63029,445,0,0,drop,70,70,0,1,0,1,0
58157,445,0,0,drop,70,70,0,1,0,1,0
58155,445,0,0,drop,70,70,0,1,0,1,0
63027,445,0,0,drop,70,70,0,1,0,1,0
63022,445,0,0,drop,70,70,0,1,0,1,0
63026,445,0,0,drop,70,70,0,1,0,1,0
58430,445,0,0,drop,66,66,0,1,0,1,0
58151,445,0,0,drop,70,70,0,1,0,1,0
63020,445,0,0,drop,70,70,0,1,0,1,0
58426,445,0,0,drop,66,66,0,1,0,1,0
58424,445,0,0,drop,66,66,0,1,0,1,0
58422,445,0,0,drop,66,66,0,1,0,1,0
58420,445,0,0,drop,66,66,0,1,0,1,0
63008,445,0,0,drop,70,70,0,1,0,1,0
63007,445,0,0,drop,70,70,0,1,0,1,0
58138,445,0,0,drop,70,70,0,1,0,1,0
58409,445,0,0,drop,66,66,0,1,0,1,0
58135,445,0,0,drop,70,70,0,1,0,1,0
58402,445,0,0,drop,66,66,0,1,0,1,0
62992,445,0,0,drop,70,70,0,1,0,1,0
58131,445,0,0,drop,70,70,0,1,0,1,0
58129,445,0,0,drop,70,70,0,1,0,1,0
58127,445,0,0,drop,70,70,0,1,0,1,0
58399,445,0,0,drop,66,66,0,1,0,1,0
58392,445,0,0,drop,66,66,0,1,0,1,0
58387,445,0,0,drop,66,66,0,1,0,1,0
50264,443,29730,443,allow,430,60,370,7,24,2,5
43310,80,46970,80,allow,811,671,140,6,32,4,2
57031,53,13224,53,allow,711,87,624,2,30,1,1
64396,53,52154,53,allow,349,91,258,2,30,1,1
65486,53,11134,53,allow,760,97,663,2,30,1,1
55905,53,39225,53,allow,754,94,660,2,30,1,1
56583,53,53516,53,allow,170,87,83,2,31,1,1
55508,53,1825,53,allow,814,110,704,2,30,1,1
59892,443,22013,443,allow,1813,1004,809,16,28,8,8
49712,53,29972,53,allow,172,88,84,2,30,1,1
65361,53,33877,53,allow,760,97,663,2,30,1,1
59890,443,5968,443,allow,1401,864,537,12,28,6,6
50390,53,29650,53,allow,772,103,669,2,30,1,1
55466,53,2778,53,allow,170,87,83,2,30,1,1
59887,443,6975,443,allow,1576,973,603,14,28,7,7
59891,443,7306,443,allow,1813,1004,809,16,28,8,8
59881,443,61673,443,allow,302,120,182,6,31,3,3
62344,80,50382,80,allow,1892,583,1309,12,16,6,6
57843,443,8894,443,allow,130,70,60,2,15,1,1
50277,443,65171,443,allow,268,120,148,5,11,3,2
49254,53,31955,53,allow,814,110,704,2,30,1,1
49690,53,24171,53,allow,216,110,106,2,30,1,1
56596,53,38999,53,allow,188,96,92,2,31,1,1
49302,443,39111,443,allow,454,262,192,8,27,5,3
59888,443,28259,443,allow,1401,864,537,12,28,6,6
59884,443,34275,443,allow,1401,864,537,12,28,6,6
59889,443,31832,443,allow,1576,973,603,14,28,7,7
59885,443,10109,443,allow,1401,864,537,12,28,6,6
41247,80,40368,80,allow,78,78,0,1,5,1,0
49901,53,7736,53,allow,272,122,150,2,30,1,1
64857,53,57218,53,allow,332,104,228,2,30,1,1
56038,53,40412,53,allow,170,87,83,2,30,1,1
49234,53,23533,53,allow,206,97,109,2,30,1,1
49989,53,26196,53,allow,346,111,235,2,30,1,1
49690,53,35001,53,allow,216,110,106,2,30,1,1
57366,53,36112,53,allow,711,87,624,2,31,1,1
54956,53,35292,53,allow,711,87,624,2,31,1,1
57218,53,55252,53,allow,789,110,679,2,31,1,1
49414,53,16481,53,allow,770,102,668,2,31,1,1
49929,53,13431,53,allow,260,124,136,2,31,1,1
56464,53,12940,53,allow,170,87,83,2,31,1,1
49862,53,62626,53,allow,744,89,655,2,31,1,1
50178,53,23159,53,allow,758,96,662,2,31,1,1
49191,53,32868,53,allow,186,95,91,2,31,1,1
58120,445,0,0,drop,70,70,0,1,0,1,0
58118,445,0,0,drop,70,70,0,1,0,1,0
60754,53,60754,53,allow,198,90,108,2,30,1,1
52853,443,45061,443,allow,130,70,60,2,15,1,1
49690,53,62022,53,allow,322,110,212,4,30,2,2
49690,53,31414,53,allow,216,110,106,2,30,1,1
52802,53,8957,53,allow,350,210,140,6,14,4,2
38261,443,49964,443,allow,134,60,74,3,4,2,1
49178,53,11567,53,allow,822,102,720,2,29,1,1
50379,53,49959,53,allow,197,102,95,2,29,1,1
49339,80,8376,80,allow,1467,361,1106,10,15,5,5
54033,443,63656,443,allow,190,70,120,4,15,2,2
42881,443,29777,443,allow,134,60,74,3,4,2,1
51820,80,11900,80,allow,366,240,126,7,25,5,2
50605,443,56643,443,allow,1766,975,791,15,71,9,6
49852,53,8412,53,allow,94,94,0,1,29,1,0
64766,53,31618,53,allow,195,102,93,2,29,1,1
56835,53,56114,53,allow,177,94,83,2,29,1,1
38264,443,28661,443,allow,134,60,74,3,4,2,1
65264,53,15709,53,allow,178,94,84,2,29,1,1
55084,53,64405,53,allow,177,94,83,2,29,1,1
49230,53,46684,53,allow,168,86,82,2,30,1,1
50255,53,25168,53,allow,199,102,97,2,29,1,1
53306,53,0,0,allow,86,86,0,1,29,1,0
57431,53,35038,53,allow,392,134,258,2,30,1,1
55466,53,45668,53,allow,177,94,83,2,30,1,1
59654,53,16319,53,allow,199,94,105,2,30,1,1
65200,53,5141,53,allow,214,110,104,2,30,1,1
64524,53,42733,53,allow,184,94,90,2,31,1,1
65496,53,41450,53,allow,280,96,184,4,34,2,2
57195,53,19593,53,allow,195,102,93,2,33,1,1
64908,53,50064,53,allow,812,110,702,2,30,1,1
57332,53,48938,53,allow,168,86,82,2,30,1,1
64888,53,19204,53,allow,718,94,624,2,30,1,1
64274,53,64916,53,allow,110,110,0,1,30,1,0
56583,53,7154,53,allow,177,94,83,2,30,1,1
49742,53,51185,53,allow,216,110,106,2,30,1,1
63988,53,36168,53,allow,195,102,93,2,30,1,1
65200,53,50135,53,allow,214,110,104,2,30,1,1
50713,53,50713,53,allow,198,90,108,2,30,1,1
56954,80,1117,80,allow,1469,970,499,9,65,6,3
38119,53,41188,53,allow,199,94,105,2,30,1,1
49742,53,16673,53,allow,216,110,106,2,30,1,1
49257,53,6745,53,allow,199,102,97,2,30,1,1
56596,53,31650,53,allow,194,102,92,2,30,1,1
57201,53,54960,53,allow,173,94,79,2,30,1,1
64274,53,21757,53,allow,299,104,195,4,35,2,2
49698,53,53512,53,allow,184,102,82,2,30,1,1
49742,53,36313,53,allow,216,110,106,2,30,1,1
52892,443,14885,443,allow,130,70,60,2,14,1,1
49310,53,61139,53,allow,186,95,91,3,33,2,1
51818,80,64733,80,allow,366,240,126,7,25,5,2
42880,443,28151,443,allow,134,60,74,3,4,2,1
37886,443,62818,443,allow,134,60,74,3,5,2,1
49178,53,26968,53,allow,199,102,97,2,29,1,1
56563,53,35411,53,allow,177,94,83,2,29,1,1
49698,53,38054,53,allow,184,102,82,2,30,1,1
50255,53,55681,53,allow,199,102,97,2,29,1,1
49257,53,51437,53,allow,199,102,97,2,30,1,1
49712,53,30095,53,allow,178,94,84,2,29,1,1
56038,53,20578,53,allow,177,94,83,2,29,1,1
55466,53,37366,53,allow,177,94,83,2,30,1,1
49712,53,3465,53,allow,178,94,84,2,30,1,1
57201,53,44480,53,allow,165,86,79,2,30,1,1
56038,53,24286,53,allow,177,94,83,2,30,1,1
49701,53,24977,53,allow,197,102,95,2,30,1,1
51120,53,11316,53,allow,168,78,90,2,30,1,1
49713,53,44635,53,allow,177,94,83,2,30,1,1
59879,443,12932,443,allow,302,120,182,6,32,3,3
49508,53,13388,53,allow,199,102,97,2,30,1,1
38269,443,44100,443,allow,130,70,60,2,15,1,1
65040,53,27133,53,allow,256,88,168,4,32,2,2
49713,53,37729,53,allow,177,94,83,2,30,1,1
49359,53,8497,53,allow,216,110,106,2,30,1,1
49535,53,29045,53,allow,771,102,669,2,30,1,1
42996,53,58544,53,allow,168,78,90,2,30,1,1
57332,53,59062,53,allow,184,102,82,2,30,1,1
57389,53,29962,53,allow,193,102,91,2,30,1,1
64410,53,61695,53,allow,196,102,94,2,30,1,1
50022,53,19595,53,allow,182,94,88,2,30,1,1
63988,53,51956,53,allow,195,102,93,2,30,1,1
55503,53,56462,53,allow,216,110,106,2,30,1,1
57333,53,18124,53,allow,342,110,232,2,30,1,1
56469,53,63453,53,allow,177,94,83,2,31,1,1
56939,53,41325,53,allow,216,110,106,2,31,1,1
57389,53,9146,53,allow,193,102,91,2,31,1,1
59607,53,65103,53,allow,209,102,107,2,30,1,1
49954,53,49870,53,allow,216,110,106,2,30,1,1
55513,53,1888,53,allow,184,94,90,2,30,1,1
50375,53,64896,53,allow,211,110,101,2,30,1,1
49359,53,18321,53,allow,216,110,106,2,30,1,1
56520,53,53336,53,allow,177,94,83,2,31,1,1
49508,53,17731,53,allow,199,102,97,2,30,1,1
55503,53,44075,53,allow,216,110,106,2,30,1,1
49701,53,55177,53,allow,197,102,95,2,30,1,1
56388,53,20771,53,allow,816,102,714,2,30,1,1
56484,53,42861,53,allow,214,110,104,2,31,1,1
55740,53,13751,53,allow,228,110,118,2,30,1,1
58117,445,0,0,drop,70,70,0,1,0,1,0
62982,445,0,0,drop,70,70,0,1,0,1,0
58115,445,0,0,drop,70,70,0,1,0,1,0
58375,445,0,0,drop,66,66,0,1,0,1,0
58113,445,0,0,drop,70,70,0,1,0,1,0
58377,445,0,0,drop,66,66,0,1,0,1,0
58376,445,0,0,drop,66,66,0,1,0,1,0
58112,445,0,0,drop,70,70,0,1,0,1,0
58374,445,0,0,drop,66,66,0,1,0,1,0
58373,445,0,0,drop,66,66,0,1,0,1,0
58372,445,0,0,drop,66,66,0,1,0,1,0
58371,445,0,0,drop,66,66,0,1,0,1,0
58369,445,0,0,drop,66,66,0,1,0,1,0
58097,445,0,0,drop,70,70,0,1,0,1,0
58096,445,0,0,drop,70,70,0,1,0,1,0
58091,445,0,0,drop,70,70,0,1,0,1,0
58086,445,0,0,drop,70,70,0,1,0,1,0
58087,445,0,0,drop,70,70,0,1,0,1,0
62977,445,0,0,drop,70,70,0,1,0,1,0
62976,445,0,0,drop,70,70,0,1,0,1,0
62965,445,0,0,drop,70,70,0,1,0,1,0
58356,445,0,0,drop,66,66,0,1,0,1,0
58355,445,0,0,drop,66,66,0,1,0,1,0
58354,445,0,0,drop,66,66,0,1,0,1,0
58075,445,0,0,drop,70,70,0,1,0,1,0
62960,445,0,0,drop,70,70,0,1,0,1,0
62956,445,0,0,drop,70,70,0,1,0,1,0
62954,445,0,0,drop,70,70,0,1,0,1,0
62953,445,0,0,drop,70,70,0,1,0,1,0
58071,445,0,0,drop,70,70,0,1,0,1,0
58062,445,0,0,drop,70,70,0,1,0,1,0
58061,445,0,0,drop,70,70,0,1,0,1,0
58059,445,0,0,drop,70,70,0,1,0,1,0
39516,23,0,0,deny,60,60,0,1,0,1,0
58058,445,0,0,drop,70,70,0,1,0,1,0
62941,445,0,0,drop,70,70,0,1,0,1,0
62938,445,0,0,drop,70,70,0,1,0,1,0
62936,445,0,0,drop,70,70,0,1,0,1,0
58054,445,0,0,drop,70,70,0,1,0,1,0
58344,445,0,0,drop,66,66,0,1,0,1,0
58048,445,0,0,drop,70,70,0,1,0,1,0
62935,445,0,0,drop,70,70,0,1,0,1,0
62933,445,0,0,drop,70,70,0,1,0,1,0
58327,445,0,0,drop,66,66,0,1,0,1,0
58326,445,0,0,drop,66,66,0,1,0,1,0
58041,445,0,0,drop,70,70,0,1,0,1,0
58040,445,0,0,drop,70,70,0,1,0,1,0
35833,23,0,0,deny,60,60,0,1,0,1,0
62923,445,0,0,drop,70,70,0,1,0,1,0
58034,445,0,0,drop,70,70,0,1,0,1,0
62916,445,0,0,drop,70,70,0,1,0,1,0
62914,445,0,0,drop,70,70,0,1,0,1,0
58033,445,0,0,drop,70,70,0,1,0,1,0
58321,445,0,0,drop,66,66,0,1,0,1,0
58313,445,0,0,drop,66,66,0,1,0,1,0
58315,445,0,0,drop,66,66,0,1,0,1,0
58318,445,0,0,drop,66,66,0,1,0,1,0
58314,445,0,0,drop,66,66,0,1,0,1,0
58311,445,0,0,drop,66,66,0,1,0,1,0
58309,445,0,0,drop,66,66,0,1,0,1,0
58308,445,0,0,drop,66,66,0,1,0,1,0
58029,445,0,0,drop,70,70,0,1,0,1,0
62907,445,0,0,drop,70,70,0,1,0,1,0
62905,445,0,0,drop,70,70,0,1,0,1,0
62903,445,0,0,drop,70,70,0,1,0,1,0
62902,445,0,0,drop,70,70,0,1,0,1,0
58028,445,0,0,drop,70,70,0,1,0,1,0
58023,445,0,0,drop,70,70,0,1,0,1,0
62900,445,0,0,drop,70,70,0,1,0,1,0
62895,445,0,0,drop,70,70,0,1,0,1,0
58301,445,0,0,drop,66,66,0,1,0,1,0
62892,445,0,0,drop,70,70,0,1,0,1,0
58298,445,0,0,drop,66,66,0,1,0,1,0
58296,445,0,0,drop,66,66,0,1,0,1,0
58294,445,0,0,drop,66,66,0,1,0,1,0
58292,445,0,0,drop,66,66,0,1,0,1,0
58010,445,0,0,drop,70,70,0,1,0,1,0
62883,445,0,0,drop,70,70,0,1,0,1,0
62880,445,0,0,drop,70,70,0,1,0,1,0
58007,445,0,0,drop,70,70,0,1,0,1,0
58282,445,0,0,drop,66,66,0,1,0,1,0
57134,53,50387,53,allow,1425,97,1328,4,53,2,2
57438,53,17355,53,allow,782,105,677,2,30,1,1
64902,53,51695,53,allow,414,106,308,2,30,1,1
50669,80,58976,80,allow,1485,806,679,13,15,7,6
55803,53,50944,53,allow,760,97,663,2,30,1,1
57315,53,60318,53,allow,748,95,653,2,30,1,1
57188,53,2618,53,allow,744,89,655,2,30,1,1
49359,53,18838,53,allow,216,110,106,2,30,1,1
64971,53,64971,53,allow,218,85,133,2,30,1,1
49257,53,2534,53,allow,198,101,97,2,30,1,1
56433,53,27409,53,allow,170,87,83,2,31,1,1
50418,53,2799,53,allow,760,96,664,2,31,1,1
65387,53,24725,53,allow,272,122,150,2,30,1,1
50253,53,9014,53,allow,756,95,661,2,30,1,1
55377,53,19699,53,allow,1428,103,1325,4,32,2,2
55083,53,35659,53,allow,216,110,106,2,30,1,1
55582,53,45316,53,allow,170,87,83,2,30,1,1
64332,53,24629,53,allow,374,96,278,4,55,2,2
55513,53,5223,53,allow,184,94,90,2,30,1,1
65055,53,55759,53,allow,1426,98,1328,4,55,2,2
57011,53,6103,53,allow,770,101,669,2,30,1,1
49337,53,4969,53,allow,303,97,206,4,56,2,2
57284,53,3184,53,allow,212,108,104,2,31,1,1
65419,53,10153,53,allow,198,101,97,2,31,1,1
49619,53,50189,53,allow,789,110,679,2,30,1,1
57215,53,55858,53,allow,810,108,702,2,30,1,1
56390,53,2004,53,allow,701,88,613,2,30,1,1
64530,53,49179,53,allow,782,105,677,2,30,1,1
49757,80,22692,80,allow,1396,864,532,9,15,5,4
64993,53,50463,53,allow,748,95,653,2,30,1,1
50005,53,45437,53,allow,295,101,194,4,30,2,2
55102,53,40717,53,allow,190,97,93,2,30,1,1
63988,53,39055,53,allow,190,97,93,2,30,1,1
61651,123,29529,123,allow,184,94,90,2,30,1,1
57389,53,59363,53,allow,186,95,91,2,30,1,1
55110,53,57772,53,allow,770,102,668,2,30,1,1
56568,53,49055,53,allow,206,105,101,2,30,1,1
49845,53,18683,53,allow,168,86,82,2,31,1,1
49777,53,49271,53,allow,168,78,90,2,31,1,1
64055,53,63061,53,allow,178,91,87,2,31,1,1
64880,53,46886,53,allow,164,84,80,2,30,1,1
56275,53,15148,53,allow,164,84,80,2,31,1,1
56861,53,42758,53,allow,756,95,661,2,31,1,1
49961,53,46234,53,allow,216,110,106,2,31,1,1
56939,53,50675,53,allow,216,110,106,2,31,1,1
56156,53,34308,53,allow,711,87,624,2,31,1,1
64565,53,49218,53,allow,802,104,698,2,31,1,1
55629,53,44695,53,allow,168,86,82,2,31,1,1
56356,53,2062,53,allow,758,96,662,2,31,1,1
55633,53,26791,53,allow,793,101,692,2,31,1,1
56621,53,7810,53,allow,760,96,664,2,31,1,1
55549,53,31074,53,allow,202,103,99,2,31,1,1
56429,53,7462,53,allow,762,98,664,2,31,1,1
65115,53,30947,53,allow,170,87,83,2,31,1,1
55181,53,51083,53,allow,815,95,720,2,31,1,1
56070,53,55660,53,allow,186,95,91,2,31,1,1
56969,53,8130,53,allow,754,94,660,2,31,1,1
55357,53,12869,53,allow,754,94,660,2,31,1,1
49152,53,51402,53,allow,206,105,101,2,31,1,1
64524,53,34078,53,allow,184,94,90,2,31,1,1
64675,53,55719,53,allow,749,94,655,2,31,1,1
55010,53,38368,53,allow,190,97,93,2,31,1,1
56668,53,31919,53,allow,198,101,97,2,31,1,1
49275,53,59894,53,allow,190,97,93,2,31,1,1
60319,53,31437,53,allow,316,80,236,2,31,1,1
64870,53,47029,53,allow,200,102,98,2,31,1,1
64697,53,42927,53,allow,198,101,97,2,31,1,1
58002,445,0,0,drop,70,70,0,1,0,1,0
58001,445,0,0,drop,70,70,0,1,0,1,0
58274,445,0,0,drop,66,66,0,1,0,1,0
62864,445,0,0,drop,70,70,0,1,0,1,0
57999,445,0,0,drop,70,70,0,1,0,1,0
58272,445,0,0,drop,66,66,0,1,0,1,0
58263,445,0,0,drop,66,66,0,1,0,1,0
42216,53,45740,53,allow,199,94,105,2,30,1,1
56484,53,39719,53,allow,214,110,104,2,30,1,1
51940,53,28110,53,allow,199,94,105,2,30,1,1
61078,123,41282,123,allow,184,94,90,2,30,1,1
55382,53,35558,53,allow,199,102,97,2,30,1,1
56577,53,47746,53,allow,198,110,88,2,30,1,1
55809,443,47324,443,allow,62,62,0,1,4,1,0
65200,53,41473,53,allow,214,110,104,2,29,1,1
49954,53,53212,53,allow,216,110,106,2,29,1,1
65386,53,46279,53,allow,168,86,82,2,29,1,1
55115,53,50368,53,allow,313,110,203,4,35,2,2
56374,53,20604,53,allow,177,94,83,2,29,1,1
65059,53,56951,53,allow,197,94,103,2,29,1,1
55102,53,13108,53,allow,195,102,93,2,29,1,1
65496,53,16227,53,allow,194,102,92,2,29,1,1
55466,53,26661,53,allow,177,94,83,2,29,1,1
65386,53,22726,53,allow,184,102,82,2,29,1,1
56374,53,12810,53,allow,177,94,83,2,29,1,1
49315,53,15991,53,allow,94,94,0,1,30,1,0
64880,53,31529,53,allow,166,86,80,2,30,1,1
56464,53,12026,53,allow,177,94,83,2,30,1,1
55608,53,12316,53,allow,195,102,93,2,30,1,1
63879,80,50871,80,allow,314,192,122,6,15,4,2
64790,53,64538,53,allow,779,86,693,2,30,1,1
55292,53,15138,53,allow,274,94,180,2,30,1,1
65419,53,45268,53,allow,199,102,97,2,30,1,1
56433,53,26629,53,allow,177,94,83,2,30,1,1
55115,53,46461,53,allow,313,110,203,4,35,2,2
55502,53,25311,53,allow,193,102,91,2,30,1,1
40600,53,40600,53,allow,228,90,138,2,30,1,1
49856,53,57011,53,allow,168,78,90,2,30,1,1
55516,123,34894,123,allow,184,94,90,2,30,1,1
50005,53,14000,53,allow,199,102,97,2,30,1,1
56701,53,54684,53,allow,211,110,101,2,30,1,1
56433,53,3210,53,allow,177,94,83,2,30,1,1
48164,53,51985,53,allow,199,94,105,2,30,1,1
49936,53,12720,53,allow,754,94,660,2,30,1,1
65040,53,33364,53,allow,178,94,84,2,30,1,1
49226,53,53578,53,allow,765,102,663,2,30,1,1
51522,443,43510,443,allow,190,70,120,4,15,2,2
55504,53,20782,53,allow,199,94,105,2,30,1,1
64983,53,5979,53,allow,181,94,87,2,30,1,1
55614,53,42097,53,allow,309,110,199,2,30,1,1
65067,53,28760,53,allow,86,86,0,1,30,1,0
54224,53,18536,53,allow,199,94,105,2,30,1,1
55453,53,1077,53,allow,730,102,628,2,30,1,1
65139,53,54576,53,allow,443,182,261,6,30,3,3
58980,123,62249,123,allow,184,94,90,2,30,1,1
55083,53,1182,53,allow,216,110,106,2,30,1,1
55582,53,5858,53,allow,177,94,83,2,30,1,1
49472,53,31228,53,allow,772,102,670,2,30,1,1
65056,53,13429,53,allow,168,94,74,2,30,1,1
65056,53,16740,53,allow,168,94,74,2,30,1,1
57284,53,19677,53,allow,214,110,104,2,30,1,1
63962,53,21344,53,allow,185,93,92,3,58,2,1
55981,80,6270,80,allow,130,70,60,2,15,1,1
49174,53,31879,53,allow,199,102,97,2,33,1,1
60951,53,52563,53,allow,164,78,86,2,29,1,1
60287,53,28366,53,allow,168,78,90,2,29,1,1
56520,53,9113,53,allow,177,94,83,2,29,1,1
56577,53,39696,53,allow,182,94,88,2,30,1,1
50022,53,4784,53,allow,198,110,88,2,29,1,1
55503,53,6618,53,allow,216,110,106,2,29,1,1
50962,53,0,0,allow,229,85,144,2,29,1,1
50375,53,45862,53,allow,211,110,101,2,30,1,1
55513,53,13816,53,allow,184,94,90,2,30,1,1
56464,53,56163,53,allow,177,94,83,2,30,1,1
55382,53,48828,53,allow,199,102,97,2,30,1,1
64983,53,54706,53,allow,181,94,87,2,30,1,1
56583,53,33992,53,allow,177,94,83,2,29,1,1
50510,53,6283,53,allow,734,94,640,2,30,1,1
55582,53,57520,53,allow,177,94,83,2,30,1,1
65486,53,53853,53,allow,193,102,91,2,30,1,1
55102,53,6205,53,allow,195,102,93,2,30,1,1
50005,53,15477,53,allow,199,102,97,2,30,1,1
56469,53,24320,53,allow,177,94,83,2,30,1,1
57284,53,51341,53,allow,214,110,104,2,30,1,1
56701,53,21171,53,allow,211,110,101,2,30,1,1
50005,53,1672,53,allow,199,102,97,2,30,1,1
56523,53,49008,53,allow,184,102,82,2,30,1,1
49659,53,53164,53,allow,730,102,628,2,30,1,1
56568,53,16992,53,allow,211,110,101,2,30,1,1
58282,53,59362,53,allow,215,102,113,2,30,1,1
49713,53,20450,53,allow,821,102,719,2,30,1,1
50584,53,19282,53,allow,738,86,652,2,30,1,1
55778,53,54108,53,allow,181,94,87,2,30,1,1
56984,53,44033,53,allow,209,102,107,2,30,1,1
43604,53,41746,53,allow,168,78,90,2,30,1,1
39461,53,45858,53,allow,168,78,90,2,30,1,1
56275,53,46209,53,allow,166,86,80,2,30,1,1
55010,53,9213,53,allow,195,102,93,2,31,1,1
49161,53,58186,53,allow,168,86,82,2,30,1,1
43298,53,31678,53,allow,199,94,105,2,30,1,1
56803,53,10846,53,allow,195,102,93,2,30,1,1
56993,53,49057,53,allow,168,86,82,2,30,1,1
65348,53,57406,53,allow,214,102,112,2,31,1,1
56137,53,23667,53,allow,199,102,97,2,31,1,1
57180,53,28550,53,allow,305,86,219,2,31,1,1
65147,53,63811,53,allow,194,102,92,2,31,1,1
56523,53,57340,53,allow,168,86,82,2,30,1,1
56023,53,18673,53,allow,195,102,93,2,30,1,1
43563,53,1876,53,allow,164,78,86,2,30,1,1
56596,53,43071,53,allow,194,102,92,2,30,1,1
51443,443,36286,443,allow,70,70,0,1,5,1,0
55083,53,24986,53,allow,325,110,215,4,44,2,2
56484,53,12661,53,allow,214,110,104,2,30,1,1
65486,53,8619,53,allow,193,102,91,2,30,1,1
56939,53,27310,53,allow,216,110,106,2,30,1,1
50368,53,63672,53,allow,763,102,661,2,30,1,1
56464,53,58795,53,allow,177,94,83,2,30,1,1
56568,53,45144,53,allow,211,110,101,2,30,1,1
55083,53,56476,53,allow,216,110,106,2,30,1,1
49161,53,58630,53,allow,184,102,82,2,30,1,1
50040,53,5250,53,allow,193,102,91,2,30,1,1
49713,53,3397,53,allow,198,102,96,2,30,1,1
55413,53,7034,53,allow,779,86,693,2,30,1,1
55199,53,62068,53,allow,152,78,74,2,30,1,1
53530,53,6923,53,allow,164,78,86,2,30,1,1
48604,53,57366,53,allow,164,78,86,2,30,1,1
49125,53,10970,53,allow,168,78,90,2,30,1,1
45607,53,29195,53,allow,168,78,90,2,30,1,1
56433,53,56287,53,allow,177,94,83,2,30,1,1
55102,53,47869,53,allow,195,102,93,2,30,1,1
56070,53,23575,53,allow,193,102,91,2,30,1,1
65499,53,27912,53,allow,182,102,80,2,30,1,1
50237,53,53638,53,allow,183,94,89,2,31,1,1
56758,53,35324,53,allow,173,94,79,2,31,1,1
51847,53,49805,53,allow,164,78,86,2,31,1,1
49411,53,17691,53,allow,195,102,93,2,31,1,1
57284,53,21102,53,allow,214,110,104,2,31,1,1
49152,53,17272,53,allow,307,105,202,4,31,2,2
56137,53,37448,53,allow,199,102,97,2,30,1,1
65180,53,26372,53,allow,165,86,79,2,30,1,1
50622,53,57483,53,allow,185,102,83,2,30,1,1
55549,53,9583,53,allow,209,110,99,2,30,1,1
65115,53,30107,53,allow,253,87,166,4,31,2,2
49845,53,35831,53,allow,168,86,82,2,30,1,1
49152,53,49230,53,allow,211,110,101,2,31,1,1
64885,53,51711,53,allow,212,102,110,2,31,1,1
56512,53,52518,53,allow,889,404,485,10,31,5,5
57043,53,20251,53,allow,166,86,80,2,31,1,1
64885,53,54457,53,allow,182,102,80,2,31,1,1
56015,53,12325,53,allow,195,102,93,2,31,1,1
50622,53,8191,53,allow,177,94,83,2,31,1,1
56982,53,27888,53,allow,177,94,83,2,31,1,1
56803,53,20372,53,allow,195,102,93,2,31,1,1
37576,53,58836,53,allow,168,78,90,2,30,1,1
55000,53,36007,53,allow,193,102,91,2,31,1,1
64586,53,19634,53,allow,252,94,158,2,31,1,1
65350,53,14923,53,allow,212,102,110,2,31,1,1
56939,53,59190,53,allow,216,110,106,2,31,1,1
49275,53,35482,53,allow,195,102,93,2,31,1,1
55851,53,26107,53,allow,167,86,81,2,31,1,1
65218,53,5567,53,allow,194,102,92,2,31,1,1
55133,53,17544,53,allow,443,182,261,6,31,3,3
57389,53,16174,53,allow,193,102,91,2,31,1,1
64276,53,55136,53,allow,197,102,95,2,31,1,1
49961,53,61953,53,allow,322,110,212,4,31,2,2
65419,53,4348,53,allow,295,101,194,4,31,2,2
55673,53,34311,53,allow,179,94,85,2,31,1,1
64751,53,23466,53,allow,458,188,270,6,31,3,3
49272,53,48276,53,allow,168,86,82,2,33,1,1
58259,445,0,0,drop,66,66,0,1,0,1,0
57990,445,0,0,drop,70,70,0,1,0,1,0
60239,23,0,0,deny,60,60,0,1,0,1,0
57988,445,0,0,drop,70,70,0,1,0,1,0
57987,445,0,0,drop,70,70,0,1,0,1,0
57986,445,0,0,drop,70,70,0,1,0,1,0
57985,445,0,0,drop,70,70,0,1,0,1,0
57982,445,0,0,drop,70,70,0,1,0,1,0
57981,445,0,0,drop,70,70,0,1,0,1,0
62857,445,0,0,drop,70,70,0,1,0,1,0
58247,445,0,0,drop,66,66,0,1,0,1,0
58246,445,0,0,drop,66,66,0,1,0,1,0
58249,445,0,0,drop,66,66,0,1,0,1,0
58248,445,0,0,drop,66,66,0,1,0,1,0
58244,445,0,0,drop,66,66,0,1,0,1,0
58242,445,0,0,drop,66,66,0,1,0,1,0
58245,445,0,0,drop,66,66,0,1,0,1,0
58241,445,0,0,drop,66,66,0,1,0,1,0
57967,445,0,0,drop,70,70,0,1,0,1,0
57966,445,0,0,drop,70,70,0,1,0,1,0
57964,445,0,0,drop,70,70,0,1,0,1,0
57957,445,0,0,drop,70,70,0,1,0,1,0
57956,445,0,0,drop,70,70,0,1,0,1,0
62846,445,0,0,drop,70,70,0,1,0,1,0
62840,445,0,0,drop,70,70,0,1,0,1,0
62835,445,0,0,drop,70,70,0,1,0,1,0
58229,445,0,0,drop,66,66,0,1,0,1,0
58228,445,0,0,drop,66,66,0,1,0,1,0
58227,445,0,0,drop,66,66,0,1,0,1,0
57945,445,0,0,drop,70,70,0,1,0,1,0
62832,445,0,0,drop,70,70,0,1,0,1,0
62831,445,0,0,drop,70,70,0,1,0,1,0
62825,445,0,0,drop,70,70,0,1,0,1,0
62821,445,0,0,drop,70,70,0,1,0,1,0
57940,445,0,0,drop,70,70,0,1,0,1,0
57930,445,0,0,drop,70,70,0,1,0,1,0
57931,445,0,0,drop,70,70,0,1,0,1,0
57929,445,0,0,drop,70,70,0,1,0,1,0
57927,445,0,0,drop,70,70,0,1,0,1,0
57925,445,0,0,drop,70,70,0,1,0,1,0
62810,445,0,0,drop,70,70,0,1,0,1,0
58206,445,0,0,drop,66,66,0,1,0,1,0
57918,445,0,0,drop,70,70,0,1,0,1,0
62804,445,0,0,drop,70,70,0,1,0,1,0
57911,445,0,0,drop,70,70,0,1,0,1,0
57909,445,0,0,drop,70,70,0,1,0,1,0
58201,445,0,0,drop,66,66,0,1,0,1,0
58199,445,0,0,drop,66,66,0,1,0,1,0
64740,53,21372,53,allow,204,96,108,2,0,1,1
57905,445,0,0,drop,70,70,0,1,0,1,0
62796,445,0,0,drop,70,70,0,1,0,1,0
57903,445,0,0,drop,70,70,0,1,0,1,0
62783,445,0,0,drop,70,70,0,1,0,1,0
62789,445,0,0,drop,70,70,0,1,0,1,0
62785,445,0,0,drop,70,70,0,1,0,1,0
58193,445,0,0,drop,66,66,0,1,0,1,0
57899,445,0,0,deny,70,70,0,1,0,1,0
58185,445,0,0,drop,66,66,0,1,0,1,0
58182,445,0,0,drop,66,66,0,1,0,1,0
58190,445,0,0,drop,66,66,0,1,0,1,0
58181,445,0,0,drop,66,66,0,1,0,1,0
58180,445,0,0,drop,66,66,0,1,0,1,0
58183,445,0,0,drop,66,66,0,1,0,1,0
62779,445,0,0,drop,70,70,0,1,0,1,0
57898,445,0,0,drop,70,70,0,1,0,1,0
62775,445,0,0,drop,70,70,0,1,0,1,0
62776,445,0,0,drop,70,70,0,1,0,1,0
62774,445,0,0,drop,70,70,0,1,0,1,0
57893,445,0,0,drop,70,70,0,1,0,1,0
40099,23,0,0,deny,60,60,0,1,0,1,0
62767,445,0,0,drop,70,70,0,1,0,1,0
62766,445,0,0,drop,70,70,0,1,0,1,0
58174,445,0,0,drop,66,66,0,1,0,1,0
62764,445,0,0,drop,70,70,0,1,0,1,0
58170,445,0,0,drop,66,66,0,1,0,1,0
58168,445,0,0,drop,66,66,0,1,0,1,0
58166,445,0,0,drop,66,66,0,1,0,1,0
58165,445,0,0,drop,66,66,0,1,0,1,0
57880,445,0,0,drop,70,70,0,1,0,1,0
55745,53,2082,53,allow,198,101,97,2,30,1,1
56137,53,13627,53,allow,198,101,97,2,30,1,1
57320,53,17715,53,allow,802,104,698,2,30,1,1
56803,53,60073,53,allow,190,97,93,2,30,1,1
45973,80,60960,80,allow,1114,534,580,12,16,7,5
56601,53,12996,53,allow,170,87,83,2,30,1,1
65357,53,31464,53,allow,256,93,163,2,30,1,1
38598,80,50146,80,allow,1114,534,580,12,16,7,5
49708,53,19029,53,allow,186,95,91,2,31,1,1
65340,53,24167,53,allow,313,110,203,4,34,2,2
55011,443,43208,443,allow,134,60,74,3,10,2,1
56015,53,32700,53,allow,190,97,93,2,31,1,1
56754,53,1275,53,allow,751,95,656,2,30,1,1
64617,53,32317,53,allow,756,95,661,2,30,1,1
55747,53,60258,53,allow,186,95,91,2,30,1,1
50130,53,57806,53,allow,174,89,85,2,30,1,1
55678,53,40642,53,allow,270,88,182,4,54,2,2
37483,443,13150,443,allow,70,70,0,2,5,2,0
51102,80,48661,80,allow,254,128,126,5,16,3,2
49973,53,28904,53,allow,747,93,654,2,30,1,1
65028,53,48786,53,allow,182,93,89,2,31,1,1
60261,53,9176,53,allow,233,81,152,2,31,1,1
56754,53,54310,53,allow,182,93,89,2,31,1,1
57030,53,10715,53,allow,749,94,655,2,30,1,1
57043,53,11137,53,allow,164,84,80,2,31,1,1
52744,53,32462,53,allow,218,81,137,2,31,1,1
60205,53,4372,53,allow,491,115,376,2,31,1,1
64155,53,47794,53,allow,182,93,89,2,31,1,1
57432,53,52576,53,allow,186,95,91,2,31,1,1
55057,53,28590,53,allow,188,80,108,2,31,1,1
49411,53,5629,53,allow,764,99,665,2,31,1,1
49411,53,16636,53,allow,190,97,93,2,31,1,1
64502,53,19448,53,allow,198,101,97,2,31,1,1
56316,53,62474,53,allow,733,93,640,2,31,1,1
57403,53,33479,53,allow,764,99,665,2,31,1,1
49901,53,43057,53,allow,752,93,659,2,31,1,1
55165,53,33843,53,allow,186,95,91,2,31,1,1
55146,53,27596,53,allow,178,91,87,2,31,1,1
55989,53,34510,53,allow,301,80,221,2,31,1,1
55865,53,59187,53,allow,192,98,94,2,31,1,1
56754,53,26868,53,allow,182,93,89,2,31,1,1
56489,53,9715,53,allow,172,88,84,2,31,1,1
63951,53,13752,53,allow,186,95,91,2,31,1,1
55673,53,33131,53,allow,174,89,85,2,31,1,1
55365,53,41996,53,allow,184,94,90,2,31,1,1
55379,53,30186,53,allow,256,93,163,2,31,1,1
56304,53,54200,53,allow,184,94,90,2,31,1,1
64275,53,47758,53,allow,192,90,102,2,31,1,1
64276,53,40042,53,allow,194,99,95,2,31,1,1
54992,53,12659,53,allow,190,97,93,2,31,1,1
62758,445,0,0,drop,70,70,0,1,0,1,0
57877,445,0,0,drop,70,70,0,1,0,1,0
49611,53,44426,53,allow,184,94,90,2,30,1,1
57239,53,5025,53,allow,193,102,91,2,30,1,1
64155,53,2380,53,allow,183,94,89,2,30,1,1
49554,80,58941,80,allow,1515,481,1034,11,15,6,5
56914,53,24598,53,allow,821,102,719,2,30,1,1
49738,53,2728,53,allow,215,102,113,2,30,1,1
56070,53,12726,53,allow,193,102,91,2,30,1,1
55934,53,23725,53,allow,182,102,80,2,30,1,1
49502,53,5291,53,allow,193,102,91,2,30,1,1
49713,53,16907,53,allow,184,94,90,2,30,1,1
65250,53,37683,53,allow,353,98,255,4,32,2,2
56568,53,6901,53,allow,365,105,260,4,47,2,2
49275,53,55214,53,allow,283,97,186,4,30,2,2
58495,443,34760,443,allow,1638,829,809,18,43,10,8
49788,53,17656,53,allow,198,102,96,2,32,1,1
56638,80,7412,80,allow,234,234,0,4,11,4,0
59277,53,14948,53,allow,164,78,86,2,29,1,1
47636,53,0,0,allow,86,86,0,1,29,1,0
56070,53,26270,53,allow,193,102,91,2,30,1,1
55657,53,52636,53,allow,822,102,720,2,30,1,1
56993,53,24692,53,allow,184,102,82,2,29,1,1
64055,53,52345,53,allow,181,94,87,2,29,1,1
55549,53,24179,53,allow,209,110,99,2,29,1,1
53552,53,3574,53,allow,168,78,90,2,29,1,1
55000,53,31472,53,allow,193,102,91,2,29,1,1
56982,53,54411,53,allow,177,94,83,2,29,1,1
65040,53,11010,53,allow,178,94,84,2,29,1,1
55199,53,24591,53,allow,152,78,74,2,29,1,1
64903,53,4073,53,allow,210,110,100,2,30,1,1
64415,53,15855,53,allow,221,94,127,2,30,1,1
50130,53,36317,53,allow,179,94,85,2,30,1,1
55629,53,22449,53,allow,168,86,82,2,30,1,1
49567,53,35834,53,allow,168,86,82,2,30,1,1
64583,53,34573,53,allow,179,94,85,2,30,1,1
55549,53,20623,53,allow,209,110,99,2,30,1,1
56304,53,19681,53,allow,184,94,90,2,30,1,1
49724,53,16397,53,allow,183,94,89,2,30,1,1
64870,53,42981,53,allow,200,102,98,2,33,1,1
54963,53,11032,53,allow,210,110,100,2,30,1,1
36677,443,38465,443,allow,712,374,338,11,26,6,5
50534,80,11143,80,allow,318,192,126,6,25,4,2
50463,80,63271,80,allow,214,140,74,4,15,3,1
49713,53,39823,53,allow,184,94,90,2,30,1,1
50549,80,64687,80,allow,378,192,186,7,21,4,3
50548,80,23213,80,allow,378,192,186,7,21,4,3
56560,53,11515,53,allow,198,102,96,2,31,1,1
64859,53,38916,53,allow,385,134,251,2,30,1,1
54936,80,14845,80,allow,613,539,74,7,15,6,1
55934,53,17194,53,allow,182,102,80,2,30,1,1
65395,53,34335,53,allow,754,94,660,2,30,1,1
64903,53,57537,53,allow,210,110,100,2,30,1,1
49451,53,64804,53,allow,211,102,109,2,30,1,1
63982,53,27288,53,allow,244,94,150,2,30,1,1
64903,53,16364,53,allow,210,110,100,2,30,1,1
64870,53,51566,53,allow,200,102,98,2,30,1,1
64718,53,52565,53,allow,781,94,687,2,30,1,1
57043,53,58233,53,allow,166,86,80,2,30,1,1
63951,53,11656,53,allow,193,102,91,2,30,1,1
64697,53,13382,53,allow,199,102,97,2,30,1,1
55678,53,49821,53,allow,270,88,182,4,54,2,2
56015,53,29304,53,allow,195,102,93,2,30,1,1
52145,443,2383,443,allow,190,70,120,4,15,2,2
65340,53,54833,53,allow,313,110,203,4,33,2,2
50547,80,14282,80,allow,378,192,186,7,21,4,3
56758,53,14411,53,allow,165,86,79,2,30,1,1
56601,53,17234,53,allow,177,94,83,2,30,1,1
64633,53,57902,53,allow,231,110,121,2,30,1,1
56779,53,27714,53,allow,165,86,79,2,30,1,1
49502,53,58398,53,allow,193,102,91,2,30,1,1
56601,53,46710,53,allow,177,94,83,2,30,1,1
49891,53,31414,53,allow,243,94,149,2,30,1,1
64664,53,7997,53,allow,168,86,82,2,32,1,1
57335,53,58927,53,allow,177,94,83,2,30,1,1
57335,53,28128,53,allow,185,102,83,2,30,1,1
37479,53,37479,53,allow,214,82,132,2,30,1,1
55745,53,20797,53,allow,199,102,97,2,30,1,1
59454,53,0,0,allow,86,86,0,1,30,1,0
54963,53,23635,53,allow,210,110,100,2,30,1,1
55678,53,55305,53,allow,270,88,182,4,54,2,2
56115,53,38646,53,allow,278,96,182,4,54,2,2
49295,53,60133,53,allow,194,102,92,2,32,1,1
50700,80,4259,80,allow,417,417,0,4,9,4,0
43146,80,15239,80,allow,1102,545,557,10,16,6,4
45472,443,53386,443,allow,1568,759,809,17,43,9,8
45470,443,49980,443,allow,1636,827,809,18,43,10,8
59956,443,50575,443,allow,2162,1113,1049,18,16,10,8
49127,53,16761,53,allow,199,94,105,2,29,1,1
65499,53,38166,53,allow,166,86,80,2,29,1,1
64533,53,56786,53,allow,183,102,81,2,29,1,1
65147,53,20335,53,allow,194,102,92,2,29,1,1
55678,53,29354,53,allow,270,88,182,4,53,2,2
64533,53,56074,53,allow,183,102,81,2,29,1,1
55513,53,52238,53,allow,184,94,90,2,29,1,1
55010,53,42242,53,allow,195,102,93,2,29,1,1
47766,53,58844,53,allow,164,78,86,2,29,1,1
64885,53,4392,53,allow,166,86,80,2,29,1,1
65398,53,64087,53,allow,811,94,717,2,29,1,1
55778,53,21245,53,allow,189,102,87,2,29,1,1
65180,53,3585,53,allow,165,86,79,2,29,1,1
56866,53,6471,53,allow,194,102,92,2,30,1,1
64697,53,51206,53,allow,199,102,97,2,30,1,1
49708,53,46475,53,allow,193,102,91,2,30,1,1
65058,53,6038,53,allow,249,94,155,2,30,1,1
49933,53,6937,53,allow,178,94,84,2,31,1,1
55570,53,44028,53,allow,168,86,82,2,31,1,1
57239,53,64762,53,allow,193,102,91,2,31,1,1
55146,53,42848,53,allow,181,94,87,2,30,1,1
56668,53,7163,53,allow,199,102,97,2,30,1,1
56668,53,30534,53,allow,199,102,97,2,30,1,1
49411,53,20667,53,allow,195,102,93,2,30,1,1
55673,53,41151,53,allow,179,94,85,2,30,1,1
49724,53,47705,53,allow,183,94,89,2,30,1,1
65340,53,38317,53,allow,313,110,203,4,33,2,2
64614,53,45879,53,allow,616,188,428,6,35,3,3
58497,443,60144,443,allow,1640,831,809,18,43,10,8
50587,80,51672,80,allow,378,192,186,7,20,4,3
56668,53,43075,53,allow,199,102,97,2,30,1,1
49564,53,57263,53,allow,168,78,90,2,30,1,1
55851,53,30574,53,allow,183,102,81,2,30,1,1
49436,53,51466,53,allow,765,102,663,2,30,1,1
56866,53,52471,53,allow,194,102,92,2,30,1,1
50015,53,0,0,allow,234,86,148,2,30,1,1
49708,53,49250,53,allow,193,102,91,2,30,1,1
65315,53,23256,53,allow,178,94,84,2,30,1,1
49708,53,50223,53,allow,193,102,91,2,30,1,1
49724,53,13142,53,allow,183,94,89,2,30,1,1
54631,443,8589,443,allow,130,70,60,3,5,2,1
60474,53,36065,53,allow,195,94,101,2,30,1,1
56779,53,5601,53,allow,173,94,79,2,30,1,1
55745,53,56029,53,allow,199,102,97,2,30,1,1
50237,53,33615,53,allow,183,94,89,2,30,1,1
64697,53,40381,53,allow,199,102,97,2,30,1,1
55146,53,47251,53,allow,181,94,87,2,30,1,1
55786,53,7570,53,allow,193,102,91,2,30,1,1
54963,53,30866,53,allow,210,110,100,2,30,1,1
49431,53,23067,53,allow,353,94,259,2,30,1,1
64155,53,25938,53,allow,183,94,89,2,30,1,1
37469,53,51680,53,allow,168,78,90,2,30,1,1
56304,53,49255,53,allow,184,94,90,2,30,1,1
48954,53,0,0,allow,86,86,0,1,30,1,0
60591,53,16493,53,allow,218,78,140,2,31,1,1
56601,53,1857,53,allow,177,94,83,2,31,1,1
49411,53,10560,53,allow,195,102,93,2,31,1,1
57043,53,5336,53,allow,166,86,80,2,31,1,1
56542,53,15813,53,allow,183,94,89,2,30,1,1
65028,53,59262,53,allow,183,94,89,2,31,1,1
49398,53,12765,53,allow,226,86,140,2,31,1,1
57432,53,10564,53,allow,193,102,91,2,31,1,1
49456,53,42586,53,allow,199,102,97,2,31,1,1
55673,53,34197,53,allow,179,94,85,2,31,1,1
55365,53,47603,53,allow,184,94,90,2,31,1,1
49952,53,65134,53,allow,195,102,93,2,31,1,1
56587,53,8172,53,allow,184,94,90,2,31,1,1
55748,53,53147,53,allow,194,102,92,2,31,1,1
54990,53,13608,53,allow,168,86,82,2,31,1,1
64302,53,55170,53,allow,258,94,164,2,31,1,1
58877,53,28014,53,allow,426,118,308,2,31,1,1
64884,53,27376,53,allow,195,102,93,2,31,1,1
56542,53,32612,53,allow,183,94,89,2,31,1,1
49532,53,59388,53,allow,331,92,239,4,40,2,2
49392,53,35647,53,allow,398,93,305,4,45,2,2
56719,80,46763,80,allow,1462,703,759,8,16,5,3
58154,445,0,0,drop,66,66,0,1,0,1,0
57873,445,0,0,drop,70,70,0,1,0,1,0
44923,23,0,0,deny,60,60,0,1,0,1,0
57871,445,0,0,drop,70,70,0,1,0,1,0
57869,445,0,0,drop,70,70,0,1,0,1,0
58146,445,0,0,drop,66,66,0,1,0,1,0
62736,445,0,0,drop,70,70,0,1,0,1,0
58143,445,0,0,drop,66,66,0,1,0,1,0
57862,445,0,0,drop,70,70,0,1,0,1,0
58135,445,0,0,drop,66,66,0,1,0,1,0
57860,445,0,0,drop,70,70,0,1,0,1,0
58127,445,0,0,drop,66,66,0,1,0,1,0
57859,445,0,0,drop,70,70,0,1,0,1,0
57858,445,0,0,drop,70,70,0,1,0,1,0
57857,445,0,0,drop,70,70,0,1,0,1,0
57855,445,0,0,drop,70,70,0,1,0,1,0
57851,445,0,0,drop,70,70,0,1,0,1,0
62728,445,0,0,drop,70,70,0,1,0,1,0
62724,445,0,0,drop,70,70,0,1,0,1,0
58121,445,0,0,drop,66,66,0,1,0,1,0
58120,445,0,0,drop,66,66,0,1,0,1,0
58117,445,0,0,drop,66,66,0,1,0,1,0
58116,445,0,0,drop,66,66,0,1,0,1,0
58118,445,0,0,drop,66,66,0,1,0,1,0
58119,445,0,0,drop,66,66,0,1,0,1,0
58114,445,0,0,drop,66,66,0,1,0,1,0
58113,445,0,0,drop,66,66,0,1,0,1,0
57839,445,0,0,drop,70,70,0,1,0,1,0
57838,445,0,0,drop,70,70,0,1,0,1,0
57834,445,0,0,drop,70,70,0,1,0,1,0
57829,445,0,0,drop,70,70,0,1,0,1,0
57828,445,0,0,drop,70,70,0,1,0,1,0
65494,53,0,0,deny,88,88,0,1,0,1,0
62721,445,0,0,drop,70,70,0,1,0,1,0
62714,445,0,0,drop,70,70,0,1,0,1,0
62709,445,0,0,drop,70,70,0,1,0,1,0
62707,445,0,0,drop,70,70,0,1,0,1,0
57817,445,0,0,drop,70,70,0,1,0,1,0
58101,445,0,0,drop,66,66,0,1,0,1,0
58099,445,0,0,drop,66,66,0,1,0,1,0
58098,445,0,0,drop,66,66,0,1,0,1,0
62704,445,0,0,drop,70,70,0,1,0,1,0
62699,445,0,0,drop,70,70,0,1,0,1,0
62693,445,0,0,drop,70,70,0,1,0,1,0
62697,445,0,0,drop,70,70,0,1,0,1,0
57813,445,0,0,drop,70,70,0,1,0,1,0
57802,445,0,0,drop,70,70,0,1,0,1,0
57803,445,0,0,drop,70,70,0,1,0,1,0
57801,445,0,0,drop,70,70,0,1,0,1,0
57798,445,0,0,drop,70,70,0,1,0,1,0
57797,445,0,0,drop,70,70,0,1,0,1,0
62686,445,0,0,drop,70,70,0,1,0,1,0
62685,445,0,0,drop,70,70,0,1,0,1,0
62680,445,0,0,drop,70,70,0,1,0,1,0
57790,445,0,0,drop,70,70,0,1,0,1,0
58079,445,0,0,drop,66,66,0,1,0,1,0
62678,445,0,0,drop,70,70,0,1,0,1,0
57783,445,0,0,drop,70,70,0,1,0,1,0
57781,445,0,0,drop,70,70,0,1,0,1,0
57239,161,0,0,deny,82,82,0,1,0,1,0
57239,161,0,0,deny,85,85,0,1,0,1,0
58072,445,0,0,drop,66,66,0,1,0,1,0
58069,445,0,0,drop,66,66,0,1,0,1,0
57777,445,0,0,drop,70,70,0,1,0,1,0
57775,445,0,0,drop,70,70,0,1,0,1,0
62668,445,0,0,drop,70,70,0,1,0,1,0
62662,445,0,0,drop,70,70,0,1,0,1,0
62655,445,0,0,drop,70,70,0,1,0,1,0
58068,445,0,0,drop,66,66,0,1,0,1,0
57771,445,0,0,drop,70,70,0,1,0,1,0
58059,445,0,0,drop,66,66,0,1,0,1,0
58060,445,0,0,drop,66,66,0,1,0,1,0
58054,445,0,0,drop,66,66,0,1,0,1,0
58058,445,0,0,drop,66,66,0,1,0,1,0
58057,445,0,0,drop,66,66,0,1,0,1,0
58056,445,0,0,drop,66,66,0,1,0,1,0
58053,445,0,0,drop,66,66,0,1,0,1,0
57770,445,0,0,drop,70,70,0,1,0,1,0
62649,445,0,0,drop,70,70,0,1,0,1,0
62648,445,0,0,drop,70,70,0,1,0,1,0
62645,445,0,0,drop,70,70,0,1,0,1,0
57765,445,0,0,drop,70,70,0,1,0,1,0
57296,53,27311,53,allow,771,101,670,2,30,1,1
58917,53,38602,53,allow,192,82,110,2,30,1,1
59905,443,11259,443,allow,343,163,180,6,15,3,3
57239,53,63537,53,allow,186,95,91,2,31,1,1
55447,53,15473,53,allow,1449,108,1341,4,33,2,2
64884,53,2199,53,allow,190,97,93,2,31,1,1
63934,53,45085,53,allow,202,103,99,2,30,1,1
65218,53,11039,53,allow,188,96,92,2,30,1,1
65028,53,18830,53,allow,182,93,89,2,30,1,1
64583,53,25231,53,allow,174,89,85,2,30,1,1
49611,53,14294,53,allow,184,94,90,2,30,1,1
63910,53,63969,53,allow,178,75,103,2,30,1,1
49456,53,39013,53,allow,198,101,97,2,31,1,1
54990,53,8264,53,allow,168,86,82,2,31,1,1
65315,53,47241,53,allow,767,102,665,2,31,1,1
56115,53,48441,53,allow,278,96,182,4,54,2,2
49543,80,13855,80,allow,1548,847,701,10,15,5,5
64989,53,11063,53,allow,578,286,292,9,15,5,4
65382,53,48645,53,allow,301,108,193,4,55,2,2
52010,53,28769,53,allow,218,85,133,2,30,1,1
55929,53,16714,53,allow,760,97,663,2,30,1,1
55742,53,3708,53,allow,780,93,687,2,30,1,1
50938,53,64544,53,allow,209,81,128,2,30,1,1
52501,53,50653,53,allow,201,80,121,2,30,1,1
49952,53,50731,53,allow,190,97,93,2,30,1,1
55395,53,45676,53,allow,767,102,665,2,31,1,1
55748,53,59262,53,allow,188,96,92,2,31,1,1
56587,53,5530,53,allow,184,94,90,2,31,1,1
55605,53,8091,53,allow,190,97,93,2,31,1,1
57912,53,13801,53,allow,295,77,218,2,30,1,1
55294,53,48651,53,allow,295,101,194,4,30,2,2
64811,53,5466,53,allow,190,97,93,2,31,1,1
49999,53,5056,53,allow,178,91,87,2,31,1,1
65496,53,42568,53,allow,96,96,0,1,31,1,0
55451,53,63000,53,allow,751,95,656,2,30,1,1
63950,53,13148,53,allow,200,102,98,2,31,1,1
55619,53,10755,53,allow,182,93,89,2,31,1,1
64707,53,28396,53,allow,757,98,659,2,31,1,1
55950,53,65022,53,allow,752,93,659,2,31,1,1
65209,53,6472,53,allow,164,84,80,2,31,1,1
56813,53,41752,53,allow,753,96,657,2,31,1,1
55310,53,30986,53,allow,176,90,86,2,31,1,1
55076,53,45529,53,allow,182,93,89,2,31,1,1
50516,53,48548,53,allow,772,100,672,2,31,1,1
53259,123,17557,123,allow,184,94,90,2,31,1,1
55354,53,26809,53,allow,212,108,104,2,31,1,1
64428,53,57120,53,allow,190,97,93,2,31,1,1
55531,53,35408,53,allow,772,100,672,2,31,1,1
62643,445,0,0,drop,70,70,0,1,0,1,0
62640,445,0,0,drop,70,70,0,1,0,1,0
54992,53,3265,53,allow,195,102,93,2,30,1,1
64227,53,32450,53,allow,245,94,151,2,30,1,1
55076,53,43465,53,allow,183,94,89,2,30,1,1
49450,53,29878,53,allow,758,102,656,2,30,1,1
56820,53,17754,53,allow,199,94,105,2,30,1,1
54373,53,8646,53,allow,200,86,114,2,30,1,1
57432,53,35465,53,allow,193,102,91,2,29,1,1
54990,53,17689,53,allow,168,86,82,2,29,1,1
56137,53,49352,53,allow,199,102,97,2,29,1,1
49456,53,3975,53,allow,199,102,97,2,30,1,1
56718,80,40668,80,allow,1462,703,759,8,15,5,3
64048,53,63585,53,allow,326,92,234,4,31,2,2
55804,53,21847,53,allow,193,102,91,2,30,1,1
50263,53,23939,53,allow,172,94,78,2,30,1,1
64070,53,45355,53,allow,337,89,248,4,38,2,2
49593,53,57101,53,allow,212,94,118,2,29,1,1
64583,53,3855,53,allow,179,94,85,2,29,1,1
64167,53,3978,53,allow,211,102,109,2,29,1,1
55165,53,51406,53,allow,193,102,91,2,30,1,1
59666,53,55387,53,allow,497,118,379,2,30,1,1
55165,53,23562,53,allow,193,102,91,2,29,1,1
56803,53,49854,53,allow,195,102,93,2,29,1,1
49501,53,7726,53,allow,734,94,640,2,29,1,1
55865,53,59326,53,allow,196,102,94,2,29,1,1
55745,53,9375,53,allow,199,102,97,2,29,1,1
65349,53,5493,53,allow,284,94,190,2,29,1,1
46949,53,11241,53,allow,168,78,90,2,29,1,1
63934,53,38044,53,allow,209,110,99,2,30,1,1
55865,53,56628,53,allow,196,102,94,2,30,1,1
55313,53,12662,53,allow,168,78,90,2,29,1,1
64428,53,56066,53,allow,195,102,93,2,30,1,1
56489,53,32825,53,allow,178,94,84,2,30,1,1
58654,53,55637,53,allow,168,78,90,2,30,1,1
64155,53,12235,53,allow,183,94,89,2,30,1,1
55378,53,28719,53,allow,277,102,175,2,30,1,1
56481,53,28182,53,allow,816,102,714,2,30,1,1
58768,17,58768,17,allow,66,66,0,1,30,1,0
50363,53,11154,53,allow,214,110,104,2,30,1,1
56115,53,55783,53,allow,278,96,182,4,54,2,2
37009,53,17382,53,allow,78,78,0,1,30,1,0
56948,53,61880,53,allow,183,94,89,2,30,1,1
58395,53,61283,53,allow,307,86,221,2,30,1,1
55473,53,5965,53,allow,186,102,84,2,30,1,1
55605,53,27341,53,allow,195,102,93,2,30,1,1
56948,53,22387,53,allow,183,94,89,2,30,1,1
64739,53,37126,53,allow,193,102,91,2,30,1,1
42348,53,29230,53,allow,199,94,105,2,30,1,1
56489,53,51415,53,allow,178,94,84,2,30,1,1
54302,53,4566,53,allow,168,78,90,2,30,1,1
56304,53,20690,53,allow,184,94,90,2,30,1,1
65004,53,7635,53,allow,261,102,159,2,30,1,1
55804,53,9951,53,allow,816,102,714,2,30,1,1
56046,53,6511,53,allow,193,102,91,2,31,1,1
57418,53,56760,53,allow,209,102,107,2,30,1,1
47918,123,27276,123,allow,184,94,90,2,30,1,1
55748,53,60711,53,allow,194,102,92,2,30,1,1
38118,443,46227,443,allow,70,70,0,1,5,1,0
55906,53,30212,53,allow,264,110,154,2,30,1,1
55473,53,63957,53,allow,186,102,84,2,30,1,1
49999,53,61068,53,allow,181,94,87,2,30,1,1
42224,123,27890,123,allow,184,94,90,2,30,1,1
55294,53,35326,53,allow,199,102,97,2,30,1,1
65218,53,38514,53,allow,194,102,92,2,31,1,1
65382,53,33350,53,allow,301,108,193,4,55,2,2
49967,53,25418,53,allow,193,102,91,2,31,1,1
65340,53,2059,53,allow,313,110,203,4,32,2,2
64583,53,5543,53,allow,426,89,337,4,58,2,2
55786,53,25615,53,allow,816,102,714,2,29,1,1
55448,53,23931,53,allow,184,94,90,2,29,1,1
54635,53,0,0,allow,197,86,111,2,29,1,1
55570,53,24983,53,allow,168,86,82,2,29,1,1
65382,53,24981,53,allow,301,108,193,4,54,2,2
55010,53,35689,53,allow,195,102,93,2,29,1,1
64043,53,22374,53,allow,320,94,226,2,29,1,1
49567,53,36957,53,allow,184,102,82,2,29,1,1
55365,53,10129,53,allow,184,94,90,2,29,1,1
64352,53,14227,53,allow,213,102,111,2,29,1,1
63934,53,32673,53,allow,209,110,99,2,29,1,1
49212,53,34127,53,allow,1188,94,1094,2,29,1,1
49611,53,47629,53,allow,184,94,90,2,29,1,1
64255,53,54651,53,allow,211,102,109,2,30,1,1
55448,53,34800,53,allow,184,94,90,2,29,1,1
49952,53,48831,53,allow,195,102,93,2,30,1,1
56542,53,53986,53,allow,183,94,89,2,29,1,1
56739,53,42182,53,allow,195,102,93,2,30,1,1
56015,53,39973,53,allow,195,102,93,2,30,1,1
56739,53,65216,53,allow,195,102,93,2,30,1,1
64502,53,56214,53,allow,199,102,97,2,30,1,1
54560,53,54560,53,allow,832,106,726,2,30,1,1
55556,53,12940,53,allow,302,78,224,2,30,1,1
64739,53,1998,53,allow,816,102,714,2,30,1,1
49742,53,40944,53,allow,790,110,680,2,30,1,1
56434,53,28860,53,allow,316,94,222,2,30,1,1
50363,53,62670,53,allow,214,110,104,2,30,1,1
55294,53,55276,53,allow,199,102,97,2,30,1,1
49518,53,16482,53,allow,193,102,91,2,30,1,1
51966,443,48480,443,allow,130,70,60,2,15,1,1
47971,443,15056,443,allow,130,70,60,2,15,1,1
63934,53,27798,53,allow,347,103,244,4,46,2,2
56115,53,39416,53,allow,278,96,182,4,53,2,2
64502,53,21170,53,allow,199,102,97,2,30,1,1
49243,53,10757,53,allow,452,118,334,2,30,1,1
55365,53,26447,53,allow,184,94,90,2,30,1,1
64854,53,19682,53,allow,178,94,84,2,31,1,1
65343,53,2539,53,allow,184,94,90,2,31,1,1
56288,53,3353,53,allow,200,102,98,2,30,1,1
56385,53,62602,53,allow,402,142,260,2,30,1,1
56365,80,15105,80,allow,1636,699,937,10,15,5,5
49933,53,13874,53,allow,186,102,84,2,30,1,1
54992,53,62120,53,allow,195,102,93,2,30,1,1
63950,53,31406,53,allow,200,102,98,2,30,1,1
57378,53,5726,53,allow,350,94,256,2,30,1,1
49611,53,14406,53,allow,184,94,90,2,30,1,1
56046,53,40264,53,allow,193,102,91,2,30,1,1
64502,53,7896,53,allow,374,101,273,4,42,2,2
49791,53,47745,53,allow,226,94,132,2,30,1,1
40755,123,40939,123,allow,184,94,90,2,30,1,1
36307,53,54070,53,allow,200,86,114,2,30,1,1
55505,53,30588,53,allow,199,102,97,2,31,1,1
54990,53,35409,53,allow,168,86,82,2,31,1,1
56369,53,3077,53,allow,193,102,91,2,31,1,1
57528,53,37207,53,allow,585,192,393,6,54,3,3
57382,53,15348,53,allow,969,86,883,2,30,1,1
55146,53,34694,53,allow,181,94,87,2,30,1,1
64884,53,3518,53,allow,195,102,93,2,30,1,1
56754,53,65237,53,allow,183,94,89,2,30,1,1
63951,53,30484,53,allow,193,102,91,2,30,1,1
65209,53,36498,53,allow,166,86,80,2,30,1,1
57432,53,25990,53,allow,193,102,91,2,30,1,1
64385,53,43683,53,allow,179,94,85,2,30,1,1
56587,53,37194,53,allow,184,94,90,2,30,1,1
55310,53,16833,53,allow,180,94,86,2,30,1,1
56481,53,4723,53,allow,193,102,91,2,30,1,1
64762,53,50554,53,allow,194,102,92,2,30,1,1
55310,53,54071,53,allow,180,94,86,2,30,1,1
49767,53,22379,53,allow,177,94,83,2,31,1,1
36126,53,44357,53,allow,326,78,248,2,31,1,1
63950,53,19633,53,allow,200,102,98,2,30,1,1
51607,53,31322,53,allow,296,94,202,2,30,1,1
55619,53,46483,53,allow,183,94,89,2,30,1,1
64132,53,11636,53,allow,179,94,85,2,30,1,1
55866,53,0,0,allow,86,86,0,1,30,1,0
64884,53,55819,53,allow,195,102,93,2,31,1,1
55076,53,14239,53,allow,183,94,89,2,30,1,1
55373,53,47253,53,allow,164,86,78,2,31,1,1
55373,53,29623,53,allow,164,86,78,2,30,1,1
50002,53,11892,53,allow,196,102,94,2,31,1,1
62458,53,43371,53,allow,429,102,327,2,31,1,1
56587,53,64159,53,allow,184,94,90,2,31,1,1
64762,53,20987,53,allow,194,102,92,2,31,1,1
56560,53,21034,53,allow,198,102,96,2,31,1,1
56975,53,65042,53,allow,197,102,95,2,31,1,1
57239,53,14403,53,allow,193,102,91,2,31,1,1
45409,53,56925,53,allow,307,86,221,2,31,1,1
65224,53,24023,53,allow,994,86,908,2,31,1,1
64569,53,2461,53,allow,214,102,112,2,31,1,1
56288,53,26260,53,allow,200,102,98,2,31,1,1
55748,53,57713,53,allow,194,102,92,2,31,1,1
49942,53,42847,53,allow,264,94,170,2,31,1,1
64132,53,36663,53,allow,179,94,85,2,31,1,1
65209,53,37823,53,allow,166,86,80,2,31,1,1
62639,445,0,0,drop,70,70,0,1,0,1,0
58043,445,0,0,drop,66,66,0,1,0,1,0
62636,445,0,0,drop,70,70,0,1,0,1,0
58042,445,0,0,drop,66,66,0,1,0,1,0
58040,445,0,0,drop,66,66,0,1,0,1,0
58039,445,0,0,drop,66,66,0,1,0,1,0
58036,445,0,0,drop,66,66,0,1,0,1,0
57752,445,0,0,drop,70,70,0,1,0,1,0
57749,445,0,0,drop,70,70,0,1,0,1,0
62635,445,0,0,drop,70,70,0,1,0,1,0
62625,445,0,0,drop,70,70,0,1,0,1,0
62624,445,0,0,drop,70,70,0,1,0,1,0
58026,445,0,0,drop,66,66,0,1,0,1,0
57745,445,0,0,drop,70,70,0,1,0,1,0
43868,23,0,0,deny,60,60,0,1,0,1,0
57743,445,0,0,drop,70,70,0,1,0,1,0
57741,445,0,0,drop,70,70,0,1,0,1,0
58018,445,0,0,drop,66,66,0,1,0,1,0
62608,445,0,0,drop,70,70,0,1,0,1,0
58016,445,0,0,drop,66,66,0,1,0,1,0
57734,445,0,0,drop,70,70,0,1,0,1,0
57732,445,0,0,drop,70,70,0,1,0,1,0
58007,445,0,0,drop,66,66,0,1,0,1,0
57998,445,0,0,drop,66,66,0,1,0,1,0
57731,445,0,0,drop,70,70,0,1,0,1,0
57730,445,0,0,drop,70,70,0,1,0,1,0
57729,445,0,0,drop,70,70,0,1,0,1,0
57726,445,0,0,drop,70,70,0,1,0,1,0
57723,445,0,0,drop,70,70,0,1,0,1,0
49329,443,27397,443,allow,460,394,66,4,0,3,1
57711,445,0,0,drop,70,70,0,1,0,1,0
57710,445,0,0,drop,70,70,0,1,0,1,0
62599,445,0,0,drop,70,70,0,1,0,1,0
62596,445,0,0,drop,70,70,0,1,0,1,0
57706,445,0,0,drop,70,70,0,1,0,1,0
64891,22,0,0,deny,60,60,0,1,0,1,0
57993,445,0,0,drop,66,66,0,1,0,1,0
57987,445,0,0,drop,66,66,0,1,0,1,0
57992,445,0,0,drop,66,66,0,1,0,1,0
57988,445,0,0,drop,66,66,0,1,0,1,0
57986,445,0,0,drop,66,66,0,1,0,1,0
57989,445,0,0,drop,66,66,0,1,0,1,0
57985,445,0,0,drop,66,66,0,1,0,1,0
57990,445,0,0,drop,66,66,0,1,0,1,0
57700,445,0,0,drop,70,70,0,1,0,1,0
57701,445,0,0,drop,70,70,0,1,0,1,0
57689,445,0,0,drop,70,70,0,1,0,1,0
62579,445,0,0,drop,70,70,0,1,0,1,0
62581,445,0,0,drop,70,70,0,1,0,1,0
63341,53,0,0,deny,77,77,0,1,0,1,0
57972,445,0,0,drop,66,66,0,1,0,1,0
57973,445,0,0,drop,66,66,0,1,0,1,0
57970,445,0,0,drop,66,66,0,1,0,1,0
38538,22,0,0,deny,60,60,0,1,0,1,0
62577,445,0,0,drop,70,70,0,1,0,1,0
57685,445,0,0,drop,70,70,0,1,0,1,0
62568,445,0,0,drop,70,70,0,1,0,1,0
62570,445,0,0,drop,70,70,0,1,0,1,0
57676,445,0,0,drop,70,70,0,1,0,1,0
57673,445,0,0,drop,70,70,0,1,0,1,0
57675,445,0,0,drop,70,70,0,1,0,1,0
57672,445,0,0,drop,70,70,0,1,0,1,0
57669,445,0,0,drop,70,70,0,1,0,1,0
62556,445,0,0,drop,70,70,0,1,0,1,0
62552,445,0,0,drop,70,70,0,1,0,1,0
57662,445,0,0,drop,70,70,0,1,0,1,0
57387,70,0,0,deny,60,60,0,1,0,1,0
57655,445,0,0,drop,70,70,0,1,0,1,0
57653,445,0,0,drop,70,70,0,1,0,1,0
57949,445,0,0,drop,66,66,0,1,0,1,0
62549,445,0,0,drop,70,70,0,1,0,1,0
57649,445,0,0,drop,70,70,0,1,0,1,0
57942,445,0,0,drop,66,66,0,1,0,1,0
57941,445,0,0,drop,66,66,0,1,0,1,0
57647,445,0,0,drop,70,70,0,1,0,1,0
64762,53,32990,53,allow,188,96,92,2,30,1,1
65343,53,10337,53,allow,184,94,90,2,30,1,1
64132,53,9025,53,allow,174,89,85,2,30,1,1
56369,53,8270,53,allow,186,95,91,2,31,1,1
64327,53,33651,53,allow,204,104,100,2,31,1,1
56288,53,45590,53,allow,200,102,98,2,31,1,1
49558,53,59753,53,allow,186,95,91,2,30,1,1
65386,53,20616,53,allow,762,101,661,2,30,1,1
64385,53,34139,53,allow,174,89,85,2,30,1,1
55660,53,37547,53,allow,757,98,659,2,30,1,1
55005,443,32809,443,allow,134,60,74,3,11,2,1
56219,53,32903,53,allow,762,101,661,2,31,1,1
49518,53,63252,53,allow,186,95,91,2,30,1,1
55396,53,1903,53,allow,778,103,675,2,30,1,1
65264,53,54273,53,allow,88,88,0,1,30,1,0
64122,53,44861,53,allow,212,108,104,2,31,1,1
52787,443,46630,443,allow,352,218,134,6,28,4,2
65422,53,10168,53,allow,753,96,657,2,30,1,1
64854,53,42024,53,allow,172,88,84,2,30,1,1
64595,53,56793,53,allow,182,93,89,2,30,1,1
49174,53,58915,53,allow,198,101,97,2,30,1,1
56046,53,4218,53,allow,186,95,91,2,31,1,1
56975,53,53582,53,allow,194,99,95,2,30,1,1
50002,53,33820,53,allow,192,98,94,2,31,1,1
56560,53,34693,53,allow,196,100,96,2,31,1,1
49800,53,22865,53,allow,182,93,89,2,31,1,1
49967,53,41633,53,allow,186,95,91,2,31,1,1
55125,53,57418,53,allow,170,87,83,2,31,1,1
49767,53,46615,53,allow,200,102,98,2,31,1,1
57083,53,25967,53,allow,196,100,96,2,31,1,1
56561,53,4757,53,allow,166,85,81,2,31,1,1
49262,53,27998,53,allow,168,86,82,2,31,1,1
65307,53,2186,53,allow,184,94,90,2,31,1,1
55265,53,19057,53,allow,740,93,647,2,31,1,1
49531,53,21298,53,allow,740,93,647,2,31,1,1
56955,53,2081,53,allow,182,93,89,2,31,1,1
55760,53,53617,53,allow,180,92,88,2,31,1,1
49752,53,46099,53,allow,180,92,88,2,31,1,1
50557,53,32584,53,allow,758,93,665,2,31,1,1
56589,53,29325,53,allow,198,101,97,2,31,1,1
57643,445,0,0,drop,70,70,0,1,0,1,0
62528,445,0,0,drop,70,70,0,1,0,1,0
62530,445,0,0,drop,70,70,0,1,0,1,0
57937,445,0,0,drop,66,66,0,1,0,1,0
57642,445,0,0,drop,70,70,0,1,0,1,0
57926,445,0,0,drop,66,66,0,1,0,1,0
57929,445,0,0,drop,66,66,0,1,0,1,0
57927,445,0,0,drop,66,66,0,1,0,1,0
57934,445,0,0,drop,66,66,0,1,0,1,0
57933,445,0,0,drop,66,66,0,1,0,1,0
57928,445,0,0,drop,66,66,0,1,0,1,0
57924,445,0,0,drop,66,66,0,1,0,1,0
64122,53,29748,53,allow,214,110,104,2,30,1,1
65343,53,12113,53,allow,184,94,90,2,30,1,1
62524,445,0,0,drop,70,70,0,1,0,1,0
62521,445,0,0,drop,70,70,0,1,0,1,0
62517,445,0,0,drop,70,70,0,1,0,1,0
62519,445,0,0,drop,70,70,0,1,0,1,0
57637,445,0,0,drop,70,70,0,1,0,1,0
62516,445,0,0,drop,70,70,0,1,0,1,0
62512,445,0,0,drop,70,70,0,1,0,1,0
62509,445,0,0,drop,70,70,0,1,0,1,0
57918,445,0,0,drop,66,66,0,1,0,1,0
62508,445,0,0,drop,70,70,0,1,0,1,0
64603,53,6564,53,allow,258,102,156,2,30,1,1
54982,53,55508,53,allow,282,96,186,4,48,2,2
45525,53,45525,53,allow,469,165,304,4,30,2,2
49406,53,22949,53,allow,215,102,113,2,30,1,1
64982,53,55675,53,allow,215,102,113,2,30,1,1
65172,53,25157,53,allow,306,110,196,2,30,1,1
49262,53,60170,53,allow,168,86,82,2,30,1,1
49603,53,29581,53,allow,199,102,97,2,30,1,1
55165,53,3036,53,allow,193,102,91,2,29,1,1
55605,53,24748,53,allow,195,102,93,2,29,1,1
50339,53,28610,53,allow,498,204,294,6,29,3,3
64811,53,22274,53,allow,195,102,93,2,29,1,1
64233,53,2922,53,allow,257,126,131,2,29,1,1
65382,53,20387,53,allow,301,108,193,4,54,2,2
50578,123,63477,123,allow,184,94,90,2,30,1,1
47817,443,22532,443,allow,190,70,120,4,14,2,2
55220,80,9309,80,allow,1146,606,540,8,45,5,3
64275,53,47631,53,allow,324,90,234,4,35,2,2
64132,53,49481,53,allow,179,94,85,2,29,1,1
65343,53,41692,53,allow,184,94,90,2,29,1,1
55599,53,39999,53,allow,258,94,164,2,29,1,1
50263,53,56865,53,allow,164,86,78,2,29,1,1
49381,53,64109,53,allow,230,102,128,2,29,1,1
64276,53,39382,53,allow,197,102,95,2,29,1,1
55354,53,62421,53,allow,214,110,104,2,30,1,1
49548,53,36556,53,allow,198,94,104,2,29,1,1
49952,53,64431,53,allow,195,102,93,2,29,1,1
55821,53,65311,53,allow,196,102,94,2,31,1,1
49862,53,51904,53,allow,194,102,92,2,30,1,1
64935,53,3553,53,allow,198,102,96,2,30,1,1
55076,53,24944,53,allow,183,94,89,2,30,1,1
65251,53,19717,53,allow,819,102,717,2,30,1,1
55052,53,42687,53,allow,198,102,96,2,30,1,1
65307,53,63090,53,allow,184,94,90,2,30,1,1
49174,53,59747,53,allow,199,102,97,2,33,1,1
49904,53,21659,53,allow,749,94,655,2,30,1,1
55354,53,63415,53,allow,214,110,104,2,30,1,1
50305,53,38735,53,allow,209,110,99,2,30,1,1
42904,53,51732,53,allow,308,118,190,2,30,1,1
56786,53,1954,53,allow,194,102,92,2,30,1,1
64854,53,27051,53,allow,178,94,84,2,30,1,1
55236,53,57748,53,allow,216,102,114,2,30,1,1
59773,53,31376,53,allow,193,94,99,2,30,1,1
55036,53,3360,53,allow,177,94,83,2,30,1,1
49999,53,62191,53,allow,316,91,225,4,46,2,2
49198,53,53619,53,allow,308,118,190,2,30,1,1
56786,53,65502,53,allow,817,102,715,2,30,1,1
65251,53,30637,53,allow,196,102,94,2,30,1,1
50615,53,31516,53,allow,785,110,675,2,30,1,1
49360,53,51221,53,allow,321,102,219,2,30,1,1
55619,53,64151,53,allow,183,94,89,2,30,1,1
64684,53,23170,53,allow,199,94,105,2,30,1,1
64385,53,23181,53,allow,179,94,85,2,30,1,1
59874,443,18993,443,allow,1066,545,521,11,28,5,6
56637,80,52477,80,allow,234,234,0,4,12,4,0
45525,53,45525,53,allow,86,86,0,1,30,1,0
55354,53,21132,53,allow,214,110,104,2,30,1,1
56955,53,1466,53,allow,183,94,89,2,30,1,1
50305,53,8454,53,allow,209,110,99,2,30,1,1
51929,80,26646,80,allow,1213,821,392,8,15,6,2
64854,53,60425,53,allow,178,94,84,2,30,1,1
65486,53,61924,53,allow,216,102,114,2,30,1,1
64327,53,41700,53,allow,210,110,100,2,30,1,1
55605,53,6586,53,allow,195,102,93,2,30,1,1
57008,123,60959,123,allow,184,94,90,2,30,1,1
38700,443,49227,443,allow,130,70,60,2,14,1,1
49456,53,22820,53,allow,308,101,207,4,32,2,2
35991,443,26374,443,allow,190,70,120,4,14,2,2
50172,443,57262,443,allow,130,70,60,2,14,1,1
56369,53,59261,53,allow,193,102,91,2,29,1,1
55865,53,14766,53,allow,325,98,227,4,40,2,2
65447,53,50068,53,allow,277,102,175,2,29,1,1
55294,53,64912,53,allow,199,102,97,2,29,1,1
56292,53,0,0,allow,238,94,144,2,29,1,1
64621,53,52780,53,allow,387,134,253,2,29,1,1
64428,53,23839,53,allow,621,196,425,6,59,3,3
49767,53,20343,53,allow,177,94,83,2,29,1,1
55619,53,44719,53,allow,183,94,89,2,29,1,1
65007,53,49517,53,allow,330,94,236,4,55,2,2
64595,53,56897,53,allow,183,94,89,2,29,1,1
64327,53,51961,53,allow,210,110,100,2,30,1,1
54992,53,53080,53,allow,195,102,93,2,29,1,1
49558,53,38507,53,allow,193,102,91,2,29,1,1
56489,53,35362,53,allow,178,94,84,2,29,1,1
55365,53,11222,53,allow,214,110,104,2,29,1,1
65221,53,38871,53,allow,258,102,156,2,29,1,1
64852,53,7184,53,allow,248,102,146,2,29,1,1
49999,53,13553,53,allow,181,94,87,2,29,1,1
55365,53,5213,53,allow,214,110,104,2,29,1,1
55505,53,4978,53,allow,199,102,97,2,29,1,1
56399,53,36148,53,allow,498,204,294,6,29,3,3
56975,53,38883,53,allow,197,102,95,2,29,1,1
55052,53,1245,53,allow,198,102,96,2,30,1,1
65411,53,34611,53,allow,354,102,252,2,30,1,1
64962,53,10417,53,allow,196,94,102,2,30,1,1
57005,53,13005,53,allow,199,94,105,2,30,1,1
49848,53,31476,53,allow,167,86,81,2,30,1,1
55760,53,12734,53,allow,182,94,88,2,30,1,1
64122,53,40984,53,allow,214,110,104,2,30,1,1
49301,53,26968,53,allow,353,118,235,2,31,1,1
63950,53,3217,53,allow,348,102,246,4,39,2,2
55036,53,7624,53,allow,177,94,83,2,30,1,1
55125,53,47085,53,allow,177,94,83,2,30,1,1
55872,53,55193,53,allow,819,102,717,2,30,1,1
50425,53,24348,53,allow,199,102,97,2,30,1,1
55405,53,55361,53,allow,199,102,97,2,30,1,1
59873,443,3851,443,allow,1066,545,521,11,28,5,6
64811,53,57822,53,allow,314,97,217,4,47,2,2
65436,53,49533,53,allow,286,90,196,4,55,2,2
49862,53,59363,53,allow,817,102,715,2,30,1,1
50002,53,25520,53,allow,196,102,94,2,30,1,1
64935,53,55369,53,allow,198,102,96,2,30,1,1
64122,53,11077,53,allow,214,110,104,2,30,1,1
49800,53,14799,53,allow,183,94,89,2,30,1,1
65497,53,19517,53,allow,490,111,379,4,54,2,2
57185,53,50357,53,allow,784,94,690,2,30,1,1
52780,53,38802,53,allow,338,94,244,2,30,1,1
49425,53,61081,53,allow,772,102,670,2,30,1,1
55821,53,40795,53,allow,196,102,94,2,30,1,1
56955,53,34703,53,allow,183,94,89,2,30,1,1
64945,53,35387,53,allow,240,86,154,2,30,1,1
64605,53,20190,53,allow,183,94,89,2,31,1,1
49781,53,21515,53,allow,194,102,92,2,30,1,1
55872,53,6785,53,allow,196,102,94,2,30,1,1
59283,53,37048,53,allow,359,86,273,2,30,1,1
49319,53,45899,53,allow,166,86,80,2,30,1,1
56979,53,50230,53,allow,209,110,99,2,30,1,1
50520,53,46734,53,allow,732,86,646,2,30,1,1
64762,53,37992,53,allow,194,102,92,2,30,1,1
49767,53,43872,53,allow,200,102,98,2,31,1,1
55310,53,54905,53,allow,180,94,86,2,31,1,1
49703,53,23224,53,allow,288,102,186,2,31,1,1
56288,53,47353,53,allow,200,102,98,2,30,1,1
49848,53,25784,53,allow,167,86,81,2,30,1,1
56430,53,26813,53,allow,199,102,97,2,30,1,1
50002,53,41135,53,allow,196,102,94,2,30,1,1
49800,53,2151,53,allow,183,94,89,2,31,1,1
56589,53,43560,53,allow,166,86,80,2,31,1,1
49518,53,53885,53,allow,193,102,91,2,30,1,1
57058,53,2739,53,allow,167,86,81,2,31,1,1
50523,53,46429,53,allow,376,78,298,2,31,1,1
55760,53,35277,53,allow,182,94,88,2,31,1,1
64022,53,48680,53,allow,197,102,95,2,31,1,1
56369,53,59110,53,allow,193,102,91,2,31,1,1
49973,53,27114,53,allow,261,94,167,2,30,1,1
57083,53,27580,53,allow,198,102,96,2,30,1,1
55405,53,37369,53,allow,199,102,97,2,30,1,1
56975,53,33537,53,allow,197,102,95,2,30,1,1
56743,53,62302,53,allow,209,110,99,2,31,1,1
55505,53,51745,53,allow,199,102,97,2,31,1,1
49820,53,29495,53,allow,193,102,91,2,31,1,1
55125,53,32465,53,allow,177,94,83,2,31,1,1
64327,53,41348,53,allow,210,110,100,2,31,1,1
56743,53,46707,53,allow,209,110,99,2,30,1,1
49809,53,6008,53,allow,386,134,252,2,30,1,1
57083,53,19689,53,allow,198,102,96,2,30,1,1
56589,53,12890,53,allow,199,102,97,2,31,1,1
56869,53,8171,53,allow,198,94,104,2,31,1,1
49558,53,10290,53,allow,193,102,91,2,30,1,1
56589,53,14177,53,allow,166,86,80,2,30,1,1
49615,53,30558,53,allow,413,170,243,6,31,3,3
49967,53,25573,53,allow,445,95,350,4,50,2,2
57914,445,0,0,drop,66,66,0,1,0,1,0
57624,445,0,0,drop,70,70,0,1,0,1,0
57911,445,0,0,drop,66,66,0,1,0,1,0
57910,445,0,0,drop,66,66,0,1,0,1,0
57908,445,0,0,drop,66,66,0,1,0,1,0
57621,445,0,0,drop,70,70,0,1,0,1,0
62504,445,0,0,drop,70,70,0,1,0,1,0
62498,445,0,0,drop,70,70,0,1,0,1,0
62497,445,0,0,drop,70,70,0,1,0,1,0
57617,445,0,0,drop,70,70,0,1,0,1,0
57615,445,0,0,drop,70,70,0,1,0,1,0
57898,445,0,0,drop,66,66,0,1,0,1,0
57613,445,0,0,drop,70,70,0,1,0,1,0
57890,445,0,0,drop,66,66,0,1,0,1,0
62484,445,0,0,drop,70,70,0,1,0,1,0
57606,445,0,0,drop,70,70,0,1,0,1,0
57887,445,0,0,drop,66,66,0,1,0,1,0
57604,445,0,0,drop,70,70,0,1,0,1,0
57603,445,0,0,drop,70,70,0,1,0,1,0
57879,445,0,0,drop,66,66,0,1,0,1,0
57602,445,0,0,drop,70,70,0,1,0,1,0
57601,445,0,0,drop,70,70,0,1,0,1,0
57870,445,0,0,drop,66,66,0,1,0,1,0
57596,445,0,0,drop,70,70,0,1,0,1,0
57595,445,0,0,drop,70,70,0,1,0,1,0
57583,445,0,0,drop,70,70,0,1,0,1,0
57576,445,0,0,drop,70,70,0,1,0,1,0
57572,445,0,0,drop,70,70,0,1,0,1,0
57573,445,0,0,drop,70,70,0,1,0,1,0
62473,445,0,0,drop,70,70,0,1,0,1,0
57863,445,0,0,drop,66,66,0,1,0,1,0
57864,445,0,0,drop,66,66,0,1,0,1,0
57859,445,0,0,drop,66,66,0,1,0,1,0
57862,445,0,0,drop,66,66,0,1,0,1,0
57861,445,0,0,drop,66,66,0,1,0,1,0
57858,445,0,0,drop,66,66,0,1,0,1,0
57860,445,0,0,drop,66,66,0,1,0,1,0
57857,445,0,0,drop,66,66,0,1,0,1,0
57561,445,0,0,drop,70,70,0,1,0,1,0
36738,123,0,0,deny,234,234,0,1,0,1,0
62463,445,0,0,drop,70,70,0,1,0,1,0
62461,445,0,0,drop,70,70,0,1,0,1,0
62453,445,0,0,drop,70,70,0,1,0,1,0
46600,443,0,0,deny,1097,1097,0,1,0,1,0
57845,445,0,0,drop,66,66,0,1,0,1,0
57843,445,0,0,drop,66,66,0,1,0,1,0
57842,445,0,0,drop,66,66,0,1,0,1,0
62451,445,0,0,drop,70,70,0,1,0,1,0
57557,445,0,0,drop,70,70,0,1,0,1,0
63196,445,0,0,deny,66,66,0,1,0,1,0
62448,445,0,0,drop,70,70,0,1,0,1,0
62444,445,0,0,drop,70,70,0,1,0,1,0
62438,445,0,0,drop,70,70,0,1,0,1,0
57545,445,0,0,drop,70,70,0,1,0,1,0
57548,445,0,0,drop,70,70,0,1,0,1,0
57547,445,0,0,drop,70,70,0,1,0,1,0
57543,445,0,0,drop,70,70,0,1,0,1,0
57541,445,0,0,drop,70,70,0,1,0,1,0
62430,445,0,0,drop,70,70,0,1,0,1,0
62424,445,0,0,drop,70,70,0,1,0,1,0
57535,445,0,0,drop,70,70,0,1,0,1,0
57527,445,0,0,drop,70,70,0,1,0,1,0
56495,53,29192,53,allow,198,101,97,2,30,1,1
48757,80,48757,80,allow,560,264,296,9,44,5,4
64605,53,39152,53,allow,182,93,89,2,30,1,1
56623,53,18777,53,allow,771,101,670,2,30,1,1
55934,53,51844,53,allow,731,85,646,2,30,1,1
64312,53,26634,53,allow,202,103,99,2,31,1,1
64485,53,38773,53,allow,182,93,89,2,30,1,1
49781,53,57974,53,allow,188,96,92,2,30,1,1
55581,53,6182,53,allow,166,85,81,2,30,1,1
54958,53,54115,53,allow,1413,85,1328,4,47,2,2
56389,53,50951,53,allow,279,93,186,4,32,2,2
54982,53,63300,53,allow,282,96,186,4,48,2,2
56743,53,16205,53,allow,202,103,99,2,30,1,1
55966,53,62624,53,allow,747,92,655,2,30,1,1
55560,53,1916,53,allow,164,84,80,2,31,1,1
57028,53,32039,53,allow,776,102,674,2,31,1,1
64127,53,29234,53,allow,170,87,83,2,31,1,1
65140,53,5924,53,allow,774,101,673,2,31,1,1
55859,53,35635,53,allow,778,103,675,2,31,1,1
49820,53,12064,53,allow,186,95,91,2,31,1,1
56946,53,14578,53,allow,732,89,643,2,31,1,1
50408,53,64657,53,allow,755,94,661,2,31,1,1
64525,53,31849,53,allow,198,101,97,2,31,1,1
49780,53,7446,53,allow,182,93,89,2,31,1,1
56674,53,43592,53,allow,182,93,89,2,31,1,1
55706,53,9914,53,allow,202,103,99,2,31,1,1
55720,53,40889,53,allow,774,101,673,2,31,1,1
57524,445,0,0,drop,70,70,0,1,0,1,0
57821,445,0,0,drop,66,66,0,1,0,1,0
62420,445,0,0,drop,70,70,0,1,0,1,0
57521,445,0,0,drop,70,70,0,1,0,1,0
57519,445,0,0,drop,70,70,0,1,0,1,0
57816,445,0,0,drop,66,66,0,1,0,1,0
57817,445,0,0,drop,66,66,0,1,0,1,0
57515,445,0,0,drop,70,70,0,1,0,1,0
62412,445,0,0,drop,70,70,0,1,0,1,0
57514,445,0,0,drop,70,70,0,1,0,1,0
62406,445,0,0,drop,70,70,0,1,0,1,0
57810,445,0,0,drop,66,66,0,1,0,1,0
57806,445,0,0,drop,66,66,0,1,0,1,0
57805,445,0,0,drop,66,66,0,1,0,1,0
57804,445,0,0,drop,66,66,0,1,0,1,0
57803,445,0,0,drop,66,66,0,1,0,1,0
57800,445,0,0,drop,66,66,0,1,0,1,0
57799,445,0,0,drop,66,66,0,1,0,1,0
57795,445,0,0,drop,66,66,0,1,0,1,0
62396,445,0,0,drop,70,70,0,1,0,1,0
57509,445,0,0,drop,70,70,0,1,0,1,0
62393,445,0,0,drop,70,70,0,1,0,1,0
62392,445,0,0,drop,70,70,0,1,0,1,0
62389,445,0,0,drop,70,70,0,1,0,1,0
45051,23,0,0,deny,60,60,0,1,0,1,0
41165,23,0,0,deny,60,60,0,1,0,1,0
62387,445,0,0,drop,70,70,0,1,0,1,0
62386,445,0,0,drop,70,70,0,1,0,1,0
62384,445,0,0,drop,70,70,0,1,0,1,0
57789,445,0,0,drop,66,66,0,1,0,1,0
56743,53,5034,53,allow,209,110,99,2,30,1,1
57066,53,30352,53,allow,197,94,103,2,30,1,1
49752,53,61999,53,allow,182,94,88,2,30,1,1
49752,53,1168,53,allow,182,94,88,2,30,1,1
65067,53,22984,53,allow,327,102,225,2,30,1,1
48755,80,48755,80,allow,630,264,366,10,44,5,5
49666,53,61369,53,allow,392,124,268,4,35,2,2
42485,443,17248,443,allow,130,70,60,3,5,2,1
64595,53,13089,53,allow,299,93,206,4,35,2,2
49319,53,1935,53,allow,166,86,80,2,29,1,1
64605,53,57757,53,allow,183,94,89,2,29,1,1
55125,53,57865,53,allow,177,94,83,2,29,1,1
55119,53,12117,53,allow,994,86,908,2,29,1,1
55943,53,30420,53,allow,448,184,264,6,29,3,3
56979,53,46725,53,allow,209,110,99,2,29,1,1
49253,53,38638,53,allow,727,86,641,2,29,1,1
49781,53,14753,53,allow,194,102,92,2,30,1,1
56533,53,7408,53,allow,199,102,97,2,29,1,1
49847,53,33024,53,allow,448,184,264,6,29,3,3
56561,53,63189,53,allow,167,86,81,2,30,1,1
56589,53,29602,53,allow,199,102,97,2,30,1,1
54448,53,29193,53,allow,70,70,0,1,30,1,0
49820,53,34423,53,allow,193,102,91,2,30,1,1
56389,53,30370,53,allow,279,93,186,4,31,2,2
36717,443,50144,443,allow,232,172,60,3,5,2,1
60796,53,60796,53,allow,248,106,142,2,30,1,1
64022,53,64185,53,allow,197,102,95,2,30,1,1
55581,53,26872,53,allow,167,86,81,2,30,1,1
56955,53,43873,53,allow,183,94,89,2,30,1,1
56535,53,61823,53,allow,200,94,106,2,30,1,1
56782,53,51399,53,allow,197,94,103,2,30,1,1
56922,53,56922,53,allow,219,98,121,2,30,1,1
57083,53,55638,53,allow,198,102,96,2,30,1,1
56871,53,27631,53,allow,198,86,112,2,30,1,1
64525,53,63463,53,allow,199,102,97,2,30,1,1
56560,53,48488,53,allow,198,102,96,2,30,1,1
64485,53,11274,53,allow,183,94,89,2,30,1,1
56389,53,40774,53,allow,279,93,186,4,32,2,2
50985,80,61422,80,allow,613,539,74,7,15,6,1
65437,53,59504,53,allow,488,111,377,4,53,2,2
55524,53,46955,53,allow,413,170,243,6,30,3,3
55560,53,36102,53,allow,166,86,80,2,30,1,1
65307,53,33704,53,allow,365,94,271,4,58,2,2
56561,53,36683,53,allow,167,86,81,2,30,1,1
57027,53,20222,53,allow,198,94,104,2,30,1,1
55581,53,16064,53,allow,167,86,81,2,30,1,1
64485,53,10635,53,allow,183,94,89,2,30,1,1
47053,80,59078,80,allow,1188,463,725,8,15,5,3
49951,80,39870,80,allow,1706,505,1201,8,14,5,3
48756,80,48756,80,allow,560,264,296,9,44,5,4
49531,53,39343,53,allow,289,94,195,4,31,2,2
49569,53,55862,53,allow,181,94,87,2,31,1,1
64144,53,27291,53,allow,193,102,91,2,31,1,1
64461,53,32838,53,allow,350,89,261,4,53,2,2
56046,53,55070,53,allow,193,102,91,2,31,1,1
65307,53,59322,53,allow,184,94,90,2,29,1,1
54982,53,58418,53,allow,282,96,186,4,47,2,2
65532,53,6977,53,allow,255,102,153,2,29,1,1
48754,80,48754,80,allow,560,264,296,9,44,5,4
56495,53,8652,53,allow,199,102,97,2,30,1,1
54982,53,26204,53,allow,282,96,186,4,48,2,2
49429,53,3365,53,allow,199,102,97,2,29,1,1
55760,53,9967,53,allow,182,94,88,2,30,1,1
56495,53,46439,53,allow,199,102,97,2,30,1,1
49331,53,38875,53,allow,200,94,106,2,29,1,1
49262,53,13310,53,allow,168,86,82,2,29,1,1
49429,53,51638,53,allow,199,102,97,2,29,1,1
45589,53,45589,53,allow,225,106,119,2,30,1,1
64485,53,6047,53,allow,183,94,89,2,30,1,1
50405,53,35754,53,allow,200,102,98,2,30,1,1
55560,53,7666,53,allow,166,86,80,2,30,1,1
64334,53,44519,53,allow,200,94,106,2,31,1,1
55560,53,43077,53,allow,166,86,80,2,30,1,1
35868,123,20404,123,allow,184,94,90,2,30,1,1
56561,53,4933,53,allow,167,86,81,2,30,1,1
65410,53,40006,53,allow,229,110,119,2,31,1,1
49780,53,9183,53,allow,183,94,89,2,31,1,1
55086,53,37200,53,allow,328,90,238,4,37,2,2
49831,53,63335,53,allow,198,94,104,2,30,1,1
55581,53,6275,53,allow,167,86,81,2,30,1,1
53443,123,34007,123,allow,184,94,90,2,30,1,1
64312,53,19518,53,allow,209,110,99,2,30,1,1
55622,53,55622,53,allow,235,98,137,2,30,1,1
64312,53,39914,53,allow,209,110,99,2,30,1,1
53864,53,0,0,allow,181,86,95,2,30,1,1
64567,53,38980,53,allow,199,102,97,2,30,1,1
65367,53,6408,53,allow,251,94,157,2,30,1,1
64257,53,61085,53,allow,211,78,133,2,30,1,1
56389,53,5155,53,allow,279,93,186,4,32,2,2
65075,53,3072,53,allow,278,100,178,4,31,2,2
36368,80,28918,80,allow,78,78,0,2,8,2,0
49767,53,48677,53,allow,200,102,98,2,30,1,1
36003,123,29238,123,allow,184,94,90,2,30,1,1
56495,53,40690,53,allow,199,102,97,2,30,1,1
53771,53,15804,53,allow,168,78,90,2,30,1,1
50436,53,50436,53,allow,248,106,142,2,30,1,1
49767,53,59870,53,allow,200,102,98,2,30,1,1
64127,53,25934,53,allow,177,94,83,2,30,1,1
56589,53,35173,53,allow,199,102,97,2,30,1,1
64605,53,37496,53,allow,183,94,89,2,30,1,1
56913,53,26881,53,allow,193,102,91,2,30,1,1
46087,123,1853,123,allow,184,94,90,2,30,1,1
57058,53,29046,53,allow,167,86,81,2,30,1,1
47749,53,47749,53,allow,248,106,142,2,30,1,1
49212,53,2222,53,allow,183,94,89,2,30,1,1
64567,53,24261,53,allow,199,102,97,2,30,1,1
49262,53,46554,53,allow,168,86,82,2,30,1,1
50759,53,50759,53,allow,225,106,119,2,30,1,1
65468,53,8938,53,allow,200,94,106,2,30,1,1
57027,123,48138,123,allow,184,94,90,2,30,1,1
55261,53,52795,53,allow,183,94,89,2,30,1,1
65080,53,25627,53,allow,209,110,99,2,30,1,1
57265,53,29608,53,allow,200,102,98,2,31,1,1
65080,53,11923,53,allow,209,110,99,2,30,1,1
56674,53,17434,53,allow,183,94,89,2,31,1,1
65354,53,35359,53,allow,272,94,178,2,31,1,1
64085,53,40904,53,allow,195,94,101,2,31,1,1
49740,53,60867,53,allow,341,85,256,4,42,2,2
39743,80,10677,80,allow,1563,570,993,10,16,6,4
49415,53,12077,53,allow,313,83,230,4,54,2,2
49740,53,35003,53,allow,167,86,81,2,30,1,1
57496,445,0,0,drop,70,70,0,1,0,1,0
62380,445,0,0,drop,70,70,0,1,0,1,0
57786,445,0,0,drop,66,66,0,1,0,1,0
57784,445,0,0,drop,66,66,0,1,0,1,0
57782,445,0,0,drop,66,66,0,1,0,1,0
57493,445,0,0,drop,70,70,0,1,0,1,0
57780,445,0,0,drop,66,66,0,1,0,1,0
62375,445,0,0,drop,70,70,0,1,0,1,0
62369,445,0,0,drop,70,70,0,1,0,1,0
57488,445,0,0,drop,70,70,0,1,0,1,0
57487,445,0,0,drop,70,70,0,1,0,1,0
57485,445,0,0,drop,70,70,0,1,0,1,0
57769,445,0,0,drop,66,66,0,1,0,1,0
57762,445,0,0,drop,66,66,0,1,0,1,0
62352,445,0,0,drop,70,70,0,1,0,1,0
57478,445,0,0,drop,70,70,0,1,0,1,0
57476,445,0,0,drop,70,70,0,1,0,1,0
57760,445,0,0,drop,66,66,0,1,0,1,0
57475,445,0,0,drop,70,70,0,1,0,1,0
57474,445,0,0,drop,70,70,0,1,0,1,0
57473,445,0,0,drop,70,70,0,1,0,1,0
57467,445,0,0,drop,70,70,0,1,0,1,0
57470,445,0,0,drop,70,70,0,1,0,1,0
57752,445,0,0,drop,66,66,0,1,0,1,0
57750,445,0,0,drop,66,66,0,1,0,1,0
57455,445,0,0,drop,70,70,0,1,0,1,0
57454,445,0,0,drop,70,70,0,1,0,1,0
57450,445,0,0,drop,70,70,0,1,0,1,0
57445,445,0,0,drop,70,70,0,1,0,1,0
57444,445,0,0,drop,70,70,0,1,0,1,0
62343,445,0,0,drop,70,70,0,1,0,1,0
50156,53,2104,53,allow,777,87,690,2,0,1,1
57729,445,0,0,drop,66,66,0,1,0,1,0
57732,445,0,0,drop,66,66,0,1,0,1,0
57736,445,0,0,drop,66,66,0,1,0,1,0
57737,445,0,0,drop,66,66,0,1,0,1,0
57733,445,0,0,drop,66,66,0,1,0,1,0
57734,445,0,0,drop,66,66,0,1,0,1,0
57730,445,0,0,drop,66,66,0,1,0,1,0
57731,445,0,0,drop,66,66,0,1,0,1,0
57433,445,0,0,drop,70,70,0,1,0,1,0
62347,25,62347,25,deny,291,126,165,4,0,2,2
62336,445,0,0,drop,70,70,0,1,0,1,0
62329,445,0,0,drop,70,70,0,1,0,1,0
62324,445,0,0,drop,70,70,0,1,0,1,0
57717,445,0,0,drop,66,66,0,1,0,1,0
57716,445,0,0,drop,66,66,0,1,0,1,0
57714,445,0,0,drop,66,66,0,1,0,1,0
49159,23,0,0,deny,60,60,0,1,0,1,0
57429,445,0,0,drop,70,70,0,1,0,1,0
62322,445,0,0,drop,70,70,0,1,0,1,0
57148,23,0,0,deny,60,60,0,1,0,1,0
57419,445,0,0,drop,70,70,0,1,0,1,0
57417,445,0,0,drop,70,70,0,1,0,1,0
57420,445,0,0,drop,70,70,0,1,0,1,0
62320,445,0,0,drop,70,70,0,1,0,1,0
57415,445,0,0,drop,70,70,0,1,0,1,0
62316,445,0,0,drop,70,70,0,1,0,1,0
62310,445,0,0,drop,70,70,0,1,0,1,0
57412,445,0,0,drop,70,70,0,1,0,1,0
64614,53,3667,53,allow,186,95,91,2,30,1,1
65315,53,25956,53,allow,172,88,84,2,30,1,1
55784,53,41751,53,allow,184,94,90,2,30,1,1
50082,53,42387,53,allow,774,101,673,2,30,1,1
50318,53,63172,53,allow,732,89,643,2,30,1,1
50906,443,11737,443,allow,124,64,60,2,15,1,1
64567,53,15933,53,allow,198,101,97,2,30,1,1
50905,443,13622,443,allow,124,64,60,2,15,1,1
55018,53,31411,53,allow,174,89,85,2,30,1,1
53718,443,33767,443,allow,318,192,126,6,16,4,2
64144,53,48969,53,allow,186,95,91,2,30,1,1
56388,53,28613,53,allow,186,95,91,3,46,2,1
57290,53,48036,53,allow,758,93,665,2,30,1,1
49418,53,11471,53,allow,776,102,674,2,30,1,1
65321,53,29738,53,allow,166,85,81,2,30,1,1
65175,53,9313,53,allow,778,103,675,2,30,1,1
55821,53,64842,53,allow,192,98,94,2,30,1,1
49740,53,20760,53,allow,166,85,81,2,30,1,1
56448,53,33079,53,allow,200,102,98,2,30,1,1
64331,53,12876,53,allow,174,89,85,2,31,1,1
56655,53,60599,53,allow,168,86,82,2,31,1,1
49351,53,12256,53,allow,164,84,80,2,30,1,1
50534,53,37578,53,allow,168,86,82,2,31,1,1
64967,53,49030,53,allow,184,94,90,2,31,1,1
49531,53,3594,53,allow,182,93,89,2,31,1,1
65341,53,36456,53,allow,200,102,98,2,31,1,1
57406,445,0,0,drop,70,70,0,1,0,1,0
62297,445,0,0,drop,70,70,0,1,0,1,0
62296,445,0,0,drop,70,70,0,1,0,1,0
55706,53,61735,53,allow,209,110,99,2,30,1,1
64144,53,47875,53,allow,193,102,91,2,30,1,1
64373,53,26971,53,allow,554,96,458,4,60,2,2
57163,53,34170,53,allow,209,110,99,2,30,1,1
64519,53,14591,53,allow,195,102,93,2,29,1,1
49740,53,58621,53,allow,167,86,81,2,29,1,1
60520,53,60520,53,allow,248,106,142,2,29,1,1
54489,53,0,0,allow,418,154,264,4,33,2,2
64604,53,45485,53,allow,429,109,320,4,37,2,2
49752,53,44269,53,allow,182,94,88,2,29,1,1
65321,53,58472,53,allow,167,86,81,2,29,1,1
64312,53,28741,53,allow,209,110,99,2,29,1,1
64127,53,58268,53,allow,177,94,83,2,30,1,1
56388,53,20730,53,allow,275,95,180,4,44,2,2
55018,53,64174,53,allow,312,89,223,4,36,2,2
49781,53,31272,53,allow,194,102,92,2,29,1,1
56913,53,31255,53,allow,193,102,91,2,29,1,1
65321,53,36858,53,allow,167,86,81,2,29,1,1
49351,53,13338,53,allow,166,86,80,2,30,1,1
54463,53,52007,53,allow,164,78,86,2,30,1,1
63859,80,37247,80,allow,314,192,122,6,15,4,2
56674,53,20676,53,allow,183,94,89,2,30,1,1
55706,53,23729,53,allow,209,110,99,2,30,1,1
50707,53,59770,53,allow,181,86,95,2,30,1,1
57282,53,14101,53,allow,199,102,97,2,30,1,1
65136,53,56790,53,allow,335,84,251,4,32,2,2
56636,80,30803,80,allow,234,234,0,4,12,4,0
46778,53,46778,53,allow,214,82,132,2,30,1,1
49806,53,63116,53,allow,242,118,124,2,30,1,1
55784,53,32669,53,allow,184,94,90,2,30,1,1
55706,53,42379,53,allow,209,110,99,2,30,1,1
56674,53,8365,53,allow,183,94,89,2,30,1,1
56448,53,9031,53,allow,200,102,98,2,30,1,1
55784,53,2771,53,allow,184,94,90,2,30,1,1
65445,53,54616,53,allow,199,102,97,2,30,1,1
56448,53,7304,53,allow,200,102,98,2,30,1,1
64614,53,56180,53,allow,193,102,91,2,30,1,1
56498,53,39557,53,allow,199,102,97,2,30,1,1
53328,53,0,0,allow,418,154,264,4,33,2,2
47045,53,20106,53,allow,225,78,147,2,30,1,1
65162,53,50444,53,allow,328,102,226,2,30,1,1
50542,53,12388,53,allow,782,110,672,2,30,1,1
64420,53,3288,53,allow,194,102,92,2,31,1,1
55648,80,35736,80,allow,70,70,0,1,5,1,0
51903,443,13827,443,allow,1612,1089,523,12,15,7,5
49212,53,38007,53,allow,183,94,89,2,29,1,1
55261,53,52324,53,allow,183,94,89,2,29,1,1
64525,53,5631,53,allow,199,102,97,2,29,1,1
57265,53,15033,53,allow,200,102,98,2,30,1,1
49780,53,34638,53,allow,183,94,89,2,29,1,1
56498,53,6287,53,allow,199,102,97,2,30,1,1
49800,53,33373,53,allow,183,94,89,2,29,1,1
55018,53,37429,53,allow,179,94,85,2,30,1,1
56388,53,28849,53,allow,193,102,91,2,29,1,1
50405,53,20541,53,allow,200,102,98,2,29,1,1
56305,53,56939,53,allow,242,118,124,2,30,1,1
64022,53,2782,53,allow,197,102,95,2,30,1,1
52361,53,7907,53,allow,186,78,108,2,29,1,1
49979,53,49459,53,allow,197,94,103,2,30,1,1
50013,53,7317,53,allow,199,102,97,2,30,1,1
60166,53,7820,53,allow,258,94,164,2,30,1,1
64567,53,19362,53,allow,199,102,97,2,30,1,1
57163,53,45195,53,allow,209,110,99,2,30,1,1
56655,53,60035,53,allow,168,86,82,2,30,1,1
64525,53,61457,53,allow,199,102,97,2,30,1,1
49384,53,48199,53,allow,193,102,91,2,31,1,1
49632,53,3027,53,allow,199,102,97,2,31,1,1
64425,53,23618,53,allow,289,134,155,2,30,1,1
49351,53,27652,53,allow,166,86,80,2,30,1,1
57047,53,31984,53,allow,198,94,104,2,31,1,1
49516,53,42173,53,allow,183,94,89,2,30,1,1
37236,53,35776,53,allow,223,78,145,2,30,1,1
50013,53,8187,53,allow,199,102,97,2,30,1,1
65315,53,36625,53,allow,94,94,0,1,30,1,0
55784,53,64875,53,allow,330,94,236,4,48,2,2
56388,53,34689,53,allow,275,95,180,4,49,2,2
49460,53,64925,53,allow,458,188,270,6,30,3,3
65445,53,31304,53,allow,199,102,97,2,30,1,1
56432,53,34927,53,allow,458,188,270,6,30,3,3
55018,53,50628,53,allow,179,94,85,2,30,1,1
49531,53,34898,53,allow,183,94,89,2,30,1,1
65228,53,53617,53,allow,212,86,126,2,30,1,1
49997,53,1711,53,allow,209,110,99,2,30,1,1
64967,53,49368,53,allow,184,94,90,2,31,1,1
65365,53,42836,53,allow,196,102,94,2,31,1,1
57018,53,4073,53,allow,209,110,99,2,30,1,1
65341,53,7483,53,allow,200,102,98,2,30,1,1
49737,53,3736,53,allow,338,110,228,2,30,1,1
64331,53,26878,53,allow,324,89,235,4,31,2,2
63959,53,54075,53,allow,246,102,144,2,31,1,1
57593,80,6872,80,allow,486,280,206,8,26,5,3
65155,53,63407,53,allow,295,103,192,4,49,2,2
52327,443,53473,443,allow,134,60,74,3,6,2,1
64331,53,61619,53,allow,179,94,85,2,30,1,1
56636,53,19411,53,allow,302,86,216,2,30,1,1
50534,53,27625,53,allow,168,86,82,2,30,1,1
64933,53,11327,53,allow,349,94,255,2,30,1,1
57399,445,0,0,drop,70,70,0,1,0,1,0
57398,445,0,0,drop,70,70,0,1,0,1,0
57392,445,0,0,drop,70,70,0,1,0,1,0
57692,445,0,0,drop,66,66,0,1,0,1,0
62294,445,0,0,drop,70,70,0,1,0,1,0
57389,445,0,0,drop,70,70,0,1,0,1,0
57689,445,0,0,drop,66,66,0,1,0,1,0
57687,445,0,0,drop,66,66,0,1,0,1,0
57385,445,0,0,drop,70,70,0,1,0,1,0
57384,445,0,0,drop,70,70,0,1,0,1,0
62284,445,0,0,drop,70,70,0,1,0,1,0
62276,445,0,0,drop,70,70,0,1,0,1,0
57684,445,0,0,drop,66,66,0,1,0,1,0
57673,445,0,0,drop,66,66,0,1,0,1,0
57668,445,0,0,drop,66,66,0,1,0,1,0
57670,445,0,0,drop,66,66,0,1,0,1,0
57676,445,0,0,drop,66,66,0,1,0,1,0
57667,445,0,0,drop,66,66,0,1,0,1,0
57672,445,0,0,drop,66,66,0,1,0,1,0
57678,445,0,0,drop,66,66,0,1,0,1,0
57379,445,0,0,drop,70,70,0,1,0,1,0
62265,445,0,0,drop,70,70,0,1,0,1,0
62261,445,0,0,drop,70,70,0,1,0,1,0
62263,445,0,0,drop,70,70,0,1,0,1,0
57366,445,0,0,drop,70,70,0,1,0,1,0
62259,445,0,0,drop,70,70,0,1,0,1,0
62257,445,0,0,drop,70,70,0,1,0,1,0
62255,445,0,0,drop,70,70,0,1,0,1,0
57662,445,0,0,drop,66,66,0,1,0,1,0
62252,445,0,0,drop,70,70,0,1,0,1,0
57657,445,0,0,drop,66,66,0,1,0,1,0
57363,445,0,0,drop,70,70,0,1,0,1,0
57656,445,0,0,drop,66,66,0,1,0,1,0
57655,445,0,0,drop,66,66,0,1,0,1,0
57652,445,0,0,drop,66,66,0,1,0,1,0
55505,53,61786,53,allow,198,101,97,2,1,1,1
57358,445,0,0,drop,70,70,0,1,0,1,0
57357,445,0,0,drop,70,70,0,1,0,1,0
62235,445,0,0,drop,70,70,0,1,0,1,0
57355,445,0,0,drop,70,70,0,1,0,1,0
57641,445,0,0,drop,66,66,0,1,0,1,0
57348,445,0,0,drop,70,70,0,1,0,1,0
57634,445,0,0,drop,66,66,0,1,0,1,0
57346,445,0,0,drop,70,70,0,1,0,1,0
57345,445,0,0,drop,70,70,0,1,0,1,0
57632,445,0,0,drop,66,66,0,1,0,1,0
57344,445,0,0,drop,70,70,0,1,0,1,0
57343,445,0,0,drop,70,70,0,1,0,1,0
57340,445,0,0,drop,70,70,0,1,0,1,0
57339,445,0,0,drop,70,70,0,1,0,1,0
57625,445,0,0,drop,66,66,0,1,0,1,0
57620,445,0,0,drop,66,66,0,1,0,1,0
57325,445,0,0,drop,70,70,0,1,0,1,0
57324,445,0,0,drop,70,70,0,1,0,1,0
57322,445,0,0,drop,70,70,0,1,0,1,0
57314,445,0,0,drop,70,70,0,1,0,1,0
57315,445,0,0,drop,70,70,0,1,0,1,0
62215,445,0,0,drop,70,70,0,1,0,1,0
57608,445,0,0,drop,66,66,0,1,0,1,0
57606,445,0,0,drop,66,66,0,1,0,1,0
57607,445,0,0,drop,66,66,0,1,0,1,0
57602,445,0,0,drop,66,66,0,1,0,1,0
57603,445,0,0,drop,66,66,0,1,0,1,0
57601,445,0,0,drop,66,66,0,1,0,1,0
57303,445,0,0,drop,70,70,0,1,0,1,0
57500,23,0,0,deny,60,60,0,1,0,1,0
62207,445,0,0,drop,70,70,0,1,0,1,0
62211,445,0,0,drop,70,70,0,1,0,1,0
62197,445,0,0,drop,70,70,0,1,0,1,0
57299,445,0,0,drop,70,70,0,1,0,1,0
57589,445,0,0,drop,66,66,0,1,0,1,0
57588,445,0,0,drop,66,66,0,1,0,1,0
57586,445,0,0,drop,66,66,0,1,0,1,0
65075,53,1890,53,allow,278,100,178,4,31,2,2
65365,53,19962,53,allow,192,98,94,2,30,1,1
49384,53,2964,53,allow,186,95,91,2,30,1,1
60384,443,14731,443,allow,130,70,60,2,15,1,1
43415,443,53448,443,allow,130,70,60,2,15,1,1
60362,443,18140,443,allow,130,70,60,2,15,1,1
56772,53,9066,53,allow,168,86,82,2,30,1,1
65155,53,8256,53,allow,295,103,192,4,48,2,2
60378,443,38205,443,allow,130,70,60,2,15,1,1
59835,53,53528,53,allow,168,78,90,2,30,1,1
43423,443,64524,443,allow,130,70,60,2,15,1,1
49516,53,51751,53,allow,182,93,89,2,30,1,1
55945,53,51093,53,allow,733,86,647,2,30,1,1
51142,80,61764,80,allow,1114,534,580,12,16,7,5
60374,443,9623,443,allow,130,70,60,2,15,1,1
64245,53,8045,53,allow,198,101,97,2,31,1,1
56948,53,35699,53,allow,93,93,0,1,30,1,0
55169,53,64266,53,allow,775,103,672,2,30,1,1
55272,53,11966,53,allow,285,103,182,4,51,2,2
55821,53,40940,53,allow,168,86,82,2,30,1,1
57282,53,60817,53,allow,198,101,97,2,30,1,1
64420,53,14172,53,allow,188,96,92,2,30,1,1
49632,53,30803,53,allow,198,101,97,2,30,1,1
64483,53,26683,53,allow,168,86,82,2,31,1,1
62194,445,0,0,drop,70,70,0,1,0,1,0
57287,445,0,0,drop,70,70,0,1,0,1,0
57290,445,0,0,drop,70,70,0,1,0,1,0
57289,445,0,0,drop,70,70,0,1,0,1,0
57286,445,0,0,drop,70,70,0,1,0,1,0
57282,445,0,0,drop,70,70,0,1,0,1,0
62192,445,0,0,drop,70,70,0,1,0,1,0
62188,445,0,0,drop,70,70,0,1,0,1,0
62184,445,0,0,drop,70,70,0,1,0,1,0
62180,445,0,0,drop,70,70,0,1,0,1,0
64958,53,33266,53,allow,395,102,293,2,30,1,1
55272,53,17246,53,allow,285,103,182,4,50,2,2
50580,80,18240,80,allow,1513,694,819,10,15,5,5
57276,445,0,0,drop,70,70,0,1,0,1,0
62172,445,0,0,drop,70,70,0,1,0,1,0
49531,53,38676,53,allow,183,94,89,2,29,1,1
64967,53,8909,53,allow,184,94,90,2,29,1,1
57594,80,6266,80,allow,486,280,206,8,25,5,3
63457,443,6711,443,allow,606,300,306,11,60,6,5
57282,53,4028,53,allow,199,102,97,2,29,1,1
49820,53,16935,53,allow,193,102,91,2,29,1,1
65315,53,35548,53,allow,178,94,84,2,29,1,1
65341,53,19741,53,allow,200,102,98,2,29,1,1
57018,53,62434,53,allow,209,110,99,2,29,1,1
56948,53,55604,53,allow,183,94,89,2,29,1,1
49307,53,61453,53,allow,210,102,108,2,29,1,1
57282,53,23204,53,allow,199,102,97,2,29,1,1
64144,53,4671,53,allow,193,102,91,2,29,1,1
55809,443,23452,443,allow,180,180,0,4,11,4,0
49165,53,17672,53,allow,212,102,110,2,29,1,1
65075,53,49710,53,allow,278,100,178,4,30,2,2
49780,53,4418,53,allow,183,94,89,2,29,1,1
49312,53,8379,53,allow,216,94,122,2,29,1,1
55272,53,42714,53,allow,285,103,182,4,50,2,2
49884,53,44954,53,allow,232,110,122,2,30,1,1
50594,80,12498,80,allow,1635,824,811,10,15,5,5
65319,53,47160,53,allow,285,103,182,4,44,2,2
42595,443,31051,443,allow,1093,606,487,11,15,7,4
65341,53,20700,53,allow,200,102,98,2,30,1,1
56772,53,56028,53,allow,168,86,82,2,30,1,1
49632,53,14328,53,allow,199,102,97,2,30,1,1
64245,53,44468,53,allow,199,102,97,2,30,1,1
49632,53,26153,53,allow,199,102,97,2,30,1,1
58209,53,58209,53,allow,645,90,555,2,30,1,1
42050,53,28616,53,allow,168,78,90,2,30,1,1
65155,53,21805,53,allow,295,103,192,4,48,2,2
53717,443,48427,443,allow,318,192,126,6,15,4,2
63460,443,27370,443,allow,502,250,252,9,63,5,4
49997,53,42691,53,allow,209,110,99,2,29,1,1
50655,80,3910,80,allow,1507,682,825,13,20,8,5
53719,443,60186,443,allow,70,70,0,1,5,1,0
60591,53,64106,53,allow,78,78,0,1,29,1,0
64967,53,42572,53,allow,184,94,90,2,29,1,1
56448,53,62354,53,allow,200,102,98,2,29,1,1
41029,53,0,0,allow,86,86,0,1,29,1,0
56655,53,54773,53,allow,86,86,0,1,29,1,0
49973,80,59362,80,allow,1352,364,988,13,15,6,7
64331,53,48009,53,allow,179,94,85,2,29,1,1
65194,53,28428,53,allow,196,94,102,2,29,1,1
56655,53,28955,53,allow,168,86,82,2,29,1,1
64844,53,45693,53,allow,733,86,647,2,29,1,1
55821,53,13953,53,allow,196,102,94,2,29,1,1
49516,53,31257,53,allow,183,94,89,2,29,1,1
49351,53,56042,53,allow,166,86,80,2,29,1,1
49516,53,60499,53,allow,183,94,89,2,29,1,1
59902,53,0,0,allow,220,83,137,2,30,1,1
57305,53,52868,53,allow,168,86,82,2,29,1,1
65365,53,13159,53,allow,196,102,94,2,30,1,1
64292,53,46657,53,allow,199,94,105,2,30,1,1
42291,53,6078,53,allow,168,78,90,2,30,1,1
49600,53,23356,53,allow,243,94,149,2,30,1,1
65155,53,9340,53,allow,613,200,413,6,59,3,3
63975,53,64486,53,allow,316,94,222,2,30,1,1
55629,53,49009,53,allow,208,94,114,2,30,1,1
65422,53,59464,53,allow,208,94,114,2,30,1,1
56772,53,47377,53,allow,168,86,82,2,30,1,1
64348,53,23011,53,allow,321,102,219,2,30,1,1
49724,53,34584,53,allow,210,102,108,2,30,1,1
64245,53,47905,53,allow,199,102,97,2,30,1,1
56772,53,27354,53,allow,168,86,82,2,30,1,1
65292,53,10766,53,allow,385,106,279,4,33,2,2
55272,53,40097,53,allow,599,198,401,6,50,3,3
58017,53,58017,53,allow,832,106,726,2,30,1,1
64420,53,3880,53,allow,194,102,92,2,30,1,1
65075,53,30736,53,allow,278,100,178,4,30,2,2
55345,53,38199,53,allow,255,102,153,2,30,1,1
39208,53,0,0,allow,86,86,0,1,30,1,0
55026,53,55024,53,allow,196,94,102,2,30,1,1
64245,53,26898,53,allow,199,102,97,2,30,1,1
64726,53,58493,53,allow,352,94,258,2,30,1,1
56947,53,11234,53,allow,239,102,137,2,30,1,1
62169,445,0,0,drop,70,70,0,1,0,1,0
57269,445,0,0,drop,70,70,0,1,0,1,0
57268,445,0,0,drop,70,70,0,1,0,1,0
57263,445,0,0,drop,70,70,0,1,0,1,0
57261,445,0,0,drop,70,70,0,1,0,1,0
57566,445,0,0,drop,66,66,0,1,0,1,0
62167,445,0,0,drop,70,70,0,1,0,1,0
57257,445,0,0,drop,70,70,0,1,0,1,0
41381,23,0,0,deny,60,60,0,1,0,1,0
57558,445,0,0,drop,66,66,0,1,0,1,0
57557,445,0,0,drop,66,66,0,1,0,1,0
57256,445,0,0,drop,70,70,0,1,0,1,0
61559,23,0,0,deny,60,60,0,1,0,1,0
62155,445,0,0,drop,70,70,0,1,0,1,0
62147,445,0,0,drop,70,70,0,1,0,1,0
57554,445,0,0,drop,66,66,0,1,0,1,0
57251,445,0,0,drop,70,70,0,1,0,1,0
57550,445,0,0,drop,66,66,0,1,0,1,0
57546,445,0,0,drop,66,66,0,1,0,1,0
57541,445,0,0,drop,66,66,0,1,0,1,0
57542,445,0,0,drop,66,66,0,1,0,1,0
57547,445,0,0,drop,66,66,0,1,0,1,0
57545,445,0,0,drop,66,66,0,1,0,1,0
57539,445,0,0,drop,66,66,0,1,0,1,0
62140,445,0,0,drop,70,70,0,1,0,1,0
62137,445,0,0,drop,70,70,0,1,0,1,0
62136,445,0,0,drop,70,70,0,1,0,1,0
62133,445,0,0,drop,70,70,0,1,0,1,0
57238,445,0,0,drop,70,70,0,1,0,1,0
64022,53,20960,53,allow,194,99,95,2,1,1,1
62130,445,0,0,drop,70,70,0,1,0,1,0
62129,445,0,0,drop,70,70,0,1,0,1,0
57235,445,0,0,drop,70,70,0,1,0,1,0
57533,445,0,0,drop,66,66,0,1,0,1,0
62124,445,0,0,drop,70,70,0,1,0,1,0
57529,445,0,0,drop,66,66,0,1,0,1,0
57526,445,0,0,drop,66,66,0,1,0,1,0
57528,445,0,0,drop,66,66,0,1,0,1,0
57525,445,0,0,drop,66,66,0,1,0,1,0
57231,445,0,0,drop,70,70,0,1,0,1,0
57229,445,0,0,drop,70,70,0,1,0,1,0
57227,445,0,0,drop,70,70,0,1,0,1,0
62119,445,0,0,drop,70,70,0,1,0,1,0
62107,445,0,0,drop,70,70,0,1,0,1,0
62110,445,0,0,drop,70,70,0,1,0,1,0
57513,445,0,0,drop,66,66,0,1,0,1,0
57220,445,0,0,drop,70,70,0,1,0,1,0
57218,445,0,0,drop,70,70,0,1,0,1,0
57506,445,0,0,drop,66,66,0,1,0,1,0
62096,445,0,0,drop,70,70,0,1,0,1,0
57217,445,0,0,drop,70,70,0,1,0,1,0
57216,445,0,0,drop,70,70,0,1,0,1,0
57215,445,0,0,drop,70,70,0,1,0,1,0
57212,445,0,0,drop,70,70,0,1,0,1,0
57211,445,0,0,drop,70,70,0,1,0,1,0
57503,445,0,0,drop,66,66,0,1,0,1,0
57497,445,0,0,drop,66,66,0,1,0,1,0
57197,445,0,0,drop,70,70,0,1,0,1,0
57196,445,0,0,drop,70,70,0,1,0,1,0
57192,445,0,0,drop,70,70,0,1,0,1,0
57491,445,0,0,drop,66,66,0,1,0,1,0
57186,445,0,0,drop,70,70,0,1,0,1,0
57187,445,0,0,drop,70,70,0,1,0,1,0
62089,445,0,0,drop,70,70,0,1,0,1,0
57475,445,0,0,drop,66,66,0,1,0,1,0
57476,445,0,0,drop,66,66,0,1,0,1,0
57478,445,0,0,drop,66,66,0,1,0,1,0
57477,445,0,0,drop,66,66,0,1,0,1,0
57479,445,0,0,drop,66,66,0,1,0,1,0
57480,445,0,0,drop,66,66,0,1,0,1,0
57474,445,0,0,drop,66,66,0,1,0,1,0
57473,445,0,0,drop,66,66,0,1,0,1,0
57175,445,0,0,drop,70,70,0,1,0,1,0
63037,443,11934,443,allow,303,85,218,2,31,1,1
63038,53,49856,53,allow,303,85,218,2,31,1,1
50523,443,44131,443,allow,1389,868,521,12,25,6,6
65319,53,30506,53,allow,285,103,182,4,44,2,2
53052,443,55345,443,allow,214,140,74,4,15,3,1
50546,80,2878,80,allow,1990,812,1178,9,15,5,4
63045,443,61231,443,allow,510,164,346,2,30,1,1
63046,53,33586,53,allow,510,164,346,2,30,1,1
50521,80,1574,80,allow,454,262,192,8,25,5,3
49555,53,60187,53,allow,578,286,292,9,15,5,4
49655,80,18992,80,allow,1056,682,374,10,15,6,4
50524,443,21568,443,allow,1389,868,521,12,25,6,6
41247,80,52056,80,allow,234,234,0,4,12,4,0
63461,443,13278,443,allow,622,310,312,11,59,6,5
45019,53,52189,53,allow,168,78,90,2,30,1,1
57170,445,0,0,drop,70,70,0,1,0,1,0
62081,445,0,0,drop,70,70,0,1,0,1,0
62068,445,0,0,drop,70,70,0,1,0,1,0
57461,445,0,0,drop,66,66,0,1,0,1,0
57460,445,0,0,drop,66,66,0,1,0,1,0
57458,445,0,0,drop,66,66,0,1,0,1,0
57159,445,0,0,drop,70,70,0,1,0,1,0
57162,445,0,0,drop,70,70,0,1,0,1,0
57161,445,0,0,drop,70,70,0,1,0,1,0
57157,445,0,0,drop,70,70,0,1,0,1,0
62067,445,0,0,drop,70,70,0,1,0,1,0
57154,445,0,0,drop,70,70,0,1,0,1,0
36963,23,0,0,deny,60,60,0,1,0,1,0
62064,445,0,0,drop,70,70,0,1,0,1,0
62059,445,0,0,drop,70,70,0,1,0,1,0
62060,445,0,0,drop,70,70,0,1,0,1,0
62055,445,0,0,drop,70,70,0,1,0,1,0
57148,445,0,0,drop,70,70,0,1,0,1,0
57141,445,0,0,drop,70,70,0,1,0,1,0
57140,445,0,0,drop,70,70,0,1,0,1,0
57134,445,0,0,drop,70,70,0,1,0,1,0
64255,53,15083,53,allow,260,86,174,2,30,1,1
64516,53,21568,53,allow,215,94,121,2,30,1,1
48658,53,48919,53,allow,368,80,288,4,30,2,2
55421,53,63396,53,allow,168,78,90,2,30,1,1
65029,53,39227,53,allow,214,102,112,2,29,1,1
64020,53,46952,53,allow,302,118,184,2,29,1,1
60232,53,0,0,allow,202,86,116,2,29,1,1
65528,53,22092,53,allow,199,86,113,2,29,1,1
65108,53,46911,53,allow,195,94,101,2,29,1,1
59928,53,57258,53,allow,320,94,226,2,29,1,1
64537,53,43379,53,allow,251,102,149,2,30,1,1
65055,53,62687,53,allow,225,86,139,2,30,1,1
63050,53,33894,53,allow,384,166,218,2,30,1,1
65018,53,20967,53,allow,310,102,208,2,30,1,1
64734,53,19737,53,allow,383,90,293,4,43,2,2
63041,53,42776,53,allow,448,166,282,2,30,1,1
65276,53,33888,53,allow,226,86,140,2,30,1,1
63047,443,26730,443,allow,304,86,218,2,30,1,1
57432,66,52808,66,allow,70,70,0,1,5,1,0
60387,80,36861,80,allow,214,140,74,4,15,3,1
63048,53,53568,53,allow,304,86,218,2,30,1,1
64109,53,30318,53,allow,225,102,123,2,30,1,1
64004,53,17770,53,allow,247,94,153,2,30,1,1
56635,80,4559,80,allow,234,234,0,4,12,4,0
55974,80,55609,80,allow,613,539,74,7,15,6,1
63042,443,30142,443,allow,512,166,346,2,30,1,1
65319,53,38266,53,allow,285,103,182,4,43,2,2
53685,53,0,0,allow,547,97,450,4,40,2,2
53328,53,0,0,allow,232,77,155,2,32,1,1
65319,53,28841,53,allow,285,103,182,4,43,2,2
60386,80,35408,80,allow,214,140,74,4,15,3,1
65021,53,29449,53,allow,589,91,498,4,54,2,2
65365,53,10909,53,allow,196,102,94,2,29,1,1
49384,53,22527,53,allow,193,102,91,2,29,1,1
64483,53,53474,53,allow,168,86,82,2,29,1,1
64256,53,36499,53,allow,211,78,133,2,29,1,1
56738,53,53123,53,allow,242,110,132,2,29,1,1
64483,53,39103,53,allow,168,86,82,2,29,1,1
49385,53,9929,53,allow,843,285,558,8,56,4,4
49742,53,9539,53,allow,213,102,111,2,29,1,1
49208,53,8830,53,allow,216,94,122,2,29,1,1
64089,53,20449,53,allow,197,94,103,2,30,1,1
63049,443,56063,443,allow,384,166,218,2,30,1,1
57174,53,49148,53,allow,210,94,116,2,30,1,1
64483,53,3911,53,allow,168,86,82,2,30,1,1
65216,53,59898,53,allow,244,94,150,2,30,1,1
56891,53,21983,53,allow,200,94,106,2,30,1,1
39758,53,26339,53,allow,86,86,0,1,30,1,0
64753,53,4084,53,allow,287,102,185,2,30,1,1
60388,80,19317,80,allow,214,140,74,4,15,3,1
56350,53,30997,53,allow,287,102,185,2,30,1,1
63043,53,52366,53,allow,448,166,282,2,30,1,1
50028,53,16611,53,allow,210,102,108,2,30,1,1
63044,443,58831,443,allow,512,166,346,2,30,1,1
46286,443,2203,443,allow,1053,566,487,10,41,6,4
49476,53,2698,53,allow,200,94,106,2,30,1,1
63034,443,35751,443,allow,304,86,218,2,30,1,1
47010,53,59094,53,allow,294,94,200,2,30,1,1
63033,53,19877,53,allow,304,86,218,2,30,1,1
49977,53,37356,53,allow,212,94,118,2,30,1,1
63032,53,34881,53,allow,304,86,218,2,30,1,1
56702,53,49433,53,allow,168,78,90,2,30,1,1
57133,445,0,0,drop,70,70,0,1,0,1,0
57439,445,0,0,drop,66,66,0,1,0,1,0
62037,445,0,0,drop,70,70,0,1,0,1,0
57129,445,0,0,drop,70,70,0,1,0,1,0
57128,445,0,0,drop,70,70,0,1,0,1,0
57432,445,0,0,drop,66,66,0,1,0,1,0
57429,445,0,0,drop,66,66,0,1,0,1,0
37701,23,0,0,deny,60,60,0,1,0,1,0
62026,445,0,0,drop,70,70,0,1,0,1,0
48576,443,26108,443,allow,476,410,66,4,0,3,1
57123,445,0,0,drop,70,70,0,1,0,1,0
62018,445,0,0,drop,70,70,0,1,0,1,0
55174,53,1640,53,allow,774,101,673,2,0,1,1
57428,445,0,0,drop,66,66,0,1,0,1,0
57412,445,0,0,drop,66,66,0,1,0,1,0
57419,445,0,0,drop,66,66,0,1,0,1,0
57413,445,0,0,drop,66,66,0,1,0,1,0
57418,445,0,0,drop,66,66,0,1,0,1,0
57417,445,0,0,drop,66,66,0,1,0,1,0
57414,445,0,0,drop,66,66,0,1,0,1,0
57411,445,0,0,drop,66,66,0,1,0,1,0
62012,445,0,0,drop,70,70,0,1,0,1,0
62007,445,0,0,drop,70,70,0,1,0,1,0
62005,445,0,0,drop,70,70,0,1,0,1,0
62004,445,0,0,drop,70,70,0,1,0,1,0
63340,53,0,0,deny,84,84,0,1,0,1,0
57110,445,0,0,drop,70,70,0,1,0,1,0
57107,445,0,0,drop,70,70,0,1,0,1,0
62003,445,0,0,drop,70,70,0,1,0,1,0
62002,445,0,0,drop,70,70,0,1,0,1,0
61999,445,0,0,drop,70,70,0,1,0,1,0
57403,445,0,0,drop,66,66,0,1,0,1,0
61995,445,0,0,drop,70,70,0,1,0,1,0
57402,445,0,0,drop,66,66,0,1,0,1,0
57400,445,0,0,drop,66,66,0,1,0,1,0
57399,445,0,0,drop,66,66,0,1,0,1,0
57103,445,0,0,drop,70,70,0,1,0,1,0
57396,445,0,0,drop,66,66,0,1,0,1,0
57101,445,0,0,drop,70,70,0,1,0,1,0
57099,445,0,0,drop,70,70,0,1,0,1,0
61990,445,0,0,drop,70,70,0,1,0,1,0
61984,445,0,0,drop,70,70,0,1,0,1,0
61981,445,0,0,drop,70,70,0,1,0,1,0
60060,443,0,0,deny,1097,1097,0,1,0,1,0
57385,445,0,0,drop,66,66,0,1,0,1,0
57092,445,0,0,drop,70,70,0,1,0,1,0
57090,445,0,0,drop,70,70,0,1,0,1,0
57089,445,0,0,drop,70,70,0,1,0,1,0
57378,445,0,0,drop,66,66,0,1,0,1,0
57088,445,0,0,drop,70,70,0,1,0,1,0
57087,445,0,0,drop,70,70,0,1,0,1,0
57082,445,0,0,drop,70,70,0,1,0,1,0
57083,445,0,0,drop,70,70,0,1,0,1,0
57376,445,0,0,drop,66,66,0,1,0,1,0
57069,445,0,0,drop,70,70,0,1,0,1,0
57068,445,0,0,drop,70,70,0,1,0,1,0
57066,445,0,0,drop,70,70,0,1,0,1,0
50542,80,60343,80,allow,1607,970,637,8,16,5,3
59868,443,32881,443,allow,502,250,252,9,26,5,4
42473,80,36510,80,allow,1737,796,941,12,16,7,5
57058,445,0,0,drop,70,70,0,1,0,1,0
57059,445,0,0,drop,70,70,0,1,0,1,0
57369,445,0,0,drop,66,66,0,1,0,1,0
57361,445,0,0,drop,66,66,0,1,0,1,0
57047,445,0,0,drop,70,70,0,1,0,1,0
61960,445,0,0,drop,70,70,0,1,0,1,0
61956,445,0,0,drop,70,70,0,1,0,1,0
57347,445,0,0,drop,66,66,0,1,0,1,0
57352,445,0,0,drop,66,66,0,1,0,1,0
57349,445,0,0,drop,66,66,0,1,0,1,0
57350,445,0,0,drop,66,66,0,1,0,1,0
57353,445,0,0,drop,66,66,0,1,0,1,0
57348,445,0,0,drop,66,66,0,1,0,1,0
57346,445,0,0,drop,66,66,0,1,0,1,0
57345,445,0,0,drop,66,66,0,1,0,1,0
57042,445,0,0,drop,70,70,0,1,0,1,0
61953,445,0,0,drop,70,70,0,1,0,1,0
63039,443,48295,443,allow,448,166,282,2,29,1,1
63031,443,4313,443,allow,304,86,218,2,29,1,1
63036,53,45835,53,allow,304,86,218,2,29,1,1
40342,53,32234,53,allow,168,78,90,2,29,1,1
59865,443,51225,443,allow,502,250,252,9,26,5,4
54768,25,54768,25,allow,194,66,128,3,15,1,2
61571,53,17660,53,allow,211,78,133,2,30,1,1
64484,53,32900,53,allow,732,239,493,6,51,3,3
49221,80,26224,80,allow,214,140,74,4,15,3,1
65298,53,43096,53,allow,246,102,144,2,30,1,1
62453,53,64784,53,allow,441,162,279,6,32,3,3
36367,443,61564,443,allow,1209,709,500,14,26,8,6
64698,53,34866,53,allow,211,102,109,2,30,1,1
50012,53,31232,53,allow,209,102,107,2,30,1,1
65164,53,35312,53,allow,262,94,168,2,30,1,1
56995,53,19045,53,allow,196,94,102,2,30,1,1
63040,53,20975,53,allow,512,166,346,2,29,1,1
49839,53,59644,53,allow,258,110,148,2,29,1,1
63035,443,45890,443,allow,304,86,218,2,29,1,1
49230,53,36534,53,allow,351,94,257,2,30,1,1
56992,53,30426,53,allow,355,102,253,2,30,1,1
63995,53,52864,53,allow,212,94,118,2,30,1,1
49213,53,44755,53,allow,211,102,109,2,30,1,1
59595,80,6644,80,allow,1052,612,440,10,15,5,5
64925,53,10435,53,allow,338,110,228,2,30,1,1
59863,443,41870,443,allow,622,310,312,11,28,6,5
40175,80,8302,80,allow,130,70,60,2,15,1,1
49667,53,38974,53,allow,261,94,167,2,30,1,1
61949,445,0,0,drop,70,70,0,1,0,1,0
61939,445,0,0,drop,70,70,0,1,0,1,0
57034,445,0,0,drop,70,70,0,1,0,1,0
57031,445,0,0,drop,70,70,0,1,0,1,0
57032,445,0,0,drop,70,70,0,1,0,1,0
57029,445,0,0,drop,70,70,0,1,0,1,0
57026,445,0,0,drop,70,70,0,1,0,1,0
57333,445,0,0,drop,66,66,0,1,0,1,0
57331,445,0,0,drop,66,66,0,1,0,1,0
57330,445,0,0,drop,66,66,0,1,0,1,0
61937,445,0,0,drop,70,70,0,1,0,1,0
61935,445,0,0,drop,70,70,0,1,0,1,0
61927,445,0,0,drop,70,70,0,1,0,1,0
57020,445,0,0,drop,70,70,0,1,0,1,0
56463,17,0,0,deny,60,60,0,1,0,1,0
57013,445,0,0,drop,70,70,0,1,0,1,0
57010,445,0,0,drop,70,70,0,1,0,1,0
51163,23,0,0,deny,60,60,0,1,0,1,0
61916,445,0,0,drop,70,70,0,1,0,1,0
61918,445,0,0,drop,70,70,0,1,0,1,0
57007,445,0,0,drop,70,70,0,1,0,1,0
57005,445,0,0,drop,70,70,0,1,0,1,0
57001,445,0,0,drop,70,70,0,1,0,1,0
49293,22,0,0,deny,60,60,0,1,0,1,0
57310,445,0,0,drop,66,66,0,1,0,1,0
61908,445,0,0,drop,70,70,0,1,0,1,0
61907,445,0,0,drop,70,70,0,1,0,1,0
57000,445,0,0,drop,70,70,0,1,0,1,0
61681,23,0,0,deny,60,60,0,1,0,1,0
57305,445,0,0,drop,66,66,0,1,0,1,0
57302,445,0,0,drop,66,66,0,1,0,1,0
58884,23,0,0,deny,60,60,0,1,0,1,0
56995,445,0,0,drop,70,70,0,1,0,1,0
61897,445,0,0,drop,70,70,0,1,0,1,0
57298,445,0,0,drop,66,66,0,1,0,1,0
57287,445,0,0,drop,66,66,0,1,0,1,0
57292,445,0,0,drop,66,66,0,1,0,1,0
57281,445,0,0,drop,66,66,0,1,0,1,0
57284,445,0,0,drop,66,66,0,1,0,1,0
57280,445,0,0,drop,66,66,0,1,0,1,0
57285,445,0,0,drop,66,66,0,1,0,1,0
57279,445,0,0,drop,66,66,0,1,0,1,0
61884,445,0,0,drop,70,70,0,1,0,1,0
61880,445,0,0,drop,70,70,0,1,0,1,0
61879,445,0,0,drop,70,70,0,1,0,1,0
61876,445,0,0,drop,70,70,0,1,0,1,0
56982,445,0,0,drop,70,70,0,1,0,1,0
55022,23,0,0,deny,60,60,0,1,0,1,0
56979,445,0,0,drop,70,70,0,1,0,1,0
50783,23,0,0,deny,60,60,0,1,0,1,0
61875,445,0,0,drop,70,70,0,1,0,1,0
61872,445,0,0,drop,70,70,0,1,0,1,0
57277,445,0,0,drop,66,66,0,1,0,1,0
61867,445,0,0,drop,70,70,0,1,0,1,0
57273,445,0,0,drop,66,66,0,1,0,1,0
56975,445,0,0,drop,70,70,0,1,0,1,0
57272,445,0,0,drop,66,66,0,1,0,1,0
57271,445,0,0,drop,66,66,0,1,0,1,0
56973,445,0,0,drop,70,70,0,1,0,1,0
57268,445,0,0,drop,66,66,0,1,0,1,0
56971,445,0,0,drop,70,70,0,1,0,1,0
61862,445,0,0,drop,70,70,0,1,0,1,0
61855,445,0,0,drop,70,70,0,1,0,1,0
61858,445,0,0,drop,70,70,0,1,0,1,0
56964,445,0,0,drop,70,70,0,1,0,1,0
57258,445,0,0,drop,66,66,0,1,0,1,0
56962,445,0,0,drop,70,70,0,1,0,1,0
39351,23,0,0,deny,60,60,0,1,0,1,0
56961,445,0,0,drop,70,70,0,1,0,1,0
56960,445,0,0,drop,70,70,0,1,0,1,0
56959,445,0,0,drop,70,70,0,1,0,1,0
56957,445,0,0,drop,70,70,0,1,0,1,0
37390,80,53231,80,allow,78,78,0,1,5,1,0
50660,80,5489,80,allow,875,327,548,9,15,5,4
60174,80,16526,80,allow,1564,990,574,15,24,8,7
42388,161,0,0,allow,109,109,0,2,35,2,0
50814,53,0,0,allow,82,82,0,1,30,1,0
57275,53,57275,53,allow,217,86,131,2,30,1,1
55594,53,15652,53,allow,202,83,119,2,31,1,1
56954,445,0,0,drop,70,70,0,1,0,1,0
57250,445,0,0,drop,66,66,0,1,0,1,0
61839,445,0,0,drop,70,70,0,1,0,1,0
54000,53,0,0,allow,202,86,116,2,30,1,1
57247,445,0,0,drop,66,66,0,1,0,1,0
56941,445,0,0,drop,70,70,0,1,0,1,0
56940,445,0,0,drop,70,70,0,1,0,1,0
56938,445,0,0,drop,70,70,0,1,0,1,0
56930,445,0,0,drop,70,70,0,1,0,1,0
56931,445,0,0,drop,70,70,0,1,0,1,0
57240,445,0,0,drop,66,66,0,1,0,1,0
57235,445,0,0,drop,66,66,0,1,0,1,0
56919,445,0,0,drop,70,70,0,1,0,1,0
61830,445,0,0,drop,70,70,0,1,0,1,0
61828,445,0,0,drop,70,70,0,1,0,1,0
57222,445,0,0,drop,66,66,0,1,0,1,0
57217,445,0,0,drop,66,66,0,1,0,1,0
57221,445,0,0,drop,66,66,0,1,0,1,0
57223,445,0,0,drop,66,66,0,1,0,1,0
57225,445,0,0,drop,66,66,0,1,0,1,0
57220,445,0,0,drop,66,66,0,1,0,1,0
57218,445,0,0,drop,66,66,0,1,0,1,0
57224,445,0,0,drop,66,66,0,1,0,1,0
56915,445,0,0,drop,70,70,0,1,0,1,0
56906,445,0,0,drop,70,70,0,1,0,1,0
56904,445,0,0,drop,70,70,0,1,0,1,0
56903,445,0,0,drop,70,70,0,1,0,1,0
56901,445,0,0,drop,70,70,0,1,0,1,0
55747,53,47798,53,allow,199,94,105,2,29,1,1
58058,53,63439,53,allow,168,78,90,2,29,1,1
37780,443,60477,443,allow,134,60,74,3,5,2,1
49937,80,61073,80,allow,1130,613,517,11,15,6,5
52925,53,48232,53,allow,168,78,90,2,29,1,1
56634,80,24022,80,allow,234,234,0,4,12,4,0
54828,443,1359,443,allow,150,150,0,1,5,1,0
49943,53,23345,53,allow,596,90,506,4,59,2,2
49875,53,45365,53,allow,445,94,351,2,30,1,1
50089,443,20398,443,allow,292,172,120,4,15,2,2
49294,53,7678,53,allow,287,94,193,2,30,1,1
64505,53,32135,53,allow,214,102,112,2,30,1,1
53375,53,19528,53,allow,298,86,212,2,30,1,1
55894,53,40691,53,allow,216,102,114,2,30,1,1
65169,53,4248,53,allow,211,102,109,2,30,1,1
55161,53,36813,53,allow,197,94,103,2,30,1,1
50517,80,5050,80,allow,502,256,246,9,25,5,4
49940,80,46739,80,allow,1130,613,517,11,15,6,5
56254,80,61838,80,allow,1196,682,514,12,15,6,6
57731,53,26408,53,allow,237,86,151,2,30,1,1
65278,53,33473,53,allow,403,91,312,4,34,2,2
38369,443,64342,443,allow,434,226,208,7,28,4,3
58547,53,0,0,allow,86,86,0,1,29,1,0
50817,53,0,0,allow,182,73,109,2,30,1,1
61049,53,17729,53,allow,525,150,375,6,33,3,3
50516,80,41134,80,allow,502,256,246,9,25,5,4
50512,80,4579,80,allow,318,192,126,6,25,4,2
54000,53,38105,53,allow,294,86,208,2,30,1,1
64817,53,59265,53,allow,199,94,105,2,29,1,1
58427,53,30619,53,allow,197,94,103,2,30,1,1
54978,53,3492,53,allow,198,94,104,2,30,1,1
49976,53,44388,53,allow,245,110,135,2,30,1,1
49932,53,19133,53,allow,237,86,151,2,30,1,1
51091,53,0,0,allow,325,75,250,2,30,1,1
56224,53,54618,53,allow,221,102,119,2,30,1,1
56972,53,60729,53,allow,301,126,175,2,30,1,1
65145,53,64400,53,allow,338,110,228,2,30,1,1
50510,80,5594,80,allow,378,192,186,7,25,4,3
49597,53,64001,53,allow,216,102,114,2,30,1,1
64975,53,43514,53,allow,198,94,104,2,30,1,1
50513,80,33823,80,allow,318,192,126,6,25,4,2
49939,80,14388,80,allow,1130,613,517,11,15,6,5
49938,80,5232,80,allow,1130,613,517,11,15,6,5
50511,80,14463,80,allow,318,192,126,6,25,4,2
36942,53,36942,53,allow,197,90,107,2,30,1,1
54846,53,32938,53,allow,168,78,90,2,30,1,1
64888,53,40321,53,allow,767,102,665,2,30,1,1
61700,53,61700,53,allow,221,90,131,2,30,1,1
58439,443,16787,443,allow,232,172,60,3,5,2,1
64243,53,51060,53,allow,258,102,156,2,30,1,1
55732,53,56337,53,allow,280,126,154,2,30,1,1
60597,53,0,0,allow,344,94,250,2,30,1,1
64784,53,44632,53,allow,195,102,93,2,30,1,1
56901,53,16725,53,allow,264,94,170,2,31,1,1
64558,53,57812,53,allow,321,102,219,2,31,1,1
37570,443,52731,443,allow,130,64,66,3,6,2,1
61818,445,0,0,drop,70,70,0,1,0,1,0
61813,445,0,0,drop,70,70,0,1,0,1,0
61811,445,0,0,drop,70,70,0,1,0,1,0
56898,445,0,0,drop,70,70,0,1,0,1,0
57205,445,0,0,drop,66,66,0,1,0,1,0
57203,445,0,0,drop,66,66,0,1,0,1,0
57202,445,0,0,drop,66,66,0,1,0,1,0
61810,445,0,0,drop,70,70,0,1,0,1,0
61808,445,0,0,drop,70,70,0,1,0,1,0
56892,445,0,0,drop,70,70,0,1,0,1,0
61803,445,0,0,drop,70,70,0,1,0,1,0
61800,445,0,0,drop,70,70,0,1,0,1,0
61802,445,0,0,drop,70,70,0,1,0,1,0
56885,445,0,0,drop,70,70,0,1,0,1,0
56882,445,0,0,drop,70,70,0,1,0,1,0
54489,53,0,0,allow,232,77,155,2,2,1,1
61787,445,0,0,drop,70,70,0,1,0,1,0
56879,445,0,0,drop,70,70,0,1,0,1,0
56877,445,0,0,drop,70,70,0,1,0,1,0
56873,445,0,0,drop,70,70,0,1,0,1,0
56872,445,0,0,drop,70,70,0,1,0,1,0
57182,445,0,0,drop,66,66,0,1,0,1,0
61781,445,0,0,drop,70,70,0,1,0,1,0
56867,445,0,0,drop,70,70,0,1,0,1,0
57176,445,0,0,drop,66,66,0,1,0,1,0
57173,445,0,0,drop,66,66,0,1,0,1,0
61769,445,0,0,drop,70,70,0,1,0,1,0
61761,445,0,0,drop,70,70,0,1,0,1,0
61760,445,0,0,drop,70,70,0,1,0,1,0
57169,445,0,0,drop,66,66,0,1,0,1,0
61755,445,0,0,drop,70,70,0,1,0,1,0
56854,445,0,0,drop,70,70,0,1,0,1,0
61751,445,0,0,drop,70,70,0,1,0,1,0
61750,445,0,0,drop,70,70,0,1,0,1,0
61748,445,0,0,drop,70,70,0,1,0,1,0
57162,445,0,0,drop,66,66,0,1,0,1,0
57158,445,0,0,drop,66,66,0,1,0,1,0
57157,445,0,0,drop,66,66,0,1,0,1,0
57156,445,0,0,drop,66,66,0,1,0,1,0
56851,445,0,0,drop,70,70,0,1,0,1,0
57153,445,0,0,drop,66,66,0,1,0,1,0
57152,445,0,0,drop,66,66,0,1,0,1,0
57151,445,0,0,drop,66,66,0,1,0,1,0
61743,445,0,0,drop,70,70,0,1,0,1,0
61742,445,0,0,drop,70,70,0,1,0,1,0
61741,445,0,0,drop,70,70,0,1,0,1,0
56846,445,0,0,drop,70,70,0,1,0,1,0
57148,445,0,0,drop,66,66,0,1,0,1,0
61739,445,0,0,drop,70,70,0,1,0,1,0
56845,445,0,0,drop,70,70,0,1,0,1,0
57146,445,0,0,drop,66,66,0,1,0,1,0
56843,445,0,0,drop,70,70,0,1,0,1,0
57142,445,0,0,drop,66,66,0,1,0,1,0
57143,445,0,0,drop,66,66,0,1,0,1,0
57140,445,0,0,drop,66,66,0,1,0,1,0
61738,445,0,0,drop,70,70,0,1,0,1,0
62325,443,62325,443,allow,1210,637,573,14,51,7,7
55177,80,55177,80,allow,374,240,134,7,15,5,2
48837,53,7815,53,allow,198,93,105,2,30,1,1
62328,443,62328,443,allow,1210,637,573,14,51,7,7
43309,80,55504,80,allow,805,665,140,6,32,4,2
55176,80,55176,80,allow,374,240,134,7,15,5,2
49277,80,55324,80,allow,254,128,126,5,16,3,2
55178,80,55178,80,allow,374,240,134,7,15,5,2
62329,443,62329,443,allow,1210,637,573,14,51,7,7
57596,80,43063,80,allow,1231,726,505,10,18,6,4
62327,443,62327,443,allow,1210,637,573,14,51,7,7
35894,53,14493,53,allow,198,93,105,2,30,1,1
56527,53,0,0,allow,206,83,123,2,31,1,1
61723,445,0,0,drop,70,70,0,1,0,1,0
56836,445,0,0,drop,70,70,0,1,0,1,0
56834,445,0,0,drop,70,70,0,1,0,1,0
54099,80,63919,80,allow,214,140,74,4,15,3,1
57129,445,0,0,drop,66,66,0,1,0,1,0
56833,445,0,0,drop,70,70,0,1,0,1,0
56832,445,0,0,drop,70,70,0,1,0,1,0
56831,445,0,0,drop,70,70,0,1,0,1,0
56825,445,0,0,drop,70,70,0,1,0,1,0
56828,445,0,0,drop,70,70,0,1,0,1,0
57122,445,0,0,drop,66,66,0,1,0,1,0
56811,445,0,0,drop,70,70,0,1,0,1,0
56810,445,0,0,drop,70,70,0,1,0,1,0
56806,445,0,0,drop,70,70,0,1,0,1,0
56800,445,0,0,drop,70,70,0,1,0,1,0
56801,445,0,0,drop,70,70,0,1,0,1,0
57120,445,0,0,drop,66,66,0,1,0,1,0
41282,53,19391,53,allow,168,78,90,2,30,1,1
56744,53,53021,53,allow,274,110,164,2,30,1,1
49951,53,52674,53,allow,525,110,415,2,30,1,1
64784,53,28832,53,allow,195,102,93,2,29,1,1
63846,80,10554,80,allow,314,192,122,6,15,4,2
51465,443,37534,443,allow,318,70,248,5,17,1,4
51443,443,10966,443,allow,1048,1048,0,9,16,9,0
55179,80,55179,80,allow,374,240,134,7,15,5,2
65173,53,61112,53,allow,508,186,322,6,51,3,3
49527,53,42526,53,allow,268,94,174,2,29,1,1
62326,443,62326,443,allow,1210,637,573,14,51,7,7
51461,443,45147,443,allow,318,70,248,5,17,1,4
55733,53,46441,53,allow,463,128,335,4,41,2,2
64772,53,64772,53,allow,241,98,143,2,30,1,1
65232,53,42020,53,allow,311,94,217,2,30,1,1
55411,53,35188,53,allow,200,94,106,2,30,1,1
65052,53,65052,53,allow,240,98,142,2,30,1,1
56076,53,58265,53,allow,311,94,217,2,30,1,1
49981,53,18517,53,allow,200,94,106,2,30,1,1
64272,53,63528,53,allow,626,190,436,6,60,3,3
57167,53,41895,53,allow,195,102,93,2,30,1,1
56659,53,34690,53,allow,199,94,105,2,30,1,1
57150,53,63337,53,allow,286,97,189,4,47,2,2
41685,161,0,0,allow,109,109,0,2,34,2,0
55174,80,55174,80,allow,374,240,134,7,15,5,2
49490,53,6765,53,allow,364,92,272,4,38,2,2
37462,53,30454,53,allow,207,86,121,2,30,1,1
56306,53,41144,53,allow,228,94,134,2,30,1,1
60597,53,0,0,allow,344,94,250,2,29,1,1
64944,53,42030,53,allow,228,94,134,2,30,1,1
50975,53,27923,53,allow,199,94,105,2,30,1,1
55638,53,61828,53,allow,184,86,98,2,30,1,1
57167,53,27604,53,allow,195,102,93,2,30,1,1
46385,53,10375,53,allow,199,94,105,2,30,1,1
52883,53,22567,53,allow,339,94,245,2,30,1,1
47037,80,10159,80,allow,613,539,74,7,15,6,1
58536,53,40631,53,allow,522,162,360,6,64,3,3
55595,443,57179,443,allow,448,166,282,2,30,1,1
54685,53,54685,53,allow,832,106,726,2,30,1,1
64335,53,51507,53,allow,293,95,198,4,46,2,2
64222,53,1206,53,allow,264,94,170,2,30,1,1
61569,53,2254,53,allow,211,78,133,2,30,1,1
55829,53,23534,53,allow,168,78,90,2,30,1,1
53260,53,10585,53,allow,199,94,105,2,30,1,1
57008,53,37986,53,allow,255,110,145,2,30,1,1
49737,53,34228,53,allow,184,86,98,2,31,1,1
55312,53,28336,53,allow,195,102,93,2,31,1,1
57111,445,0,0,drop,66,66,0,1,0,1,0
57109,445,0,0,drop,66,66,0,1,0,1,0
56789,445,0,0,drop,70,70,0,1,0,1,0
61701,445,0,0,drop,70,70,0,1,0,1,0
61702,445,0,0,drop,70,70,0,1,0,1,0
61700,445,0,0,drop,70,70,0,1,0,1,0
57092,445,0,0,drop,66,66,0,1,0,1,0
57090,445,0,0,drop,66,66,0,1,0,1,0
57097,445,0,0,drop,66,66,0,1,0,1,0
57094,445,0,0,drop,66,66,0,1,0,1,0
57095,445,0,0,drop,66,66,0,1,0,1,0
57096,445,0,0,drop,66,66,0,1,0,1,0
57093,445,0,0,drop,66,66,0,1,0,1,0
57091,445,0,0,drop,66,66,0,1,0,1,0
56785,445,0,0,drop,70,70,0,1,0,1,0
56773,445,0,0,drop,70,70,0,1,0,1,0
56775,445,0,0,drop,70,70,0,1,0,1,0
56776,445,0,0,drop,70,70,0,1,0,1,0
56772,445,0,0,drop,70,70,0,1,0,1,0
56768,445,0,0,drop,70,70,0,1,0,1,0
61696,445,0,0,drop,70,70,0,1,0,1,0
61691,445,0,0,drop,70,70,0,1,0,1,0
61683,445,0,0,drop,70,70,0,1,0,1,0
42379,443,23985,443,allow,499,425,74,4,0,3,1
57074,445,0,0,drop,66,66,0,1,0,1,0
57076,445,0,0,drop,66,66,0,1,0,1,0
57075,445,0,0,drop,66,66,0,1,0,1,0
61682,445,0,0,drop,70,70,0,1,0,1,0
56763,445,0,0,drop,70,70,0,1,0,1,0
61679,445,0,0,drop,70,70,0,1,0,1,0
61669,445,0,0,drop,70,70,0,1,0,1,0
61672,445,0,0,drop,70,70,0,1,0,1,0
61671,445,0,0,drop,70,70,0,1,0,1,0
56755,445,0,0,drop,70,70,0,1,0,1,0
56754,445,0,0,drop,70,70,0,1,0,1,0
56748,445,0,0,drop,70,70,0,1,0,1,0
56747,445,0,0,drop,70,70,0,1,0,1,0
56743,445,0,0,drop,70,70,0,1,0,1,0
56742,445,0,0,drop,70,70,0,1,0,1,0
57054,445,0,0,drop,66,66,0,1,0,1,0
61653,445,0,0,drop,70,70,0,1,0,1,0
61652,445,0,0,drop,70,70,0,1,0,1,0
56737,445,0,0,drop,70,70,0,1,0,1,0
57049,445,0,0,drop,66,66,0,1,0,1,0
57045,445,0,0,drop,66,66,0,1,0,1,0
55394,123,0,0,deny,234,234,0,1,0,1,0
61638,445,0,0,drop,70,70,0,1,0,1,0
61637,445,0,0,drop,70,70,0,1,0,1,0
57044,445,0,0,drop,66,66,0,1,0,1,0
56724,445,0,0,drop,70,70,0,1,0,1,0
61626,445,0,0,drop,70,70,0,1,0,1,0
61624,445,0,0,drop,70,70,0,1,0,1,0
61622,445,0,0,drop,70,70,0,1,0,1,0
61620,445,0,0,drop,70,70,0,1,0,1,0
56721,445,0,0,drop,70,70,0,1,0,1,0
57034,445,0,0,drop,66,66,0,1,0,1,0
57033,445,0,0,drop,66,66,0,1,0,1,0
57030,445,0,0,drop,66,66,0,1,0,1,0
57027,445,0,0,drop,66,66,0,1,0,1,0
57026,445,0,0,drop,66,66,0,1,0,1,0
57025,445,0,0,drop,66,66,0,1,0,1,0
57023,445,0,0,drop,66,66,0,1,0,1,0
55312,53,10081,53,allow,190,97,93,2,30,1,1
60113,443,5252,443,allow,704,280,424,11,19,5,6
52829,80,23872,80,allow,2078,726,1352,10,15,5,5
37561,80,40884,80,allow,1630,918,712,12,16,7,5
47471,80,60446,80,allow,1114,534,580,12,16,7,5
41151,80,58286,80,allow,1711,786,925,12,16,7,5
40909,443,25631,443,allow,1062,724,338,16,41,11,5
56717,445,0,0,drop,70,70,0,1,0,1,0
56715,445,0,0,drop,70,70,0,1,0,1,0
61619,445,0,0,drop,70,70,0,1,0,1,0
61616,445,0,0,drop,70,70,0,1,0,1,0
61614,445,0,0,drop,70,70,0,1,0,1,0
57020,445,0,0,drop,66,66,0,1,0,1,0
61611,445,0,0,drop,70,70,0,1,0,1,0
56713,445,0,0,drop,70,70,0,1,0,1,0
57017,445,0,0,drop,66,66,0,1,0,1,0
57016,445,0,0,drop,66,66,0,1,0,1,0
52281,161,0,0,allow,550,550,0,6,35,6,0
50460,443,12819,443,allow,1346,918,428,10,31,6,4
53912,443,35610,443,allow,1346,918,428,10,33,6,4
47600,53,23679,53,allow,168,78,90,2,29,1,1
42587,53,63043,53,allow,199,94,105,2,30,1,1
46409,80,63158,80,allow,1053,613,440,10,15,5,5
56970,53,57331,53,allow,428,103,325,4,34,2,2
64900,53,36772,53,allow,314,102,212,2,29,1,1
56081,53,45307,53,allow,237,94,143,2,29,1,1
56314,53,21778,53,allow,211,102,109,2,29,1,1
61568,53,62912,53,allow,260,86,174,2,29,1,1
37611,53,57023,53,allow,199,94,105,2,30,1,1
57298,53,55060,53,allow,323,110,213,2,30,1,1
49663,53,0,0,allow,86,86,0,1,30,1,0
56100,53,62385,53,allow,211,102,109,2,30,1,1
49424,53,53979,53,allow,228,110,118,2,30,1,1
43391,80,44561,80,allow,1560,684,876,10,15,5,5
37893,53,0,0,allow,86,86,0,1,30,1,0
64573,53,28615,53,allow,380,110,270,2,30,1,1
64566,53,50358,53,allow,347,107,240,4,42,2,2
50448,443,19311,443,allow,1346,918,428,10,35,6,4
60425,80,53766,80,allow,186,64,122,4,28,2,2
41914,123,34175,123,allow,184,94,90,2,30,1,1
49540,53,16812,53,allow,279,94,185,2,30,1,1
43680,53,64871,53,allow,271,102,169,2,30,1,1
53911,443,57422,443,allow,1346,918,428,10,33,6,4
60427,80,8033,80,allow,186,64,122,4,28,2,2
56633,80,19210,80,allow,234,234,0,4,12,4,0
50016,53,35137,53,allow,275,94,181,2,29,1,1
55312,53,37351,53,allow,195,102,93,2,29,1,1
55713,53,11593,53,allow,308,94,214,2,30,1,1
57414,53,33094,53,allow,214,102,112,2,29,1,1
55773,53,51846,53,allow,102,102,0,1,60,1,0
65406,53,1627,53,allow,102,102,0,1,60,1,0
55648,80,53307,80,allow,70,70,0,2,8,2,0
60583,443,60583,443,allow,1315,786,529,12,36,7,5
49128,53,21318,53,allow,199,94,105,2,30,1,1
58890,53,58890,53,allow,198,90,108,2,30,1,1
36851,53,52640,53,allow,404,261,143,3,30,2,1
55281,53,41810,53,allow,236,94,142,2,30,1,1
57015,53,23440,53,allow,363,102,261,2,30,1,1
55887,53,35825,53,allow,339,98,241,4,47,2,2
64265,53,25534,53,allow,550,133,417,4,47,2,2
55470,53,60625,53,allow,310,94,216,2,30,1,1
56135,53,30728,53,allow,258,118,140,2,30,1,1
64564,53,49143,53,allow,273,94,179,2,30,1,1
44871,53,64533,53,allow,164,78,86,2,31,1,1
49911,53,3623,53,allow,200,94,106,2,30,1,1
55144,53,47771,53,allow,209,102,107,2,30,1,1
55312,53,24613,53,allow,195,102,93,2,30,1,1
55105,53,24892,53,allow,194,94,100,2,30,1,1
56845,53,65473,53,allow,233,102,131,2,30,1,1
49278,53,60636,53,allow,200,94,106,2,30,1,1
65036,53,31003,53,allow,209,94,115,2,30,1,1
57014,445,0,0,drop,66,66,0,1,0,1,0
57012,445,0,0,drop,66,66,0,1,0,1,0
56706,445,0,0,drop,70,70,0,1,0,1,0
61610,445,0,0,drop,70,70,0,1,0,1,0
61599,445,0,0,drop,70,70,0,1,0,1,0
61593,445,0,0,drop,70,70,0,1,0,1,0
56704,445,0,0,drop,70,70,0,1,0,1,0
56703,445,0,0,drop,70,70,0,1,0,1,0
57002,445,0,0,drop,66,66,0,1,0,1,0
56702,445,0,0,drop,70,70,0,1,0,1,0
56701,445,0,0,drop,70,70,0,1,0,1,0
56699,445,0,0,drop,70,70,0,1,0,1,0
56697,445,0,0,drop,70,70,0,1,0,1,0
52318,17,0,0,deny,60,60,0,1,0,1,0
56994,445,0,0,drop,66,66,0,1,0,1,0
56683,445,0,0,drop,70,70,0,1,0,1,0
56682,445,0,0,drop,70,70,0,1,0,1,0
61585,445,0,0,drop,70,70,0,1,0,1,0
56676,445,0,0,drop,70,70,0,1,0,1,0
56672,445,0,0,drop,70,70,0,1,0,1,0
56673,445,0,0,drop,70,70,0,1,0,1,0
56991,445,0,0,drop,66,66,0,1,0,1,0
56983,445,0,0,drop,66,66,0,1,0,1,0
56980,445,0,0,drop,66,66,0,1,0,1,0
56661,445,0,0,drop,70,70,0,1,0,1,0
61574,445,0,0,drop,70,70,0,1,0,1,0
56656,445,0,0,drop,70,70,0,1,0,1,0
56969,445,0,0,drop,66,66,0,1,0,1,0
56961,445,0,0,drop,66,66,0,1,0,1,0
56965,445,0,0,drop,66,66,0,1,0,1,0
56967,445,0,0,drop,66,66,0,1,0,1,0
56968,445,0,0,drop,66,66,0,1,0,1,0
56963,445,0,0,drop,66,66,0,1,0,1,0
56962,445,0,0,drop,66,66,0,1,0,1,0
56964,445,0,0,drop,66,66,0,1,0,1,0
56648,445,0,0,drop,70,70,0,1,0,1,0
56645,445,0,0,drop,70,70,0,1,0,1,0
56646,445,0,0,drop,70,70,0,1,0,1,0
56643,445,0,0,drop,70,70,0,1,0,1,0
56640,445,0,0,drop,70,70,0,1,0,1,0
61569,445,0,0,drop,70,70,0,1,0,1,0
61555,445,0,0,drop,70,70,0,1,0,1,0
56948,445,0,0,drop,66,66,0,1,0,1,0
56946,445,0,0,drop,66,66,0,1,0,1,0
56947,445,0,0,drop,66,66,0,1,0,1,0
56635,445,0,0,drop,70,70,0,1,0,1,0
61554,445,0,0,drop,70,70,0,1,0,1,0
61551,445,0,0,drop,70,70,0,1,0,1,0
61550,445,0,0,drop,70,70,0,1,0,1,0
61548,445,0,0,drop,70,70,0,1,0,1,0
61543,445,0,0,drop,70,70,0,1,0,1,0
56627,445,0,0,drop,70,70,0,1,0,1,0
56624,445,0,0,drop,70,70,0,1,0,1,0
56619,445,0,0,drop,70,70,0,1,0,1,0
56618,445,0,0,drop,70,70,0,1,0,1,0
61532,445,0,0,drop,70,70,0,1,0,1,0
56614,445,0,0,drop,70,70,0,1,0,1,0
56613,445,0,0,drop,70,70,0,1,0,1,0
56925,445,0,0,drop,66,66,0,1,0,1,0
61524,445,0,0,drop,70,70,0,1,0,1,0
56608,445,0,0,drop,70,70,0,1,0,1,0
56919,445,0,0,drop,66,66,0,1,0,1,0
56916,445,0,0,drop,66,66,0,1,0,1,0
61514,445,0,0,drop,70,70,0,1,0,1,0
47396,23,0,0,deny,60,60,0,1,0,1,0
48440,53,22120,53,allow,198,93,105,2,30,1,1
61591,80,1732,80,allow,124,64,60,2,16,1,1
56330,53,24669,53,allow,711,87,624,2,30,1,1
58496,53,58496,53,allow,204,92,112,2,30,1,1
52261,53,8647,53,allow,578,286,292,9,15,5,4
61509,445,0,0,drop,70,70,0,1,0,1,0
56914,445,0,0,drop,66,66,0,1,0,1,0
56595,445,0,0,drop,70,70,0,1,0,1,0
40100,17,0,0,deny,60,60,0,1,0,1,0
61499,445,0,0,drop,70,70,0,1,0,1,0
56592,445,0,0,drop,70,70,0,1,0,1,0
49254,53,34045,53,allow,214,102,112,2,30,1,1
65297,53,52505,53,allow,241,118,123,2,30,1,1
61496,445,0,0,drop,70,70,0,1,0,1,0
61494,445,0,0,drop,70,70,0,1,0,1,0
61492,445,0,0,drop,70,70,0,1,0,1,0
56905,445,0,0,drop,66,66,0,1,0,1,0
56900,445,0,0,drop,66,66,0,1,0,1,0
56901,445,0,0,drop,66,66,0,1,0,1,0
56899,445,0,0,drop,66,66,0,1,0,1,0
56897,445,0,0,drop,66,66,0,1,0,1,0
56896,445,0,0,drop,66,66,0,1,0,1,0
56895,445,0,0,drop,66,66,0,1,0,1,0
56587,445,0,0,drop,70,70,0,1,0,1,0
56586,445,0,0,drop,70,70,0,1,0,1,0
56584,445,0,0,drop,70,70,0,1,0,1,0
61491,445,0,0,drop,70,70,0,1,0,1,0
61488,445,0,0,drop,70,70,0,1,0,1,0
64208,53,37921,53,allow,194,94,100,2,29,1,1
56983,53,62235,53,allow,221,94,127,2,29,1,1
52327,53,21249,53,allow,224,94,130,2,29,1,1
49790,53,34832,53,allow,195,102,93,2,30,1,1
49917,53,46665,53,allow,168,78,90,2,29,1,1
40808,53,41572,53,allow,168,78,90,2,29,1,1
57048,53,62627,53,allow,512,95,417,4,34,2,2
39488,53,45099,53,allow,199,94,105,2,29,1,1
64330,53,63113,53,allow,200,94,106,2,29,1,1
64347,53,35603,53,allow,321,109,212,4,47,2,2
46965,53,4424,53,allow,199,94,105,2,30,1,1
56164,53,3250,53,allow,226,110,116,2,30,1,1
39716,53,15462,53,allow,86,86,0,1,30,1,0
55410,80,63972,80,allow,1250,472,778,13,46,3,10
41472,53,41472,53,allow,218,90,128,2,30,1,1
56004,53,16480,53,allow,177,94,83,2,30,1,1
56004,53,53891,53,allow,177,94,83,2,30,1,1
65236,53,36812,53,allow,215,102,113,2,30,1,1
57073,53,17930,53,allow,197,102,95,2,35,1,1
64709,53,12288,53,allow,229,110,119,2,30,1,1
53719,443,48486,443,allow,70,70,0,2,8,2,0
64683,53,5338,53,allow,376,95,281,4,36,2,2
53444,443,53444,443,allow,960,539,421,9,30,5,4
53445,443,53445,443,allow,960,539,421,9,30,5,4
49668,53,59883,53,allow,200,94,106,2,29,1,1
42089,53,62601,53,allow,199,94,105,2,29,1,1
57600,53,41878,53,allow,168,78,90,2,30,1,1
54262,53,54262,53,allow,198,90,108,2,30,1,1
44949,53,44949,53,allow,198,90,108,2,30,1,1
57360,53,29113,53,allow,231,110,121,2,30,1,1
57139,53,26096,53,allow,181,86,95,2,30,1,1
64864,53,28778,53,allow,275,126,149,2,30,1,1
65425,53,4149,53,allow,402,142,260,2,30,1,1
42184,53,42184,53,allow,334,226,108,3,30,2,1
53447,443,53447,443,allow,960,539,421,9,30,5,4
65374,53,60025,53,allow,261,102,159,2,30,1,1
59101,53,46129,53,allow,195,94,101,2,30,1,1
53446,443,53446,443,allow,960,539,421,9,30,5,4
56358,80,8330,80,allow,1569,1077,492,11,30,6,5
56952,53,53652,53,allow,487,136,351,4,46,2,2
61838,53,61838,53,allow,216,90,126,2,30,1,1
65270,53,38040,53,allow,226,110,116,2,30,1,1
49276,80,4660,80,allow,254,128,126,5,16,3,2
46555,53,62486,53,allow,168,78,90,2,30,1,1
61484,445,0,0,drop,70,70,0,1,0,1,0
56893,445,0,0,drop,66,66,0,1,0,1,0
61483,445,0,0,drop,70,70,0,1,0,1,0
56888,445,0,0,drop,66,66,0,1,0,1,0
56885,445,0,0,drop,66,66,0,1,0,1,0
56887,445,0,0,drop,66,66,0,1,0,1,0
56883,445,0,0,drop,66,66,0,1,0,1,0
56577,445,0,0,drop,70,70,0,1,0,1,0
56575,445,0,0,drop,70,70,0,1,0,1,0
61478,445,0,0,drop,70,70,0,1,0,1,0
61467,445,0,0,drop,70,70,0,1,0,1,0
61465,445,0,0,drop,70,70,0,1,0,1,0
56574,445,0,0,drop,70,70,0,1,0,1,0
56573,445,0,0,drop,70,70,0,1,0,1,0
56572,445,0,0,drop,70,70,0,1,0,1,0
56568,445,0,0,drop,70,70,0,1,0,1,0
56569,445,0,0,drop,70,70,0,1,0,1,0
56872,445,0,0,drop,66,66,0,1,0,1,0
56554,445,0,0,drop,70,70,0,1,0,1,0
56552,445,0,0,drop,70,70,0,1,0,1,0
56547,445,0,0,drop,70,70,0,1,0,1,0
56543,445,0,0,drop,70,70,0,1,0,1,0
56544,445,0,0,drop,70,70,0,1,0,1,0
56865,445,0,0,drop,66,66,0,1,0,1,0
56862,445,0,0,drop,66,66,0,1,0,1,0
56532,445,0,0,drop,70,70,0,1,0,1,0
56855,445,0,0,drop,66,66,0,1,0,1,0
56846,445,0,0,drop,66,66,0,1,0,1,0
56528,445,0,0,drop,70,70,0,1,0,1,0
61447,445,0,0,drop,70,70,0,1,0,1,0
61444,445,0,0,drop,70,70,0,1,0,1,0
61443,445,0,0,drop,70,70,0,1,0,1,0
56840,445,0,0,drop,66,66,0,1,0,1,0
56838,445,0,0,drop,66,66,0,1,0,1,0
56839,445,0,0,drop,66,66,0,1,0,1,0
56835,445,0,0,drop,66,66,0,1,0,1,0
56834,445,0,0,drop,66,66,0,1,0,1,0
56836,445,0,0,drop,66,66,0,1,0,1,0
56837,445,0,0,drop,66,66,0,1,0,1,0
56832,445,0,0,drop,66,66,0,1,0,1,0
56519,445,0,0,drop,70,70,0,1,0,1,0
56516,445,0,0,drop,70,70,0,1,0,1,0
56517,445,0,0,drop,70,70,0,1,0,1,0
56514,445,0,0,drop,70,70,0,1,0,1,0
56511,445,0,0,drop,70,70,0,1,0,1,0
61435,445,0,0,drop,70,70,0,1,0,1,0
61428,445,0,0,drop,70,70,0,1,0,1,0
56505,445,0,0,drop,70,70,0,1,0,1,0
56817,445,0,0,drop,66,66,0,1,0,1,0
56820,445,0,0,drop,66,66,0,1,0,1,0
56819,445,0,0,drop,66,66,0,1,0,1,0
61425,445,0,0,drop,70,70,0,1,0,1,0
61423,445,0,0,drop,70,70,0,1,0,1,0
56498,445,0,0,drop,70,70,0,1,0,1,0
56496,445,0,0,drop,70,70,0,1,0,1,0
61420,445,0,0,drop,70,70,0,1,0,1,0
61417,445,0,0,drop,70,70,0,1,0,1,0
61414,445,0,0,drop,70,70,0,1,0,1,0
56491,445,0,0,drop,70,70,0,1,0,1,0
56490,445,0,0,drop,70,70,0,1,0,1,0
61403,445,0,0,drop,70,70,0,1,0,1,0
56486,445,0,0,drop,70,70,0,1,0,1,0
56485,445,0,0,drop,70,70,0,1,0,1,0
37309,53,0,0,allow,82,82,0,1,30,1,0
55706,22,55706,22,allow,252,60,192,5,14,2,3
49790,53,24988,53,allow,190,97,93,2,30,1,1
57744,53,14767,53,allow,198,93,105,2,31,1,1
42162,53,42162,53,allow,227,88,139,2,31,1,1
59371,161,59371,161,allow,2085,880,1205,10,31,5,5
56480,445,0,0,drop,70,70,0,1,0,1,0
56798,445,0,0,drop,66,66,0,1,0,1,0
61398,445,0,0,drop,70,70,0,1,0,1,0
61395,445,0,0,drop,70,70,0,1,0,1,0
56790,445,0,0,drop,66,66,0,1,0,1,0
58442,123,61048,123,allow,184,94,90,2,30,1,1
41410,80,40896,80,allow,1484,877,607,11,34,6,5
41409,80,32220,80,allow,1484,877,607,11,34,6,5
64323,53,33071,53,allow,376,126,250,2,30,1,1
40695,53,6681,53,allow,168,78,90,2,29,1,1
52125,53,31811,53,allow,205,86,119,2,29,1,1
56632,80,25180,80,allow,234,234,0,4,12,4,0
55367,53,25329,53,allow,215,102,113,2,30,1,1
65074,53,29931,53,allow,284,118,166,2,30,1,1
49790,53,51287,53,allow,195,102,93,2,30,1,1
41037,80,6510,80,allow,613,539,74,7,15,6,1
60410,80,39027,80,allow,186,64,122,4,27,2,2
65337,53,53258,53,allow,460,112,348,4,56,2,2
49219,443,60965,443,allow,70,70,0,2,4,2,0
49790,53,41551,53,allow,195,102,93,2,29,1,1
51412,53,4036,53,allow,252,78,174,2,30,1,1
54417,53,12775,53,allow,259,86,173,2,30,1,1
54618,53,15831,53,allow,263,86,177,2,30,1,1
57432,66,6875,66,allow,70,70,0,2,8,2,0
64708,53,55981,53,allow,294,134,160,2,30,1,1
46009,53,4263,53,allow,199,94,105,2,30,1,1
50915,53,63317,53,allow,168,78,90,2,30,1,1
49589,53,16073,53,allow,214,102,112,2,31,1,1
60295,53,27114,53,allow,224,94,130,2,30,1,1
47969,53,59484,53,allow,199,94,105,2,30,1,1
64185,53,32210,53,allow,403,110,293,2,31,1,1
54455,443,48160,443,allow,282,148,134,5,27,3,2
58209,53,48023,53,allow,259,86,173,2,30,1,1
45325,53,64530,53,allow,168,78,90,2,30,1,1
60281,80,39760,80,allow,1151,711,440,10,16,5,5
64910,53,52147,53,allow,259,86,173,2,30,1,1
41230,443,13536,443,allow,78,78,0,1,5,1,0
39387,443,57166,443,allow,204,70,134,4,26,2,2
40358,443,63081,443,allow,626,352,274,10,16,6,4
56788,445,0,0,drop,66,66,0,1,0,1,0
61384,445,0,0,drop,70,70,0,1,0,1,0
61381,445,0,0,drop,70,70,0,1,0,1,0
61375,445,0,0,drop,70,70,0,1,0,1,0
56467,445,0,0,drop,70,70,0,1,0,1,0
56784,445,0,0,drop,66,66,0,1,0,1,0
56464,445,0,0,drop,70,70,0,1,0,1,0
61370,445,0,0,drop,70,70,0,1,0,1,0
61368,445,0,0,drop,70,70,0,1,0,1,0
61365,445,0,0,drop,70,70,0,1,0,1,0
61366,445,0,0,drop,70,70,0,1,0,1,0
56778,445,0,0,drop,66,66,0,1,0,1,0
56776,445,0,0,drop,66,66,0,1,0,1,0
56774,445,0,0,drop,66,66,0,1,0,1,0
56773,445,0,0,drop,66,66,0,1,0,1,0
56460,445,0,0,drop,70,70,0,1,0,1,0
56769,445,0,0,drop,66,66,0,1,0,1,0
56768,445,0,0,drop,66,66,0,1,0,1,0
56767,445,0,0,drop,66,66,0,1,0,1,0
56458,445,0,0,drop,70,70,0,1,0,1,0
56456,445,0,0,drop,70,70,0,1,0,1,0
61361,445,0,0,drop,70,70,0,1,0,1,0
61360,445,0,0,drop,70,70,0,1,0,1,0
61363,445,0,0,drop,70,70,0,1,0,1,0
56764,445,0,0,drop,66,66,0,1,0,1,0
61355,445,0,0,drop,70,70,0,1,0,1,0
56761,445,0,0,drop,66,66,0,1,0,1,0
45654,67,0,0,deny,60,60,0,1,0,1,0
56759,445,0,0,drop,66,66,0,1,0,1,0
56757,445,0,0,drop,66,66,0,1,0,1,0
56755,445,0,0,drop,66,66,0,1,0,1,0
56449,445,0,0,drop,70,70,0,1,0,1,0
56447,445,0,0,drop,70,70,0,1,0,1,0
61350,445,0,0,drop,70,70,0,1,0,1,0
56446,445,0,0,drop,70,70,0,1,0,1,0
56445,445,0,0,drop,70,70,0,1,0,1,0
61341,445,0,0,drop,70,70,0,1,0,1,0
61338,445,0,0,drop,70,70,0,1,0,1,0
56444,445,0,0,drop,70,70,0,1,0,1,0
56442,445,0,0,drop,70,70,0,1,0,1,0
56438,445,0,0,drop,70,70,0,1,0,1,0
56745,445,0,0,drop,66,66,0,1,0,1,0
56426,445,0,0,drop,70,70,0,1,0,1,0
56425,445,0,0,drop,70,70,0,1,0,1,0
56423,445,0,0,drop,70,70,0,1,0,1,0
56415,445,0,0,drop,70,70,0,1,0,1,0
56416,445,0,0,drop,70,70,0,1,0,1,0
56737,445,0,0,drop,66,66,0,1,0,1,0
61327,445,0,0,drop,70,70,0,1,0,1,0
52200,23,0,0,deny,60,60,0,1,0,1,0
56734,445,0,0,drop,66,66,0,1,0,1,0
56404,445,0,0,drop,70,70,0,1,0,1,0
56719,445,0,0,drop,66,66,0,1,0,1,0
56399,445,0,0,drop,70,70,0,1,0,1,0
56390,445,0,0,drop,70,70,0,1,0,1,0
56391,445,0,0,drop,70,70,0,1,0,1,0
56389,445,0,0,drop,70,70,0,1,0,1,0
61318,445,0,0,drop,70,70,0,1,0,1,0
61315,445,0,0,drop,70,70,0,1,0,1,0
61316,445,0,0,drop,70,70,0,1,0,1,0
56387,445,0,0,drop,70,70,0,1,0,1,0
56706,445,0,0,drop,66,66,0,1,0,1,0
56710,445,0,0,drop,66,66,0,1,0,1,0
56709,445,0,0,drop,66,66,0,1,0,1,0
56707,445,0,0,drop,66,66,0,1,0,1,0
56704,445,0,0,drop,66,66,0,1,0,1,0
56712,445,0,0,drop,66,66,0,1,0,1,0
56711,445,0,0,drop,66,66,0,1,0,1,0
56705,445,0,0,drop,66,66,0,1,0,1,0
56383,445,0,0,drop,70,70,0,1,0,1,0
45682,1,0,0,deny,62,62,0,1,0,1,0
56377,445,0,0,drop,70,70,0,1,0,1,0
61307,445,0,0,drop,70,70,0,1,0,1,0
61301,445,0,0,drop,70,70,0,1,0,1,0
56690,445,0,0,drop,66,66,0,1,0,1,0
56691,445,0,0,drop,66,66,0,1,0,1,0
56689,445,0,0,drop,66,66,0,1,0,1,0
36227,23,0,0,deny,60,60,0,1,0,1,0
61298,445,0,0,drop,70,70,0,1,0,1,0
56370,445,0,0,drop,70,70,0,1,0,1,0
56367,445,0,0,drop,70,70,0,1,0,1,0
61295,445,0,0,drop,70,70,0,1,0,1,0
61294,445,0,0,drop,70,70,0,1,0,1,0
61292,445,0,0,drop,70,70,0,1,0,1,0
61288,445,0,0,drop,70,70,0,1,0,1,0
56363,445,0,0,drop,70,70,0,1,0,1,0
56362,445,0,0,drop,70,70,0,1,0,1,0
56358,445,0,0,drop,70,70,0,1,0,1,0
51385,161,51385,161,allow,2315,979,1336,10,30,5,5
56976,80,37703,80,allow,214,140,74,4,35,3,1
39287,53,1937,53,allow,198,93,105,2,30,1,1
45000,443,43427,443,allow,2227,1018,1209,17,16,8,9
56978,80,63683,80,allow,214,140,74,4,35,3,1
43310,443,13938,443,allow,60,60,0,1,5,1,0
56975,80,23804,80,allow,214,140,74,4,35,3,1
56988,80,5679,80,allow,214,140,74,4,35,3,1
43309,443,32781,443,allow,60,60,0,1,5,1,0
60112,443,25865,443,allow,572,280,292,9,16,5,4
56979,80,46084,80,allow,214,140,74,4,35,3,1
56977,80,20065,80,allow,214,140,74,4,35,3,1
64216,53,64216,53,allow,220,100,120,2,30,1,1
43308,443,4843,443,allow,120,120,0,2,5,2,0
61276,445,0,0,drop,70,70,0,1,0,1,0
56357,445,0,0,drop,70,70,0,1,0,1,0
56980,80,6065,80,allow,214,140,74,4,35,3,1
56670,445,0,0,drop,66,66,0,1,0,1,0
61268,445,0,0,drop,70,70,0,1,0,1,0
55373,1,0,0,deny,66,66,0,1,0,1,0
56662,445,0,0,drop,66,66,0,1,0,1,0
56339,445,0,0,drop,70,70,0,1,0,1,0
50025,53,43960,53,allow,536,120,416,4,59,2,2
43156,53,17212,53,allow,168,78,90,2,29,1,1
65001,53,54840,53,allow,224,78,146,2,30,1,1
49229,53,37715,53,allow,243,110,133,2,29,1,1
59222,53,30617,53,allow,181,86,95,2,30,1,1
53102,53,13819,53,allow,70,70,0,1,30,1,0
57388,53,31918,53,allow,266,86,180,2,30,1,1
56989,80,28425,80,allow,526,304,222,8,35,5,3
56658,53,56658,53,allow,257,114,143,2,30,1,1
49523,53,19380,53,allow,314,93,221,4,43,2,2
56987,80,45961,80,allow,214,140,74,4,35,3,1
56986,80,18351,80,allow,214,140,74,4,35,3,1
56984,80,27269,80,allow,214,140,74,4,35,3,1
51481,53,20508,53,allow,168,78,90,2,30,1,1
48105,53,48105,53,allow,262,106,156,2,33,1,1
64530,53,46090,53,allow,211,102,109,2,30,1,1
49502,53,35075,53,allow,179,86,93,2,29,1,1
56985,80,59526,80,allow,214,140,74,4,35,3,1
57184,53,36086,53,allow,272,94,178,2,29,1,1
43743,53,43743,53,allow,240,98,142,2,29,1,1
56981,80,19891,80,allow,214,140,74,4,35,3,1
43039,53,27551,53,allow,168,78,90,2,29,1,1
61217,53,50317,53,allow,281,94,187,2,30,1,1
55552,53,60195,53,allow,211,102,109,2,30,1,1
49182,53,44371,53,allow,211,102,109,2,30,1,1
55531,53,57594,53,allow,370,126,244,2,30,1,1
50502,123,1103,123,allow,184,94,90,2,30,1,1
53512,53,23746,53,allow,168,78,90,2,30,1,1
61567,53,3917,53,allow,183,86,97,2,30,1,1
60276,80,60276,80,allow,671,313,358,7,75,4,3
56990,80,57120,80,allow,214,140,74,4,35,3,1
64438,53,23542,53,allow,211,102,109,2,30,1,1
65166,53,40990,53,allow,211,102,109,2,30,1,1
64679,53,17226,53,allow,211,102,109,2,31,1,1
56983,80,30863,80,allow,214,140,74,4,35,3,1
56982,80,63526,80,allow,214,140,74,4,35,3,1
41486,443,65300,443,allow,204,70,134,4,26,2,2
65039,53,3857,53,allow,302,102,200,2,30,1,1
64430,53,41812,53,allow,493,91,402,4,31,2,2
49565,53,54064,53,allow,768,193,575,6,40,3,3
64703,53,13570,53,allow,214,102,112,2,30,1,1
56529,53,10690,53,allow,378,94,284,2,30,1,1
56648,443,37098,443,allow,1327,918,409,10,26,6,4
49936,80,9467,80,allow,1130,613,517,11,15,6,5
65361,53,22669,53,allow,249,94,155,2,30,1,1
49615,53,9854,53,allow,276,94,182,2,30,1,1
56655,443,7969,443,allow,1272,876,396,10,26,6,4
64824,53,60323,53,allow,94,94,0,1,30,1,0
56646,443,10246,443,allow,1327,918,409,10,26,6,4
59291,53,59291,53,allow,197,90,107,2,30,1,1
56660,445,0,0,drop,66,66,0,1,0,1,0
61256,445,0,0,drop,70,70,0,1,0,1,0
61252,445,0,0,drop,70,70,0,1,0,1,0
61247,445,0,0,drop,70,70,0,1,0,1,0
56656,445,0,0,drop,66,66,0,1,0,1,0
56336,445,0,0,drop,70,70,0,1,0,1,0
61240,445,0,0,drop,70,70,0,1,0,1,0
61236,445,0,0,drop,70,70,0,1,0,1,0
61237,445,0,0,drop,70,70,0,1,0,1,0
38683,17,0,0,deny,60,60,0,1,0,1,0
56649,445,0,0,drop,66,66,0,1,0,1,0
56331,445,0,0,drop,70,70,0,1,0,1,0
56330,445,0,0,drop,70,70,0,1,0,1,0
56643,445,0,0,drop,66,66,0,1,0,1,0
56648,445,0,0,drop,66,66,0,1,0,1,0
56645,445,0,0,drop,66,66,0,1,0,1,0
56328,445,0,0,drop,70,70,0,1,0,1,0
56640,445,0,0,drop,66,66,0,1,0,1,0
56641,445,0,0,drop,66,66,0,1,0,1,0
56638,445,0,0,drop,66,66,0,1,0,1,0
61235,445,0,0,drop,70,70,0,1,0,1,0
61230,445,0,0,drop,70,70,0,1,0,1,0
61229,445,0,0,drop,70,70,0,1,0,1,0
56635,445,0,0,drop,66,66,0,1,0,1,0
61227,445,0,0,drop,70,70,0,1,0,1,0
56633,445,0,0,drop,66,66,0,1,0,1,0
56321,445,0,0,drop,70,70,0,1,0,1,0
56631,445,0,0,drop,66,66,0,1,0,1,0
56630,445,0,0,drop,66,66,0,1,0,1,0
56627,445,0,0,drop,66,66,0,1,0,1,0
56319,445,0,0,drop,70,70,0,1,0,1,0
56318,445,0,0,drop,70,70,0,1,0,1,0
56317,445,0,0,drop,70,70,0,1,0,1,0
56316,445,0,0,drop,70,70,0,1,0,1,0
56312,445,0,0,drop,70,70,0,1,0,1,0
56310,445,0,0,drop,70,70,0,1,0,1,0
47037,1,0,0,deny,62,62,0,1,0,1,0
61210,445,0,0,drop,70,70,0,1,0,1,0
56298,445,0,0,drop,70,70,0,1,0,1,0
56297,445,0,0,drop,70,70,0,1,0,1,0
56616,445,0,0,drop,66,66,0,1,0,1,0
56291,445,0,0,drop,70,70,0,1,0,1,0
56288,445,0,0,drop,70,70,0,1,0,1,0
56287,445,0,0,drop,70,70,0,1,0,1,0
56609,445,0,0,drop,66,66,0,1,0,1,0
61199,445,0,0,drop,70,70,0,1,0,1,0
56276,445,0,0,drop,70,70,0,1,0,1,0
56606,445,0,0,drop,66,66,0,1,0,1,0
56600,445,0,0,drop,66,66,0,1,0,1,0
48755,23,0,0,deny,60,60,0,1,0,1,0
56595,445,0,0,drop,66,66,0,1,0,1,0
56272,445,0,0,drop,70,70,0,1,0,1,0
56263,445,0,0,drop,70,70,0,1,0,1,0
56260,445,0,0,drop,70,70,0,1,0,1,0
56261,445,0,0,drop,70,70,0,1,0,1,0
56259,445,0,0,drop,70,70,0,1,0,1,0
56256,445,0,0,drop,70,70,0,1,0,1,0
61192,445,0,0,drop,70,70,0,1,0,1,0
61189,445,0,0,drop,70,70,0,1,0,1,0
61187,445,0,0,drop,70,70,0,1,0,1,0
56579,445,0,0,drop,66,66,0,1,0,1,0
56580,445,0,0,drop,66,66,0,1,0,1,0
56582,445,0,0,drop,66,66,0,1,0,1,0
56584,445,0,0,drop,66,66,0,1,0,1,0
56583,445,0,0,drop,66,66,0,1,0,1,0
56581,445,0,0,drop,66,66,0,1,0,1,0
56577,445,0,0,drop,66,66,0,1,0,1,0
56576,445,0,0,drop,66,66,0,1,0,1,0
56249,445,0,0,drop,70,70,0,1,0,1,0
61180,445,0,0,drop,70,70,0,1,0,1,0
61176,445,0,0,drop,70,70,0,1,0,1,0
56563,445,0,0,drop,66,66,0,1,0,1,0
56564,445,0,0,drop,66,66,0,1,0,1,0
56562,445,0,0,drop,66,66,0,1,0,1,0
56242,445,0,0,drop,70,70,0,1,0,1,0
56241,445,0,0,drop,70,70,0,1,0,1,0
61170,445,0,0,drop,70,70,0,1,0,1,0
61167,445,0,0,drop,70,70,0,1,0,1,0
46415,53,46415,53,allow,211,80,131,2,30,1,1
51434,53,0,0,allow,202,93,109,2,30,1,1
55773,53,49268,53,allow,97,97,0,1,60,1,0
56666,443,31326,443,allow,1299,730,569,13,25,7,6
56665,443,57309,443,allow,1299,730,569,13,25,7,6
48655,53,0,0,allow,82,82,0,2,40,2,0
46230,53,46230,53,allow,257,101,156,2,33,1,1
59487,53,59487,53,allow,211,80,131,2,30,1,1
44467,53,44467,53,allow,211,80,131,2,30,1,1
65408,53,49701,53,allow,817,98,719,2,30,1,1
56662,443,60423,443,allow,1233,730,503,12,25,7,5
56663,443,26937,443,allow,1299,730,569,13,25,7,6
44949,443,55206,443,allow,190,70,120,4,15,2,2
61165,445,0,0,drop,70,70,0,1,0,1,0
61160,445,0,0,drop,70,70,0,1,0,1,0
61156,445,0,0,drop,70,70,0,1,0,1,0
56236,445,0,0,drop,70,70,0,1,0,1,0
56234,445,0,0,drop,70,70,0,1,0,1,0
56230,445,0,0,drop,70,70,0,1,0,1,0
37865,123,17478,123,allow,184,94,90,2,30,1,1
53521,443,40751,443,allow,130,70,60,2,14,1,1
56647,443,58814,443,allow,1327,918,409,10,25,6,4
56653,443,22218,443,allow,1272,876,396,10,25,6,4
63983,53,48725,53,allow,447,94,353,4,54,2,2
64374,53,21599,53,allow,211,94,117,2,30,1,1
56656,443,24919,443,allow,1342,918,424,10,25,6,4
45531,53,30846,53,allow,168,78,90,2,30,1,1
38710,80,33174,80,allow,190,70,120,4,17,2,2
56657,443,37201,443,allow,1342,918,424,10,25,6,4
53934,443,47963,443,allow,360,360,0,7,4,7,0
49440,53,64789,53,allow,415,88,327,4,52,2,2
56631,80,19501,80,allow,234,234,0,4,12,4,0
64685,53,19809,53,allow,535,100,435,4,36,2,2
65179,53,9786,53,allow,289,102,187,2,30,1,1
38772,53,26700,53,allow,168,78,90,2,30,1,1
62447,53,48844,53,allow,296,94,202,2,30,1,1
49934,80,37957,80,allow,1130,613,517,11,15,6,5
49933,80,49306,80,allow,1130,613,517,11,15,6,5
58689,123,57350,123,allow,184,94,90,2,30,1,1
57294,53,58964,53,allow,387,134,253,2,30,1,1
64914,53,14005,53,allow,224,94,130,2,30,1,1
64403,53,53109,53,allow,387,134,253,2,30,1,1
58688,53,58261,53,allow,184,78,106,2,30,1,1
63952,53,35871,53,allow,289,102,187,2,30,1,1
52815,80,10358,80,allow,1152,712,440,10,15,5,5
49935,80,29909,80,allow,1130,613,517,11,15,6,5
45124,80,4219,80,allow,1808,636,1172,16,16,8,8
56652,443,14295,443,allow,1272,876,396,10,25,6,4
46308,123,1425,123,allow,184,94,90,2,30,1,1
49892,53,17000,53,allow,525,110,415,4,43,2,2
54828,443,16065,443,allow,572,572,0,5,11,5,0
63838,80,51652,80,allow,314,192,122,6,15,4,2
64908,53,50995,53,allow,304,94,210,2,30,1,1
49795,53,1877,53,allow,211,102,109,2,30,1,1
50106,53,56744,53,allow,296,94,202,2,30,1,1
49924,53,63883,53,allow,353,94,259,2,31,1,1
50484,80,53622,80,allow,318,192,126,6,26,4,2
50485,80,52438,80,allow,318,192,126,6,26,4,2
56660,443,12588,443,allow,1579,988,591,13,25,7,6
63928,53,2140,53,allow,376,126,250,2,30,1,1
49318,53,58973,53,allow,718,94,624,2,30,1,1
64503,53,37724,53,allow,209,102,107,2,30,1,1
64551,53,2637,53,allow,354,94,260,2,30,1,1
56229,445,0,0,drop,70,70,0,1,0,1,0
61144,445,0,0,drop,70,70,0,1,0,1,0
50828,123,0,0,deny,234,234,0,1,0,1,0
56222,445,0,0,drop,70,70,0,1,0,1,0
61314,23,0,0,deny,60,60,0,1,0,1,0
56540,445,0,0,drop,66,66,0,1,0,1,0
47348,23,0,0,deny,60,60,0,1,0,1,0
61140,445,0,0,drop,70,70,0,1,0,1,0
61141,445,0,0,drop,70,70,0,1,0,1,0
56209,445,0,0,drop,70,70,0,1,0,1,0
56536,445,0,0,drop,66,66,0,1,0,1,0
56532,445,0,0,drop,66,66,0,1,0,1,0
56206,445,0,0,drop,70,70,0,1,0,1,0
61126,445,0,0,drop,70,70,0,1,0,1,0
61124,445,0,0,drop,70,70,0,1,0,1,0
61121,445,0,0,drop,70,70,0,1,0,1,0
56529,445,0,0,drop,66,66,0,1,0,1,0
61114,445,0,0,drop,70,70,0,1,0,1,0
56201,445,0,0,drop,70,70,0,1,0,1,0
56200,445,0,0,drop,70,70,0,1,0,1,0
61111,445,0,0,drop,70,70,0,1,0,1,0
61109,445,0,0,drop,70,70,0,1,0,1,0
61108,445,0,0,drop,70,70,0,1,0,1,0
56523,445,0,0,drop,66,66,0,1,0,1,0
56198,445,0,0,drop,70,70,0,1,0,1,0
56516,445,0,0,drop,66,66,0,1,0,1,0
56519,445,0,0,drop,66,66,0,1,0,1,0
56517,445,0,0,drop,66,66,0,1,0,1,0
56512,445,0,0,drop,66,66,0,1,0,1,0
56513,445,0,0,drop,66,66,0,1,0,1,0
56511,445,0,0,drop,66,66,0,1,0,1,0
44059,23,0,0,deny,60,60,0,1,0,1,0
61107,445,0,0,drop,70,70,0,1,0,1,0
61104,445,0,0,drop,70,70,0,1,0,1,0
61102,445,0,0,drop,70,70,0,1,0,1,0
56509,445,0,0,drop,66,66,0,1,0,1,0
56191,445,0,0,drop,70,70,0,1,0,1,0
61099,445,0,0,drop,70,70,0,1,0,1,0
56505,445,0,0,drop,66,66,0,1,0,1,0
56189,445,0,0,drop,70,70,0,1,0,1,0
56502,445,0,0,drop,66,66,0,1,0,1,0
56503,445,0,0,drop,66,66,0,1,0,1,0
56499,445,0,0,drop,66,66,0,1,0,1,0
56188,445,0,0,drop,70,70,0,1,0,1,0
56187,445,0,0,drop,70,70,0,1,0,1,0
56186,445,0,0,drop,70,70,0,1,0,1,0
56181,445,0,0,drop,70,70,0,1,0,1,0
56183,445,0,0,drop,70,70,0,1,0,1,0
61093,445,0,0,drop,70,70,0,1,0,1,0
61090,445,0,0,drop,70,70,0,1,0,1,0
56168,445,0,0,drop,70,70,0,1,0,1,0
56167,445,0,0,drop,70,70,0,1,0,1,0
56164,445,0,0,drop,70,70,0,1,0,1,0
56158,445,0,0,drop,70,70,0,1,0,1,0
56157,445,0,0,drop,70,70,0,1,0,1,0
56489,445,0,0,drop,66,66,0,1,0,1,0
56481,445,0,0,drop,66,66,0,1,0,1,0
61072,445,0,0,drop,70,70,0,1,0,1,0
56146,445,0,0,drop,70,70,0,1,0,1,0
56479,445,0,0,drop,66,66,0,1,0,1,0
56472,445,0,0,drop,66,66,0,1,0,1,0
56142,445,0,0,drop,70,70,0,1,0,1,0
56461,445,0,0,drop,66,66,0,1,0,1,0
56133,445,0,0,drop,70,70,0,1,0,1,0
56131,445,0,0,drop,70,70,0,1,0,1,0
56130,445,0,0,drop,70,70,0,1,0,1,0
56129,445,0,0,drop,70,70,0,1,0,1,0
56126,445,0,0,drop,70,70,0,1,0,1,0
61062,445,0,0,drop,70,70,0,1,0,1,0
61060,445,0,0,drop,70,70,0,1,0,1,0
61059,445,0,0,drop,70,70,0,1,0,1,0
56456,445,0,0,drop,66,66,0,1,0,1,0
56450,445,0,0,drop,66,66,0,1,0,1,0
56455,445,0,0,drop,66,66,0,1,0,1,0
56453,445,0,0,drop,66,66,0,1,0,1,0
56454,445,0,0,drop,66,66,0,1,0,1,0
56449,445,0,0,drop,66,66,0,1,0,1,0
56451,445,0,0,drop,66,66,0,1,0,1,0
56448,445,0,0,drop,66,66,0,1,0,1,0
49186,53,49186,53,allow,257,101,156,2,32,1,1
50500,80,1291,80,allow,318,192,126,6,25,4,2
50499,80,43182,80,allow,318,192,126,6,25,4,2
50479,80,2241,80,allow,312,192,120,6,25,4,2
46984,443,45323,443,allow,416,210,206,7,35,4,3
50501,80,58618,80,allow,318,192,126,6,25,4,2
50502,80,37094,80,allow,318,192,126,6,25,4,2
50492,80,56917,80,allow,318,192,126,6,25,4,2
65025,443,1842,443,allow,2227,1018,1209,17,16,8,9
52042,53,52042,53,allow,81,81,0,1,30,1,0
50491,80,59883,80,allow,318,192,126,6,25,4,2
57161,53,1657,53,allow,711,87,624,2,30,1,1
55958,53,60321,53,allow,170,87,83,2,31,1,1
56351,53,13734,53,allow,306,99,207,2,31,1,1
62299,53,62299,53,allow,259,108,151,2,31,1,1
56119,445,0,0,drop,70,70,0,1,0,1,0
61057,445,0,0,drop,70,70,0,1,0,1,0
63768,53,12206,53,allow,298,102,196,2,30,1,1
64133,53,32044,53,allow,216,102,114,2,30,1,1
56112,445,0,0,drop,70,70,0,1,0,1,0
56111,445,0,0,drop,70,70,0,1,0,1,0
56436,445,0,0,drop,66,66,0,1,0,1,0
56434,445,0,0,drop,66,66,0,1,0,1,0
56435,445,0,0,drop,66,66,0,1,0,1,0
61041,445,0,0,drop,70,70,0,1,0,1,0
56106,445,0,0,drop,70,70,0,1,0,1,0
61039,445,0,0,drop,70,70,0,1,0,1,0
56104,445,0,0,drop,70,70,0,1,0,1,0
61031,445,0,0,drop,70,70,0,1,0,1,0
56100,445,0,0,drop,70,70,0,1,0,1,0
56099,445,0,0,drop,70,70,0,1,0,1,0
56094,445,0,0,drop,70,70,0,1,0,1,0
50496,80,19242,80,allow,318,192,126,6,25,4,2
50480,80,36021,80,allow,318,192,126,6,25,4,2
55496,80,55496,80,allow,1099,578,521,10,15,6,4
49710,53,28433,53,allow,480,93,387,4,50,2,2
60796,53,56563,53,allow,296,94,202,2,29,1,1
56659,443,25934,443,allow,1579,988,591,13,24,7,6
63938,53,63032,53,allow,385,110,275,2,30,1,1
49172,53,32719,53,allow,227,102,125,2,29,1,1
65352,53,63363,53,allow,321,102,219,2,29,1,1
52042,53,52042,53,allow,478,292,186,5,30,3,2
50482,80,36252,80,allow,314,192,122,6,25,4,2
62139,53,5028,53,allow,298,102,196,2,30,1,1
64845,53,4147,53,allow,289,110,179,2,30,1,1
56336,53,52213,53,allow,196,102,94,2,35,1,1
64514,53,39075,53,allow,437,88,349,4,41,2,2
50498,80,12035,80,allow,312,192,120,6,25,4,2
50490,80,51282,80,allow,318,192,126,6,25,4,2
58851,443,28195,443,allow,344,130,214,6,77,3,3
47640,443,10100,443,allow,1058,571,487,10,38,6,4
56724,53,0,0,allow,86,86,0,1,30,1,0
65207,53,42618,53,allow,277,110,167,2,30,1,1
57092,53,43166,53,allow,270,102,168,2,30,1,1
50489,80,24870,80,allow,318,192,126,6,25,4,2
50505,80,62173,80,allow,318,192,126,6,25,4,2
57386,443,57835,443,allow,1056,569,487,10,38,6,4
47638,443,5364,443,allow,1056,569,487,10,38,6,4
46531,123,21322,123,allow,184,94,90,2,30,1,1
65428,53,65157,53,allow,516,86,430,4,32,2,2
50493,80,1565,80,allow,318,192,126,6,25,4,2
49159,53,48232,53,allow,213,102,111,2,29,1,1
50481,80,4638,80,allow,318,192,126,6,25,4,2
57372,53,20962,53,allow,177,94,83,2,30,1,1
49771,53,64611,53,allow,272,110,162,2,30,1,1
56341,53,28637,53,allow,213,102,111,2,29,1,1
64791,53,19786,53,allow,526,197,329,6,49,3,3
55917,53,58501,53,allow,371,109,262,4,59,2,2
64209,53,40539,53,allow,291,94,197,2,29,1,1
57370,53,22264,53,allow,347,110,237,2,30,1,1
63981,53,39748,53,allow,329,86,243,4,42,2,2
57384,443,57610,443,allow,1054,567,487,10,38,6,4
57372,53,54871,53,allow,177,94,83,2,30,1,1
37621,80,10654,80,allow,350,210,140,6,15,4,2
54966,53,44405,53,allow,171,88,83,3,33,2,1
64268,53,45536,53,allow,334,103,231,4,54,2,2
50018,53,44491,53,allow,270,102,168,2,30,1,1
56233,53,2635,53,allow,399,97,302,4,59,2,2
65073,53,40365,53,allow,293,102,191,2,30,1,1
55958,53,40832,53,allow,177,94,83,2,30,1,1
50506,80,64243,80,allow,318,192,126,6,25,4,2
50488,80,56611,80,allow,318,192,126,6,25,4,2
50495,80,9941,80,allow,312,192,120,6,25,4,2
50483,80,35746,80,allow,374,192,182,7,25,4,3
39616,443,20055,443,allow,60,60,0,2,5,2,0
49761,53,36428,53,allow,373,99,274,4,41,2,2
50477,80,59736,80,allow,648,256,392,8,25,5,3
55004,53,63304,53,allow,270,102,168,2,30,1,1
49818,53,37745,53,allow,86,86,0,1,30,1,0
52038,80,51825,80,allow,70,70,0,1,5,1,0
64753,53,63867,53,allow,94,94,0,1,30,1,0
49622,53,58073,53,allow,244,94,150,2,30,1,1
51467,443,51893,443,allow,194,70,124,3,11,1,2
64191,53,1179,53,allow,212,102,110,2,30,1,1
64164,53,32232,53,allow,229,102,127,2,30,1,1
55498,53,0,0,allow,86,86,0,1,30,1,0
56410,445,0,0,drop,66,66,0,1,0,1,0
61013,445,0,0,drop,70,70,0,1,0,1,0
56081,445,0,0,drop,70,70,0,1,0,1,0
56406,445,0,0,drop,66,66,0,1,0,1,0
56078,445,0,0,drop,70,70,0,1,0,1,0
56404,445,0,0,drop,66,66,0,1,0,1,0
60994,445,0,0,drop,70,70,0,1,0,1,0
56400,445,0,0,drop,66,66,0,1,0,1,0
56073,445,0,0,drop,70,70,0,1,0,1,0
56072,445,0,0,drop,70,70,0,1,0,1,0
56070,445,0,0,drop,70,70,0,1,0,1,0
60984,445,0,0,drop,70,70,0,1,0,1,0
60982,445,0,0,drop,70,70,0,1,0,1,0
60980,445,0,0,drop,70,70,0,1,0,1,0
56395,445,0,0,drop,66,66,0,1,0,1,0
56392,445,0,0,drop,66,66,0,1,0,1,0
56391,445,0,0,drop,66,66,0,1,0,1,0
56386,445,0,0,drop,66,66,0,1,0,1,0
56384,445,0,0,drop,66,66,0,1,0,1,0
56385,445,0,0,drop,66,66,0,1,0,1,0
56383,445,0,0,drop,66,66,0,1,0,1,0
56063,445,0,0,drop,70,70,0,1,0,1,0
60978,445,0,0,drop,70,70,0,1,0,1,0
60977,445,0,0,drop,70,70,0,1,0,1,0
60972,445,0,0,drop,70,70,0,1,0,1,0
56381,445,0,0,drop,66,66,0,1,0,1,0
56061,445,0,0,drop,70,70,0,1,0,1,0
60971,445,0,0,drop,70,70,0,1,0,1,0
56377,445,0,0,drop,66,66,0,1,0,1,0
58131,1,0,0,deny,146,146,0,1,0,1,0
56060,445,0,0,drop,70,70,0,1,0,1,0
56375,445,0,0,drop,66,66,0,1,0,1,0
56373,445,0,0,drop,66,66,0,1,0,1,0
56059,445,0,0,drop,70,70,0,1,0,1,0
56058,445,0,0,drop,70,70,0,1,0,1,0
56371,445,0,0,drop,66,66,0,1,0,1,0
56053,445,0,0,drop,70,70,0,1,0,1,0
56052,445,0,0,drop,70,70,0,1,0,1,0
56040,445,0,0,drop,70,70,0,1,0,1,0
56039,445,0,0,drop,70,70,0,1,0,1,0
56035,445,0,0,drop,70,70,0,1,0,1,0
56030,445,0,0,drop,70,70,0,1,0,1,0
56029,445,0,0,drop,70,70,0,1,0,1,0
56360,445,0,0,drop,66,66,0,1,0,1,0
56018,445,0,0,drop,70,70,0,1,0,1,0
56353,445,0,0,drop,66,66,0,1,0,1,0
60943,445,0,0,drop,70,70,0,1,0,1,0
56350,445,0,0,drop,66,66,0,1,0,1,0
56014,445,0,0,drop,70,70,0,1,0,1,0
56343,445,0,0,drop,66,66,0,1,0,1,0
56341,445,0,0,drop,66,66,0,1,0,1,0
58999,53,58999,53,allow,825,99,726,2,30,1,1
52814,53,53198,53,allow,578,286,292,9,15,5,4
37390,80,51104,80,allow,234,234,0,4,12,4,0
63015,53,58315,53,allow,303,85,218,2,31,1,1
63016,443,62521,443,allow,303,85,218,2,31,1,1
63024,53,42862,53,allow,569,164,405,2,30,1,1
63023,443,14505,443,allow,382,164,218,2,30,1,1
38815,53,38815,53,allow,230,99,131,2,30,1,1
48238,443,41856,443,allow,2227,1018,1209,17,15,8,9
56005,445,0,0,drop,70,70,0,1,0,1,0
56003,445,0,0,drop,70,70,0,1,0,1,0
56001,445,0,0,drop,70,70,0,1,0,1,0
56000,445,0,0,drop,70,70,0,1,0,1,0
55997,445,0,0,drop,70,70,0,1,0,1,0
64363,53,54171,53,allow,212,102,110,2,30,1,1
60433,123,65242,123,allow,184,94,90,2,29,1,1
55624,53,62232,53,allow,244,94,150,2,29,1,1
56837,53,27740,53,allow,195,102,93,2,32,1,1
60287,80,62692,80,allow,1052,612,440,10,15,5,5
55193,53,55120,53,allow,200,102,98,2,33,1,1
56837,53,4890,53,allow,195,102,93,2,29,1,1
65106,53,17651,53,allow,354,94,260,2,29,1,1
58679,53,27207,53,allow,298,102,196,2,29,1,1
55958,53,62913,53,allow,177,94,83,2,29,1,1
56346,53,56346,53,allow,262,106,156,2,32,1,1
54703,53,49581,53,allow,168,78,90,2,30,1,1
63021,443,34609,443,allow,512,166,346,2,30,1,1
56658,443,12805,443,allow,1560,988,572,13,23,7,6
64047,53,55544,53,allow,604,89,515,4,45,2,2
58481,53,42506,53,allow,290,110,180,2,30,1,1
63027,443,10834,443,allow,384,166,218,2,30,1,1
64338,53,41701,53,allow,200,102,98,2,30,1,1
65188,53,34848,53,allow,213,102,111,2,30,1,1
39615,443,17497,443,allow,130,70,60,3,5,2,1
49166,443,10443,443,allow,70,70,0,1,5,1,0
49250,53,62470,53,allow,298,87,211,4,48,2,2
58558,53,58236,53,allow,268,86,182,2,30,1,1
56630,80,55230,80,allow,234,234,0,4,12,4,0
65282,53,57609,53,allow,522,91,431,4,49,2,2
37900,53,2466,53,allow,78,78,0,1,30,1,0
55958,53,14434,53,allow,177,94,83,2,30,1,1
63020,443,53282,443,allow,512,166,346,2,30,1,1
54966,53,59029,53,allow,255,88,167,4,32,2,2
49995,53,53855,53,allow,303,98,205,4,40,2,2
65465,53,18720,53,allow,293,102,191,2,29,1,1
49684,53,21165,53,allow,305,94,211,2,29,1,1
49497,53,38810,53,allow,297,102,195,2,29,1,1
55600,53,56237,53,allow,168,78,90,2,30,1,1
55762,53,8136,53,allow,196,86,110,2,29,1,1
55762,53,54612,53,allow,184,102,82,2,29,1,1
65212,53,14498,53,allow,273,118,155,2,30,1,1
65093,53,16648,53,allow,266,118,148,2,29,1,1
57065,53,34013,53,allow,272,110,162,2,29,1,1
65389,53,51653,53,allow,94,94,0,1,30,1,0
39814,53,58386,53,allow,168,78,90,2,30,1,1
55193,53,45543,53,allow,200,102,98,2,30,1,1
49378,53,56071,53,allow,268,94,174,2,30,1,1
64512,53,55792,53,allow,244,118,126,2,30,1,1
57996,53,57996,53,allow,265,114,151,2,30,1,1
63013,443,17200,443,allow,304,86,218,2,30,1,1
58259,53,23484,53,allow,168,78,90,2,30,1,1
42115,53,42115,53,allow,262,106,156,2,32,1,1
63028,53,16966,53,allow,384,166,218,2,30,1,1
63025,443,40805,443,allow,304,86,218,2,30,1,1
56129,53,60836,53,allow,94,94,0,1,30,1,0
53761,123,54980,123,allow,184,94,90,2,30,1,1
49288,53,48281,53,allow,322,102,220,2,30,1,1
49273,53,17508,53,allow,342,110,232,2,30,1,1
64875,53,51837,53,allow,211,102,109,2,30,1,1
44976,53,45616,53,allow,86,86,0,1,30,1,0
49995,53,30507,53,allow,197,102,95,2,33,1,1
55228,53,59087,53,allow,212,102,110,2,30,1,1
63980,53,48933,53,allow,225,102,123,2,30,1,1
63026,53,55076,53,allow,304,86,218,2,30,1,1
62329,53,9486,53,allow,268,86,182,2,30,1,1
60920,53,22139,53,allow,268,86,182,2,30,1,1
49161,53,1492,53,allow,385,102,283,2,30,1,1
51933,53,51933,53,allow,253,106,147,2,30,1,1
38334,53,4428,53,allow,168,78,90,2,31,1,1
56802,80,23332,80,allow,1559,762,797,14,30,7,7
64361,53,32766,53,allow,228,110,118,2,30,1,1
58875,53,56659,53,allow,370,86,284,2,30,1,1
49954,53,40035,53,allow,211,102,109,2,31,1,1
63012,53,5232,53,allow,304,86,218,2,30,1,1
63011,443,30939,443,allow,304,86,218,2,30,1,1
64076,53,18119,53,allow,353,118,235,2,30,1,1
60936,445,0,0,drop,70,70,0,1,0,1,0
60932,445,0,0,drop,70,70,0,1,0,1,0
60931,445,0,0,drop,70,70,0,1,0,1,0
56325,445,0,0,drop,66,66,0,1,0,1,0
56326,445,0,0,drop,66,66,0,1,0,1,0
56324,445,0,0,drop,66,66,0,1,0,1,0
56320,445,0,0,drop,66,66,0,1,0,1,0
56322,445,0,0,drop,66,66,0,1,0,1,0
56323,445,0,0,drop,66,66,0,1,0,1,0
56321,445,0,0,drop,66,66,0,1,0,1,0
56319,445,0,0,drop,66,66,0,1,0,1,0
55992,445,0,0,drop,70,70,0,1,0,1,0
55984,445,0,0,drop,70,70,0,1,0,1,0
60922,445,0,0,drop,70,70,0,1,0,1,0
60915,445,0,0,drop,70,70,0,1,0,1,0
55981,445,0,0,drop,70,70,0,1,0,1,0
56307,445,0,0,drop,66,66,0,1,0,1,0
56306,445,0,0,drop,66,66,0,1,0,1,0
56304,445,0,0,drop,66,66,0,1,0,1,0
60913,445,0,0,drop,70,70,0,1,0,1,0
55978,445,0,0,drop,70,70,0,1,0,1,0
55976,445,0,0,drop,70,70,0,1,0,1,0
60911,445,0,0,drop,70,70,0,1,0,1,0
60909,445,0,0,drop,70,70,0,1,0,1,0
60908,445,0,0,drop,70,70,0,1,0,1,0
60900,445,0,0,drop,70,70,0,1,0,1,0
55972,445,0,0,drop,70,70,0,1,0,1,0
55971,445,0,0,drop,70,70,0,1,0,1,0
60892,445,0,0,drop,70,70,0,1,0,1,0
60891,445,0,0,drop,70,70,0,1,0,1,0
55966,445,0,0,drop,70,70,0,1,0,1,0
56281,445,0,0,drop,66,66,0,1,0,1,0
60885,445,0,0,drop,70,70,0,1,0,1,0
60884,445,0,0,drop,70,70,0,1,0,1,0
55953,445,0,0,drop,70,70,0,1,0,1,0
55950,445,0,0,drop,70,70,0,1,0,1,0
56277,445,0,0,drop,66,66,0,1,0,1,0
56275,445,0,0,drop,66,66,0,1,0,1,0
60873,445,0,0,drop,70,70,0,1,0,1,0
60866,445,0,0,drop,70,70,0,1,0,1,0
60865,445,0,0,drop,70,70,0,1,0,1,0
56274,445,0,0,drop,66,66,0,1,0,1,0
55945,445,0,0,drop,70,70,0,1,0,1,0
55944,445,0,0,drop,70,70,0,1,0,1,0
55942,445,0,0,drop,70,70,0,1,0,1,0
60859,445,0,0,drop,70,70,0,1,0,1,0
60855,445,0,0,drop,70,70,0,1,0,1,0
60852,445,0,0,drop,70,70,0,1,0,1,0
56265,445,0,0,drop,66,66,0,1,0,1,0
56263,445,0,0,drop,66,66,0,1,0,1,0
56260,445,0,0,drop,66,66,0,1,0,1,0
56258,445,0,0,drop,66,66,0,1,0,1,0
56256,445,0,0,drop,66,66,0,1,0,1,0
56255,445,0,0,drop,66,66,0,1,0,1,0
56253,445,0,0,drop,66,66,0,1,0,1,0
55935,445,0,0,drop,70,70,0,1,0,1,0
55933,445,0,0,drop,70,70,0,1,0,1,0
60849,445,0,0,drop,70,70,0,1,0,1,0
60850,445,0,0,drop,70,70,0,1,0,1,0
60848,445,0,0,drop,70,70,0,1,0,1,0
56252,445,0,0,drop,66,66,0,1,0,1,0
60843,445,0,0,drop,70,70,0,1,0,1,0
55932,445,0,0,drop,70,70,0,1,0,1,0
56247,445,0,0,drop,66,66,0,1,0,1,0
55931,445,0,0,drop,70,70,0,1,0,1,0
55930,445,0,0,drop,70,70,0,1,0,1,0
55926,445,0,0,drop,70,70,0,1,0,1,0
55927,445,0,0,drop,70,70,0,1,0,1,0
56246,445,0,0,drop,66,66,0,1,0,1,0
56244,445,0,0,drop,66,66,0,1,0,1,0
55912,445,0,0,drop,70,70,0,1,0,1,0
55911,445,0,0,drop,70,70,0,1,0,1,0
55907,445,0,0,drop,70,70,0,1,0,1,0
55902,445,0,0,drop,70,70,0,1,0,1,0
55901,445,0,0,drop,70,70,0,1,0,1,0
60825,445,0,0,drop,70,70,0,1,0,1,0
56231,445,0,0,drop,66,66,0,1,0,1,0
55890,445,0,0,drop,70,70,0,1,0,1,0
56224,445,0,0,drop,66,66,0,1,0,1,0
51283,80,60981,80,allow,1114,534,580,12,16,7,5
37096,443,33249,443,allow,1753,1108,645,16,26,9,7
63214,53,63214,53,allow,261,103,158,2,30,1,1
39328,80,54036,80,allow,78,78,0,1,5,1,0
55592,53,16143,53,allow,817,98,719,2,30,1,1
49396,53,24683,53,allow,170,87,83,2,30,1,1
55274,53,15789,53,allow,711,87,624,2,30,1,1
49224,53,6029,53,allow,170,87,83,2,31,1,1
40322,23,0,0,deny,60,60,0,1,0,1,0
56221,445,0,0,drop,66,66,0,1,0,1,0
55886,445,0,0,drop,70,70,0,1,0,1,0
56214,445,0,0,drop,66,66,0,1,0,1,0
55877,445,0,0,drop,70,70,0,1,0,1,0
55876,445,0,0,drop,70,70,0,1,0,1,0
55872,445,0,0,drop,70,70,0,1,0,1,0
55874,445,0,0,drop,70,70,0,1,0,1,0
56211,445,0,0,drop,66,66,0,1,0,1,0
55869,445,0,0,drop,70,70,0,1,0,1,0
60803,445,0,0,drop,70,70,0,1,0,1,0
60805,445,0,0,drop,70,70,0,1,0,1,0
60804,445,0,0,drop,70,70,0,1,0,1,0
39452,123,25633,123,allow,184,94,90,2,30,1,1
49396,53,21722,53,allow,177,94,83,2,30,1,1
49989,53,42243,53,allow,677,217,460,6,74,3,3
64202,53,3004,53,allow,316,89,227,4,50,2,2
63022,53,50452,53,allow,384,166,218,2,29,1,1
63014,53,26673,53,allow,304,86,218,2,29,1,1
49507,53,65329,53,allow,177,94,83,2,30,1,1
60827,53,38613,53,allow,224,86,138,2,29,1,1
63018,53,50611,53,allow,384,166,218,2,29,1,1
63010,53,14322,53,allow,304,86,218,2,29,1,1
65442,53,44743,53,allow,262,102,160,2,29,1,1
49396,53,32920,53,allow,177,94,83,2,29,1,1
54044,53,15773,53,allow,224,86,138,2,29,1,1
64765,53,50725,53,allow,177,94,83,2,30,1,1
58870,443,45632,443,allow,1411,921,490,12,15,7,5
49606,53,55555,53,allow,328,94,234,4,43,2,2
50084,80,12971,80,allow,2173,616,1557,10,15,6,4
64608,53,19709,53,allow,718,94,624,2,30,1,1
64670,53,49938,53,allow,228,94,134,2,30,1,1
49507,53,33142,53,allow,177,94,83,2,30,1,1
49334,53,5617,53,allow,300,99,201,4,38,2,2
64828,53,23782,53,allow,372,94,278,2,30,1,1
64230,53,48297,53,allow,193,94,99,2,30,1,1
39570,443,62469,443,allow,70,70,0,1,5,1,0
63019,53,40745,53,allow,512,166,346,2,29,1,1
51791,80,21497,80,allow,1934,1083,851,9,15,5,4
64542,53,47604,53,allow,234,94,140,2,29,1,1
49474,53,54970,53,allow,224,86,138,2,29,1,1
63017,443,7644,443,allow,571,166,405,2,29,1,1
53290,443,5427,443,allow,494,288,206,8,26,5,3
63009,443,26712,443,allow,304,86,218,2,29,1,1
49396,53,18429,53,allow,177,94,83,2,29,1,1
64966,53,26229,53,allow,376,126,250,2,29,1,1
65197,53,14120,53,allow,177,86,91,2,30,1,1
50059,53,45752,53,allow,718,94,624,2,30,1,1
65167,53,20946,53,allow,219,94,125,2,30,1,1
49758,53,63769,53,allow,243,102,141,2,30,1,1
46671,53,46671,53,allow,832,106,726,2,30,1,1
64765,53,64580,53,allow,177,94,83,2,30,1,1
51790,80,59266,80,allow,1936,1085,851,9,15,5,4
55808,53,55808,53,allow,257,106,151,2,30,1,1
46887,443,50848,443,allow,118,118,0,1,30,1,0
49338,53,20545,53,allow,368,94,274,2,30,1,1
64561,53,17308,53,allow,461,91,370,4,60,2,2
39762,123,46956,123,allow,184,94,90,2,30,1,1
64360,53,15501,53,allow,350,88,262,4,31,2,2
47089,443,11846,443,allow,172,172,0,2,5,2,0
58440,53,59026,53,allow,305,102,203,2,31,1,1
49746,53,24579,53,allow,479,88,391,4,58,2,2
64157,53,49752,53,allow,370,126,244,2,30,1,1
64951,53,60545,53,allow,230,102,128,2,30,1,1
49948,53,19107,53,allow,380,110,270,2,30,1,1
56660,53,3127,53,allow,338,110,228,2,30,1,1
56621,443,14784,443,allow,1327,918,409,10,26,6,4
56197,445,0,0,drop,66,66,0,1,0,1,0
56193,445,0,0,drop,66,66,0,1,0,1,0
56192,445,0,0,drop,66,66,0,1,0,1,0
56198,445,0,0,drop,66,66,0,1,0,1,0
56194,445,0,0,drop,66,66,0,1,0,1,0
56196,445,0,0,drop,66,66,0,1,0,1,0
56195,445,0,0,drop,66,66,0,1,0,1,0
56190,445,0,0,drop,66,66,0,1,0,1,0
55864,445,0,0,drop,70,70,0,1,0,1,0
55856,445,0,0,drop,70,70,0,1,0,1,0
55855,445,0,0,drop,70,70,0,1,0,1,0
60802,445,0,0,drop,70,70,0,1,0,1,0
60789,445,0,0,drop,70,70,0,1,0,1,0
60788,445,0,0,drop,70,70,0,1,0,1,0
56178,445,0,0,drop,66,66,0,1,0,1,0
56177,445,0,0,drop,66,66,0,1,0,1,0
56175,445,0,0,drop,66,66,0,1,0,1,0
55850,445,0,0,drop,70,70,0,1,0,1,0
55848,445,0,0,drop,70,70,0,1,0,1,0
60783,445,0,0,drop,70,70,0,1,0,1,0
55844,445,0,0,drop,70,70,0,1,0,1,0
60776,445,0,0,drop,70,70,0,1,0,1,0
60779,445,0,0,drop,70,70,0,1,0,1,0
60778,445,0,0,drop,70,70,0,1,0,1,0
55843,445,0,0,drop,70,70,0,1,0,1,0
55838,445,0,0,drop,70,70,0,1,0,1,0
60766,445,0,0,drop,70,70,0,1,0,1,0
60765,445,0,0,drop,70,70,0,1,0,1,0
60764,445,0,0,drop,70,70,0,1,0,1,0
38758,23,0,0,deny,60,60,0,1,0,1,0
56153,445,0,0,drop,66,66,0,1,0,1,0
55825,445,0,0,drop,70,70,0,1,0,1,0
60758,445,0,0,drop,70,70,0,1,0,1,0
55822,445,0,0,drop,70,70,0,1,0,1,0
56148,445,0,0,drop,66,66,0,1,0,1,0
56146,445,0,0,drop,66,66,0,1,0,1,0
60745,445,0,0,drop,70,70,0,1,0,1,0
55817,445,0,0,drop,70,70,0,1,0,1,0
60741,445,0,0,drop,70,70,0,1,0,1,0
60735,445,0,0,drop,70,70,0,1,0,1,0
55816,445,0,0,drop,70,70,0,1,0,1,0
56143,445,0,0,drop,66,66,0,1,0,1,0
55814,445,0,0,drop,70,70,0,1,0,1,0
60730,445,0,0,drop,70,70,0,1,0,1,0
60725,445,0,0,drop,70,70,0,1,0,1,0
60724,445,0,0,drop,70,70,0,1,0,1,0
56137,445,0,0,drop,66,66,0,1,0,1,0
56131,445,0,0,drop,66,66,0,1,0,1,0
56128,445,0,0,drop,66,66,0,1,0,1,0
56130,445,0,0,drop,66,66,0,1,0,1,0
55807,445,0,0,drop,70,70,0,1,0,1,0
56127,445,0,0,drop,66,66,0,1,0,1,0
56125,445,0,0,drop,66,66,0,1,0,1,0
56126,445,0,0,drop,66,66,0,1,0,1,0
55805,445,0,0,drop,70,70,0,1,0,1,0
55804,445,0,0,drop,70,70,0,1,0,1,0
60723,445,0,0,drop,70,70,0,1,0,1,0
60720,445,0,0,drop,70,70,0,1,0,1,0
60717,445,0,0,drop,70,70,0,1,0,1,0
55803,445,0,0,drop,70,70,0,1,0,1,0
55802,445,0,0,drop,70,70,0,1,0,1,0
56123,445,0,0,drop,66,66,0,1,0,1,0
55798,445,0,0,drop,70,70,0,1,0,1,0
55799,445,0,0,drop,70,70,0,1,0,1,0
60715,445,0,0,drop,70,70,0,1,0,1,0
56118,445,0,0,drop,66,66,0,1,0,1,0
56117,445,0,0,drop,66,66,0,1,0,1,0
56115,445,0,0,drop,66,66,0,1,0,1,0
56113,445,0,0,drop,66,66,0,1,0,1,0
55784,445,0,0,drop,70,70,0,1,0,1,0
55782,445,0,0,drop,70,70,0,1,0,1,0
55777,445,0,0,drop,70,70,0,1,0,1,0
59200,53,0,0,allow,82,82,0,1,30,1,0
54966,53,23127,53,allow,170,87,83,3,32,2,1
49228,53,49228,53,allow,825,99,726,2,30,1,1
55859,53,0,0,allow,82,82,0,1,30,1,0
64915,53,33891,53,allow,170,87,83,2,31,1,1
49844,53,1140,53,allow,762,98,664,2,31,1,1
56837,53,17666,53,allow,190,97,93,2,31,1,1
65483,53,14095,53,allow,701,88,613,2,31,1,1
54666,123,26890,123,allow,184,94,90,2,31,1,1
64968,53,11084,53,allow,87,87,0,1,31,1,0
53432,53,53432,53,allow,197,76,121,2,31,1,1
55727,53,65316,53,allow,711,87,624,2,31,1,1
49707,53,6726,53,allow,733,85,648,2,31,1,1
55773,445,0,0,drop,70,70,0,1,0,1,0
55774,445,0,0,drop,70,70,0,1,0,1,0
60714,445,0,0,drop,70,70,0,1,0,1,0
60702,445,0,0,drop,70,70,0,1,0,1,0
45363,23,0,0,deny,60,60,0,1,0,1,0
62682,23,0,0,deny,60,60,0,1,0,1,0
56102,445,0,0,drop,66,66,0,1,0,1,0
55762,445,0,0,drop,70,70,0,1,0,1,0
56094,445,0,0,drop,66,66,0,1,0,1,0
55758,445,0,0,drop,70,70,0,1,0,1,0
56092,445,0,0,drop,66,66,0,1,0,1,0
55747,445,0,0,drop,70,70,0,1,0,1,0
55748,445,0,0,drop,70,70,0,1,0,1,0
57441,53,16567,53,allow,177,94,83,2,29,1,1
56620,443,2901,443,allow,1327,918,409,10,25,6,4
65110,53,12122,53,allow,754,191,563,6,51,3,3
64974,53,51198,53,allow,493,111,382,4,57,2,2
63930,53,2970,53,allow,377,94,283,2,29,1,1
63762,123,63358,123,allow,184,94,90,2,29,1,1
58440,53,26101,53,allow,305,102,203,2,30,1,1
64429,53,41917,53,allow,217,94,123,2,30,1,1
65175,53,18597,53,allow,269,94,175,2,30,1,1
56629,80,58427,80,allow,234,234,0,4,12,4,0
55217,53,39301,53,allow,210,102,108,2,30,1,1
65268,53,12409,53,allow,395,107,288,4,46,2,2
49224,53,17208,53,allow,185,102,83,2,30,1,1
60517,53,31898,53,allow,198,86,112,2,30,1,1
65211,53,49175,53,allow,216,102,114,2,30,1,1
64915,53,11027,53,allow,177,94,83,2,30,1,1
56336,53,12124,53,allow,196,102,94,2,30,1,1
56336,53,53884,53,allow,196,102,94,2,35,1,1
49444,53,42796,53,allow,401,88,313,4,38,2,2
49756,53,16127,53,allow,396,94,302,4,41,2,2
52931,80,27397,80,allow,78,78,0,1,4,1,0
49633,53,1926,53,allow,245,94,151,2,29,1,1
64252,53,63103,53,allow,350,94,256,2,29,1,1
57441,53,9760,53,allow,177,94,83,2,29,1,1
63008,53,31909,53,allow,183,86,97,2,30,1,1
64873,53,26833,53,allow,380,110,270,2,30,1,1
39624,53,30103,53,allow,168,78,90,2,30,1,1
49369,53,33288,53,allow,232,110,122,2,30,1,1
49835,53,27246,53,allow,214,94,120,2,30,1,1
55773,53,28630,53,allow,102,102,0,1,60,1,0
56611,443,65034,443,allow,1473,868,605,10,25,6,4
43719,53,43719,53,allow,295,90,205,2,30,1,1
64367,53,24939,53,allow,257,110,147,2,30,1,1
55625,53,6982,53,allow,94,94,0,1,30,1,0
64482,53,36400,53,allow,322,95,227,4,39,2,2
64716,53,33097,53,allow,385,134,251,2,30,1,1
56777,53,34621,53,allow,210,94,116,2,30,1,1
49987,53,51873,53,allow,253,86,167,2,30,1,1
65453,53,50552,53,allow,242,94,148,2,30,1,1
49855,53,11171,53,allow,290,102,188,2,30,1,1
64915,53,41416,53,allow,177,94,83,2,31,1,1
46991,53,46991,53,allow,262,106,156,2,31,1,1
55744,445,0,0,drop,70,70,0,1,0,1,0
55745,445,0,0,drop,70,70,0,1,0,1,0
56085,445,0,0,drop,66,66,0,1,0,1,0
55742,445,0,0,drop,70,70,0,1,0,1,0
56082,445,0,0,drop,66,66,0,1,0,1,0
55736,445,0,0,drop,70,70,0,1,0,1,0
60678,445,0,0,drop,70,70,0,1,0,1,0
60677,445,0,0,drop,70,70,0,1,0,1,0
60675,445,0,0,drop,70,70,0,1,0,1,0
56067,445,0,0,drop,66,66,0,1,0,1,0
56069,445,0,0,drop,66,66,0,1,0,1,0
56066,445,0,0,drop,66,66,0,1,0,1,0
56063,445,0,0,drop,66,66,0,1,0,1,0
56065,445,0,0,drop,66,66,0,1,0,1,0
56061,445,0,0,drop,66,66,0,1,0,1,0
56062,445,0,0,drop,66,66,0,1,0,1,0
55728,445,0,0,drop,70,70,0,1,0,1,0
55727,445,0,0,drop,70,70,0,1,0,1,0
60671,445,0,0,drop,70,70,0,1,0,1,0
60661,445,0,0,drop,70,70,0,1,0,1,0
60660,445,0,0,drop,70,70,0,1,0,1,0
55722,445,0,0,drop,70,70,0,1,0,1,0
55720,445,0,0,drop,70,70,0,1,0,1,0
56047,445,0,0,drop,66,66,0,1,0,1,0
56049,445,0,0,drop,66,66,0,1,0,1,0
56046,445,0,0,drop,66,66,0,1,0,1,0
55716,445,0,0,drop,70,70,0,1,0,1,0
60655,445,0,0,drop,70,70,0,1,0,1,0
55714,445,0,0,drop,70,70,0,1,0,1,0
60654,445,0,0,drop,70,70,0,1,0,1,0
60652,445,0,0,drop,70,70,0,1,0,1,0
60650,445,0,0,drop,70,70,0,1,0,1,0
43916,21,0,0,deny,60,60,0,1,0,1,0
55710,445,0,0,drop,70,70,0,1,0,1,0
60637,445,0,0,drop,70,70,0,1,0,1,0
60635,445,0,0,drop,70,70,0,1,0,1,0
55697,445,0,0,drop,70,70,0,1,0,1,0
56025,445,0,0,drop,66,66,0,1,0,1,0
60629,445,0,0,drop,70,70,0,1,0,1,0
55694,445,0,0,drop,70,70,0,1,0,1,0
56020,445,0,0,drop,66,66,0,1,0,1,0
55690,445,0,0,drop,70,70,0,1,0,1,0
56017,445,0,0,drop,66,66,0,1,0,1,0
55688,445,0,0,drop,70,70,0,1,0,1,0
60617,445,0,0,drop,70,70,0,1,0,1,0
60614,445,0,0,drop,70,70,0,1,0,1,0
60607,445,0,0,drop,70,70,0,1,0,1,0
56013,445,0,0,drop,66,66,0,1,0,1,0
60603,445,0,0,drop,70,70,0,1,0,1,0
60598,445,0,0,drop,70,70,0,1,0,1,0
56008,445,0,0,drop,66,66,0,1,0,1,0
56003,445,0,0,drop,66,66,0,1,0,1,0
56005,445,0,0,drop,66,66,0,1,0,1,0
56004,445,0,0,drop,66,66,0,1,0,1,0
55998,445,0,0,drop,66,66,0,1,0,1,0
55997,445,0,0,drop,66,66,0,1,0,1,0
55676,445,0,0,drop,70,70,0,1,0,1,0
63421,53,63421,53,allow,223,86,137,2,30,1,1
60115,443,39754,443,allow,268,120,148,5,10,3,2
53776,53,0,0,allow,82,82,0,2,40,2,0
56552,53,56552,53,allow,223,86,137,2,30,1,1
62466,53,62466,53,allow,194,87,107,2,30,1,1
40334,53,40334,53,allow,213,87,126,2,30,1,1
55220,53,55080,53,allow,758,96,662,2,30,1,1
57996,53,57996,53,allow,847,110,737,2,30,1,1
56039,53,8952,53,allow,762,98,664,2,30,1,1
60109,443,54198,443,allow,268,120,148,5,10,3,2
50382,80,4705,80,allow,1369,799,570,13,77,7,6
55193,53,9970,53,allow,200,102,98,2,30,1,1
56836,1,16144,1,allow,130,70,60,2,5,1,1
57352,53,30931,53,allow,711,87,624,2,31,1,1
60365,443,2645,443,allow,130,70,60,2,15,1,1
65027,53,8113,53,allow,758,96,662,2,30,1,1
40127,53,0,0,allow,82,82,0,1,31,1,0
55104,53,12993,53,allow,733,85,648,2,31,1,1
55733,53,35309,53,allow,170,87,83,2,31,1,1
56720,53,21366,53,allow,170,87,83,2,31,1,1
56045,53,44616,53,allow,754,94,660,2,31,1,1
55675,445,0,0,drop,70,70,0,1,0,1,0
55674,445,0,0,drop,70,70,0,1,0,1,0
55672,445,0,0,drop,70,70,0,1,0,1,0
55668,445,0,0,drop,70,70,0,1,0,1,0
60593,445,0,0,drop,70,70,0,1,0,1,0
60589,445,0,0,drop,70,70,0,1,0,1,0
55991,445,0,0,drop,66,66,0,1,0,1,0
60587,445,0,0,drop,70,70,0,1,0,1,0
55988,445,0,0,drop,66,66,0,1,0,1,0
50486,80,43523,80,allow,378,192,186,7,21,4,3
51457,443,1251,443,allow,334,70,264,5,17,1,4
50116,22,50116,22,allow,184,120,64,4,4,3,1
64780,53,56336,53,allow,203,86,117,2,29,1,1
50002,53,23419,53,allow,183,102,81,2,30,1,1
64915,53,19337,53,allow,177,94,83,2,29,1,1
48151,123,24928,123,allow,184,94,90,2,30,1,1
50020,53,1594,53,allow,210,102,108,2,30,1,1
55193,53,3630,53,allow,533,102,431,4,42,2,2
52657,53,48551,53,allow,302,210,92,3,30,2,1
52217,80,27362,80,allow,1074,565,509,11,16,6,5
63826,80,41744,80,allow,314,192,122,6,15,4,2
47325,443,49234,443,allow,130,70,60,2,15,1,1
56593,443,58940,443,allow,1165,662,503,11,25,6,5
64153,53,31839,53,allow,213,94,119,2,30,1,1
50368,53,59190,53,allow,70,70,0,1,30,1,0
49289,53,43256,53,allow,177,94,83,2,30,1,1
64656,53,38366,53,allow,718,94,624,2,30,1,1
49767,53,47243,53,allow,185,102,83,2,30,1,1
49817,53,12075,53,allow,167,86,81,2,30,1,1
65299,53,37280,53,allow,177,94,83,2,30,1,1
64224,53,56405,53,allow,280,94,186,2,30,1,1
55275,53,25486,53,allow,213,94,119,2,30,1,1
56643,443,24007,443,allow,1560,988,572,13,21,7,6
60228,443,13572,443,allow,1058,641,417,10,50,6,4
58692,53,28574,53,allow,199,94,105,2,30,1,1
64238,53,60413,53,allow,213,102,111,2,30,1,1
49767,53,2563,53,allow,177,94,83,2,30,1,1
65053,53,62092,53,allow,197,94,103,2,30,1,1
54966,53,31791,53,allow,254,87,167,4,31,2,2
50487,80,25708,80,allow,378,192,186,7,21,4,3
64644,53,30010,53,allow,364,89,275,4,33,2,2
47002,53,47002,53,allow,244,98,146,2,31,1,1
56837,53,14391,53,allow,195,102,93,2,33,1,1
60114,443,25008,443,allow,268,120,148,5,10,3,2
64459,53,56371,53,allow,251,94,157,2,29,1,1
62736,80,60766,80,allow,1516,481,1035,11,15,6,5
54447,53,9967,53,allow,199,94,105,2,29,1,1
39850,53,3565,53,allow,199,94,105,2,29,1,1
46455,53,32632,53,allow,168,78,90,2,30,1,1
50659,53,45075,53,allow,168,78,90,2,30,1,1
49289,53,16244,53,allow,177,94,83,2,30,1,1
56345,53,18764,53,allow,199,94,105,2,30,1,1
50287,53,28262,53,allow,781,94,687,2,30,1,1
50239,53,31652,53,allow,183,94,89,2,31,1,1
37759,53,22729,53,allow,164,78,86,2,30,1,1
57284,443,12442,443,allow,1402,917,485,12,27,7,5
54100,80,44998,80,allow,78,78,0,1,5,1,0
50318,53,54870,53,allow,94,94,0,1,30,1,0
65299,53,60442,53,allow,177,94,83,2,30,1,1
54101,80,21675,80,allow,78,78,0,1,5,1,0
49943,53,18559,53,allow,718,94,624,2,30,1,1
43851,53,43851,53,allow,227,90,137,2,30,1,1
48737,53,48737,53,allow,227,90,137,2,30,1,1
49872,53,36268,53,allow,331,126,205,2,30,1,1
49995,53,57379,53,allow,197,102,95,2,30,1,1
56006,53,33224,53,allow,183,102,81,2,30,1,1
55261,53,37106,53,allow,177,94,83,2,30,1,1
64902,53,39715,53,allow,231,110,121,2,30,1,1
55619,53,59792,53,allow,241,78,163,2,30,1,1
57364,53,64164,53,allow,177,94,83,2,30,1,1
55757,53,48609,53,allow,177,94,83,2,30,1,1
64968,53,21697,53,allow,250,102,148,2,31,1,1
65521,53,52937,53,allow,167,86,81,2,30,1,1
49528,53,57566,53,allow,177,94,83,2,30,1,1
55009,53,51311,53,allow,241,78,163,2,30,1,1
55987,445,0,0,drop,66,66,0,1,0,1,0
55985,445,0,0,drop,66,66,0,1,0,1,0
55656,445,0,0,drop,70,70,0,1,0,1,0
55655,445,0,0,drop,70,70,0,1,0,1,0
55984,445,0,0,drop,66,66,0,1,0,1,0
55645,445,0,0,drop,70,70,0,1,0,1,0
60586,445,0,0,drop,70,70,0,1,0,1,0
60573,445,0,0,drop,70,70,0,1,0,1,0
60569,445,0,0,drop,70,70,0,1,0,1,0
55632,445,0,0,drop,70,70,0,1,0,1,0
55973,445,0,0,drop,66,66,0,1,0,1,0
55965,445,0,0,drop,66,66,0,1,0,1,0
55628,445,0,0,drop,70,70,0,1,0,1,0
55963,445,0,0,drop,66,66,0,1,0,1,0
55618,445,0,0,drop,70,70,0,1,0,1,0
55616,445,0,0,drop,70,70,0,1,0,1,0
55614,445,0,0,drop,70,70,0,1,0,1,0
55611,445,0,0,drop,70,70,0,1,0,1,0
55955,445,0,0,drop,66,66,0,1,0,1,0
55952,445,0,0,drop,66,66,0,1,0,1,0
55605,445,0,0,drop,70,70,0,1,0,1,0
60548,445,0,0,drop,70,70,0,1,0,1,0
60547,445,0,0,drop,70,70,0,1,0,1,0
60549,445,0,0,drop,70,70,0,1,0,1,0
55937,445,0,0,drop,66,66,0,1,0,1,0
55940,445,0,0,drop,66,66,0,1,0,1,0
55934,445,0,0,drop,66,66,0,1,0,1,0
55935,445,0,0,drop,66,66,0,1,0,1,0
55939,445,0,0,drop,66,66,0,1,0,1,0
55933,445,0,0,drop,66,66,0,1,0,1,0
55938,445,0,0,drop,66,66,0,1,0,1,0
55932,445,0,0,drop,66,66,0,1,0,1,0
59312,22,59312,22,deny,327,140,187,4,0,2,2
55598,445,0,0,drop,70,70,0,1,0,1,0
55591,445,0,0,drop,70,70,0,1,0,1,0
55590,445,0,0,drop,70,70,0,1,0,1,0
60544,445,0,0,drop,70,70,0,1,0,1,0
60540,445,0,0,drop,70,70,0,1,0,1,0
60533,445,0,0,drop,70,70,0,1,0,1,0
55920,445,0,0,drop,66,66,0,1,0,1,0
55919,445,0,0,drop,66,66,0,1,0,1,0
55917,445,0,0,drop,66,66,0,1,0,1,0
55586,445,0,0,drop,70,70,0,1,0,1,0
60530,445,0,0,drop,70,70,0,1,0,1,0
55585,445,0,0,drop,70,70,0,1,0,1,0
60527,445,0,0,drop,70,70,0,1,0,1,0
60519,445,0,0,drop,70,70,0,1,0,1,0
60516,445,0,0,drop,70,70,0,1,0,1,0
60515,445,0,0,drop,70,70,0,1,0,1,0
60510,445,0,0,drop,70,70,0,1,0,1,0
60508,445,0,0,drop,70,70,0,1,0,1,0
55564,445,0,0,drop,70,70,0,1,0,1,0
55898,445,0,0,drop,66,66,0,1,0,1,0
60498,445,0,0,drop,70,70,0,1,0,1,0
58110,23,0,0,deny,60,60,0,1,0,1,0
55560,445,0,0,drop,70,70,0,1,0,1,0
55891,445,0,0,drop,66,66,0,1,0,1,0
55888,445,0,0,drop,66,66,0,1,0,1,0
55556,445,0,0,drop,70,70,0,1,0,1,0
60489,445,0,0,drop,70,70,0,1,0,1,0
60482,445,0,0,drop,70,70,0,1,0,1,0
60479,445,0,0,drop,70,70,0,1,0,1,0
55884,445,0,0,drop,66,66,0,1,0,1,0
64589,53,29733,53,allow,742,88,654,2,30,1,1
55547,53,56945,53,allow,738,86,652,2,30,1,1
38085,443,38085,443,allow,1452,817,635,16,20,9,7
41919,53,41919,53,allow,223,86,137,2,30,1,1
49528,53,46480,53,allow,170,87,83,2,30,1,1
44455,53,21066,53,allow,221,75,146,2,30,1,1
46741,53,52840,53,allow,221,75,146,2,30,1,1
64614,53,3783,53,allow,168,86,82,2,30,1,1
57424,53,20131,53,allow,170,87,83,2,31,1,1
38409,443,38409,443,allow,1452,817,635,16,20,9,7
55940,53,24862,53,allow,168,86,82,2,30,1,1
56717,53,9802,53,allow,711,87,624,2,30,1,1
50178,53,43275,53,allow,172,88,84,2,31,1,1
55782,53,3411,53,allow,238,87,151,2,30,1,1
56336,53,18502,53,allow,192,98,94,2,30,1,1
56131,53,17639,53,allow,238,87,151,2,30,1,1
57000,53,25419,53,allow,188,96,92,2,31,1,1
56625,53,10109,53,allow,711,87,624,2,31,1,1
55664,53,52942,53,allow,711,87,624,2,31,1,1
57073,53,4074,53,allow,99,99,0,1,31,1,0
60476,445,0,0,drop,70,70,0,1,0,1,0
55549,445,0,0,drop,70,70,0,1,0,1,0
58455,80,58455,80,allow,348,132,216,6,15,3,3
60469,445,0,0,drop,70,70,0,1,0,1,0
55877,445,0,0,drop,66,66,0,1,0,1,0
55869,445,0,0,drop,66,66,0,1,0,1,0
55875,445,0,0,drop,66,66,0,1,0,1,0
55872,445,0,0,drop,66,66,0,1,0,1,0
55866,445,0,0,drop,66,66,0,1,0,1,0
55868,445,0,0,drop,66,66,0,1,0,1,0
55865,445,0,0,drop,66,66,0,1,0,1,0
55546,445,0,0,drop,70,70,0,1,0,1,0
55545,445,0,0,drop,70,70,0,1,0,1,0
55544,445,0,0,drop,70,70,0,1,0,1,0
55542,445,0,0,drop,70,70,0,1,0,1,0
55540,445,0,0,drop,70,70,0,1,0,1,0
60466,445,0,0,drop,70,70,0,1,0,1,0
60464,445,0,0,drop,70,70,0,1,0,1,0
55864,445,0,0,drop,66,66,0,1,0,1,0
60459,445,0,0,drop,70,70,0,1,0,1,0
55526,445,0,0,drop,70,70,0,1,0,1,0
55525,445,0,0,drop,70,70,0,1,0,1,0
55859,445,0,0,drop,66,66,0,1,0,1,0
55519,445,0,0,drop,70,70,0,1,0,1,0
55858,445,0,0,drop,66,66,0,1,0,1,0
55856,445,0,0,drop,66,66,0,1,0,1,0
37854,443,37854,443,allow,1452,817,635,16,20,9,7
55261,53,19096,53,allow,177,94,83,2,29,1,1
55010,53,1751,53,allow,245,94,151,2,29,1,1
55782,53,43309,53,allow,245,94,151,2,29,1,1
55757,53,56073,53,allow,177,94,83,2,29,1,1
57000,53,24193,53,allow,194,102,92,2,30,1,1
37628,443,37628,443,allow,1452,817,635,16,20,9,7
55195,53,34217,53,allow,969,86,883,2,29,1,1
49349,53,12679,53,allow,405,110,295,4,38,2,2
50042,53,35274,53,allow,738,86,652,2,29,1,1
49912,53,4964,53,allow,733,94,639,2,29,1,1
55733,53,46336,53,allow,177,94,83,2,29,1,1
57364,53,42885,53,allow,177,94,83,2,29,1,1
65521,53,38042,53,allow,167,86,81,2,29,1,1
55782,53,22320,53,allow,245,94,151,2,29,1,1
55734,53,29847,53,allow,733,94,639,2,30,1,1
57396,53,31064,53,allow,183,94,89,2,30,1,1
56131,53,29991,53,allow,245,94,151,2,30,1,1
56720,53,20064,53,allow,177,94,83,2,30,1,1
57396,53,6439,53,allow,183,94,89,2,30,1,1
55940,53,15244,53,allow,168,86,82,2,30,1,1
57424,53,34088,53,allow,177,94,83,2,30,1,1
55223,53,34886,53,allow,168,86,82,2,31,1,1
50273,53,27219,53,allow,718,94,624,2,30,1,1
59282,123,52231,123,allow,184,94,90,2,30,1,1
58132,80,58132,80,allow,348,132,216,6,15,3,3
56131,53,25151,53,allow,245,94,151,2,30,1,1
50239,53,39194,53,allow,183,94,89,2,30,1,1
50642,53,60676,53,allow,173,94,79,2,30,1,1
55122,53,24716,53,allow,173,94,79,2,30,1,1
64752,53,32902,53,allow,186,102,84,2,30,1,1
56134,53,19695,53,allow,167,86,81,2,30,1,1
57000,53,6517,53,allow,194,102,92,2,30,1,1
57396,53,65107,53,allow,183,94,89,2,30,1,1
64879,53,23535,53,allow,173,94,79,2,30,1,1
65436,53,10665,53,allow,102,102,0,1,30,1,0
55112,53,21380,53,allow,245,94,151,2,30,1,1
64879,53,13290,53,allow,165,86,79,2,30,1,1
56720,53,7909,53,allow,177,94,83,2,30,1,1
42841,53,47596,53,allow,168,78,90,2,30,1,1
40107,53,34833,53,allow,168,78,90,2,30,1,1
37580,443,37580,443,allow,1452,817,635,16,20,9,7
49277,53,3822,53,allow,821,102,719,2,30,1,1
55733,53,30284,53,allow,177,94,83,2,30,1,1
50239,53,26724,53,allow,183,94,89,2,30,1,1
56134,53,7161,53,allow,167,86,81,2,30,1,1
49216,53,26832,53,allow,401,142,259,2,30,1,1
56006,53,57116,53,allow,183,102,81,2,29,1,1
55782,53,15555,53,allow,245,94,151,2,29,1,1
56759,53,4446,53,allow,177,94,83,2,30,1,1
49528,53,36226,53,allow,177,94,83,2,29,1,1
56272,53,49117,53,allow,235,86,149,2,30,1,1
49594,53,57290,53,allow,301,102,199,2,30,1,1
56459,53,5237,53,allow,177,94,83,2,30,1,1
65047,53,53893,53,allow,196,86,110,2,30,1,1
65530,53,42402,53,allow,194,102,92,2,30,1,1
49528,53,13440,53,allow,177,94,83,2,30,1,1
55770,53,54138,53,allow,167,86,81,2,30,1,1
56759,53,10512,53,allow,177,94,83,2,30,1,1
57424,53,65254,53,allow,177,94,83,2,30,1,1
49723,53,39151,53,allow,427,90,337,4,41,2,2
42156,80,50916,80,allow,1323,335,988,10,15,5,5
56131,53,31536,53,allow,245,94,151,2,30,1,1
64531,53,13391,53,allow,754,94,660,2,30,1,1
64614,53,55438,53,allow,168,86,82,2,30,1,1
65047,53,60656,53,allow,184,102,82,2,30,1,1
49431,53,38249,53,allow,767,102,665,2,30,1,1
50642,53,41798,53,allow,165,86,79,2,30,1,1
49557,53,33015,53,allow,211,102,109,2,30,1,1
64286,53,59300,53,allow,274,94,180,2,30,1,1
55910,53,42664,53,allow,183,94,89,2,30,1,1
55910,53,63749,53,allow,183,94,89,2,31,1,1
56893,53,20902,53,allow,177,94,83,2,31,1,1
55479,53,50336,53,allow,184,94,90,2,31,1,1
64751,53,58884,53,allow,178,94,84,2,31,1,1
55037,443,6546,443,allow,130,70,60,3,5,2,1
56985,53,39491,53,allow,165,86,79,2,30,1,1
50589,53,3456,53,allow,177,94,83,2,30,1,1
55122,53,17738,53,allow,173,94,79,2,30,1,1
55854,445,0,0,drop,66,66,0,1,0,1,0
60455,445,0,0,drop,70,70,0,1,0,1,0
55844,445,0,0,drop,66,66,0,1,0,1,0
55500,445,0,0,drop,70,70,0,1,0,1,0
55836,445,0,0,drop,66,66,0,1,0,1,0
60432,445,0,0,drop,70,70,0,1,0,1,0
55490,445,0,0,drop,70,70,0,1,0,1,0
55488,445,0,0,drop,70,70,0,1,0,1,0
55487,445,0,0,drop,70,70,0,1,0,1,0
55834,445,0,0,drop,66,66,0,1,0,1,0
55483,445,0,0,drop,70,70,0,1,0,1,0
55827,445,0,0,drop,66,66,0,1,0,1,0
55820,445,0,0,drop,66,66,0,1,0,1,0
55478,445,0,0,drop,70,70,0,1,0,1,0
60422,445,0,0,drop,70,70,0,1,0,1,0
60420,445,0,0,drop,70,70,0,1,0,1,0
60419,445,0,0,drop,70,70,0,1,0,1,0
55470,445,0,0,drop,70,70,0,1,0,1,0
55811,445,0,0,drop,66,66,0,1,0,1,0
55810,445,0,0,drop,66,66,0,1,0,1,0
55808,445,0,0,drop,66,66,0,1,0,1,0
55809,445,0,0,drop,66,66,0,1,0,1,0
55807,445,0,0,drop,66,66,0,1,0,1,0
55806,445,0,0,drop,66,66,0,1,0,1,0
55804,445,0,0,drop,66,66,0,1,0,1,0
55803,445,0,0,drop,66,66,0,1,0,1,0
55462,445,0,0,drop,70,70,0,1,0,1,0
50878,23,0,0,deny,60,60,0,1,0,1,0
60413,445,0,0,drop,70,70,0,1,0,1,0
60405,445,0,0,drop,70,70,0,1,0,1,0
60404,445,0,0,drop,70,70,0,1,0,1,0
55791,445,0,0,drop,66,66,0,1,0,1,0
55790,445,0,0,drop,66,66,0,1,0,1,0
55789,445,0,0,drop,66,66,0,1,0,1,0
55457,445,0,0,drop,70,70,0,1,0,1,0
60399,445,0,0,drop,70,70,0,1,0,1,0
60392,445,0,0,drop,70,70,0,1,0,1,0
60391,445,0,0,drop,70,70,0,1,0,1,0
60387,445,0,0,drop,70,70,0,1,0,1,0
60382,445,0,0,drop,70,70,0,1,0,1,0
60380,445,0,0,drop,70,70,0,1,0,1,0
55439,445,0,0,drop,70,70,0,1,0,1,0
55436,445,0,0,drop,70,70,0,1,0,1,0
55769,445,0,0,drop,66,66,0,1,0,1,0
41114,53,0,0,allow,82,82,0,1,30,1,0
55897,53,59750,53,allow,733,85,648,2,30,1,1
55426,53,8033,53,allow,181,98,83,2,30,1,1
55910,53,5285,53,allow,182,93,89,2,30,1,1
56437,53,9819,53,allow,749,94,655,2,30,1,1
55131,53,48118,53,allow,744,95,649,2,30,1,1
55180,53,64280,53,allow,780,93,687,2,31,1,1
55164,53,9551,53,allow,170,87,83,2,31,1,1
56141,53,2789,53,allow,184,94,90,2,31,1,1
50306,53,23964,53,allow,814,110,704,2,30,1,1
46219,53,46219,53,allow,237,91,146,2,33,1,1
57209,53,54053,53,allow,764,99,665,2,30,1,1
55148,53,64223,53,allow,711,87,624,2,30,1,1
55223,53,54493,53,allow,168,86,82,2,31,1,1
55479,53,40449,53,allow,184,94,90,2,31,1,1
50669,53,9177,53,allow,578,286,292,9,16,5,4
55471,53,27819,53,allow,256,93,163,2,30,1,1
55770,53,35170,53,allow,166,85,81,2,30,1,1
56956,53,28771,53,allow,182,93,89,2,30,1,1
65021,53,29006,53,allow,256,93,163,2,30,1,1
49867,53,44107,53,allow,170,87,83,2,30,1,1
50313,53,2331,53,allow,744,95,649,2,30,1,1
57166,53,41004,53,allow,170,87,83,2,30,1,1
51594,53,51594,53,allow,219,92,127,2,30,1,1
58688,53,58688,53,allow,235,92,143,2,30,1,1
55727,53,47747,53,allow,701,88,613,2,31,1,1
55253,53,63534,53,allow,754,94,660,2,31,1,1
57020,53,49369,53,allow,738,86,652,2,31,1,1
49168,53,10918,53,allow,192,98,94,2,31,1,1
60373,445,0,0,drop,70,70,0,1,0,1,0
55431,445,0,0,drop,70,70,0,1,0,1,0
55428,445,0,0,drop,70,70,0,1,0,1,0
55760,445,0,0,drop,66,66,0,1,0,1,0
55759,445,0,0,drop,66,66,0,1,0,1,0
56956,53,61460,53,allow,183,94,89,2,30,1,1
60358,445,0,0,drop,70,70,0,1,0,1,0
60351,445,0,0,drop,70,70,0,1,0,1,0
55755,445,0,0,drop,66,66,0,1,0,1,0
55421,445,0,0,drop,70,70,0,1,0,1,0
55419,445,0,0,drop,70,70,0,1,0,1,0
60344,445,0,0,drop,70,70,0,1,0,1,0
56715,53,50292,53,allow,807,94,713,2,30,1,1
48521,53,27557,53,allow,78,78,0,1,30,1,0
64566,53,24742,53,allow,194,102,92,2,30,1,1
65000,53,35253,53,allow,184,102,82,2,30,1,1
55426,53,25381,53,allow,177,94,83,2,30,1,1
44870,80,28005,80,allow,1119,1045,74,7,14,6,1
50589,53,31342,53,allow,177,94,83,2,29,1,1
57424,53,34696,53,allow,177,94,83,2,30,1,1
49867,53,10689,53,allow,177,94,83,2,30,1,1
49867,53,63133,53,allow,177,94,83,2,30,1,1
57305,443,15646,443,allow,1574,1089,485,13,15,8,5
40549,443,43115,443,allow,1352,691,661,14,42,8,6
52437,443,30974,443,allow,384,384,0,7,33,7,0
63927,53,2248,53,allow,374,101,273,4,33,2,2
41230,443,4213,443,allow,234,234,0,4,11,4,0
56628,80,40894,80,allow,234,234,0,4,11,4,0
50159,53,16650,53,allow,94,94,0,1,29,1,0
56985,53,40638,53,allow,165,86,79,2,29,1,1
50178,53,59652,53,allow,178,94,84,2,29,1,1
55244,53,54182,53,allow,186,102,84,2,30,1,1
57000,53,32346,53,allow,194,102,92,2,30,1,1
55770,53,28096,53,allow,167,86,81,2,29,1,1
49867,53,7070,53,allow,177,94,83,2,29,1,1
65221,53,41318,53,allow,199,102,97,2,30,1,1
55479,53,22790,53,allow,184,94,90,2,30,1,1
42117,80,40456,80,allow,1056,682,374,10,15,6,4
56893,53,7619,53,allow,177,94,83,2,30,1,1
49718,53,50641,53,allow,184,94,90,2,30,1,1
64016,53,54267,53,allow,183,94,89,2,30,1,1
56292,53,23956,53,allow,197,102,95,2,30,1,1
55164,53,14668,53,allow,177,94,83,2,30,1,1
56694,53,57041,53,allow,196,102,94,2,30,1,1
57073,53,22592,53,allow,197,102,95,2,33,1,1
64867,53,27823,53,allow,765,102,663,2,30,1,1
56472,53,44784,53,allow,177,94,83,2,30,1,1
56715,53,19827,53,allow,184,94,90,2,30,1,1
56568,443,49242,443,allow,1277,705,572,13,25,7,6
64052,53,43180,53,allow,211,102,109,2,30,1,1
56141,53,19077,53,allow,184,94,90,2,30,1,1
56571,53,44608,53,allow,211,102,109,2,30,1,1
65221,53,47234,53,allow,199,102,97,2,30,1,1
55770,53,17489,53,allow,167,86,81,2,30,1,1
55820,53,26876,53,allow,184,94,90,2,30,1,1
55264,53,44429,53,allow,177,94,83,2,30,1,1
57166,53,28476,53,allow,177,94,83,2,30,1,1
64710,53,46845,53,allow,393,110,283,2,30,1,1
53210,80,7510,80,allow,1726,940,786,8,51,5,3
56956,53,13948,53,allow,183,94,89,2,30,1,1
60608,53,20949,53,allow,199,94,105,2,30,1,1
57155,53,11661,53,allow,396,102,294,2,30,1,1
41474,443,44338,443,allow,190,70,120,4,15,2,2
59860,443,59422,443,allow,2165,987,1178,17,40,8,9
40333,80,15004,80,allow,1049,975,74,6,15,5,1
49173,80,62950,80,allow,254,128,126,5,15,3,2
64934,53,52297,53,allow,197,102,95,2,33,1,1
55244,53,5418,53,allow,186,102,84,2,29,1,1
64800,53,3701,53,allow,343,92,251,4,50,2,2
36811,53,36811,53,allow,227,90,137,2,29,1,1
60632,53,3971,53,allow,179,86,93,2,29,1,1
65239,53,28035,53,allow,757,102,655,2,29,1,1
64046,53,35754,53,allow,259,110,149,2,29,1,1
64752,53,22741,53,allow,178,94,84,2,29,1,1
64935,53,42263,53,allow,313,94,219,2,29,1,1
56720,53,11601,53,allow,177,94,83,2,29,1,1
56459,53,48405,53,allow,177,94,83,2,30,1,1
56141,53,30553,53,allow,184,94,90,2,30,1,1
50000,53,56621,53,allow,216,102,114,2,29,1,1
38936,53,29060,53,allow,215,86,129,2,30,1,1
49718,53,42238,53,allow,807,94,713,2,30,1,1
49793,53,43171,53,allow,718,94,624,2,30,1,1
65325,53,48288,53,allow,216,110,106,2,30,1,1
56717,53,10005,53,allow,183,94,89,2,30,1,1
65324,53,6556,53,allow,749,94,655,2,30,1,1
65221,53,62850,53,allow,199,102,97,2,30,1,1
64016,53,50450,53,allow,183,94,89,2,30,1,1
49913,53,16997,53,allow,216,110,106,2,31,1,1
55919,53,44823,53,allow,177,94,83,2,30,1,1
53211,80,10536,80,allow,194,128,66,4,51,3,1
65000,53,40784,53,allow,168,86,82,2,30,1,1
56956,53,49926,53,allow,183,94,89,2,30,1,1
55164,53,64984,53,allow,177,94,83,2,30,1,1
64493,53,11797,53,allow,199,102,97,2,30,1,1
55223,53,62144,53,allow,168,86,82,2,30,1,1
56472,53,22766,53,allow,177,94,83,2,30,1,1
57166,53,13391,53,allow,177,94,83,2,30,1,1
55910,53,26815,53,allow,183,94,89,2,30,1,1
55479,53,23646,53,allow,184,94,90,2,31,1,1
57342,53,55197,53,allow,167,86,81,2,31,1,1
55919,53,46329,53,allow,177,94,83,2,31,1,1
56550,53,64220,53,allow,183,94,89,2,31,1,1
64555,53,10175,53,allow,469,97,372,4,49,2,2
64751,53,57978,53,allow,178,94,84,2,30,1,1
57166,53,52593,53,allow,177,94,83,2,30,1,1
61703,80,42538,80,allow,1494,954,540,13,51,8,5
55264,53,25192,53,allow,177,94,83,2,30,1,1
46726,53,27470,53,allow,168,78,90,2,30,1,1
49903,53,65277,53,allow,231,110,121,2,30,1,1
55043,53,37629,53,allow,167,86,81,2,30,1,1
55164,53,26323,53,allow,177,94,83,2,30,1,1
56586,53,63496,53,allow,177,94,83,2,31,1,1
64588,53,41773,53,allow,173,94,79,2,31,1,1
60341,445,0,0,drop,70,70,0,1,0,1,0
60340,445,0,0,drop,70,70,0,1,0,1,0
55749,445,0,0,drop,66,66,0,1,0,1,0
55418,445,0,0,drop,70,70,0,1,0,1,0
55745,445,0,0,drop,66,66,0,1,0,1,0
55744,445,0,0,drop,66,66,0,1,0,1,0
55741,445,0,0,drop,66,66,0,1,0,1,0
55417,445,0,0,drop,70,70,0,1,0,1,0
55416,445,0,0,drop,70,70,0,1,0,1,0
55411,445,0,0,drop,70,70,0,1,0,1,0
55412,445,0,0,drop,70,70,0,1,0,1,0
55739,445,0,0,drop,66,66,0,1,0,1,0
55738,445,0,0,drop,66,66,0,1,0,1,0
55736,445,0,0,drop,66,66,0,1,0,1,0
60338,445,0,0,drop,70,70,0,1,0,1,0
55398,445,0,0,drop,70,70,0,1,0,1,0
60335,445,0,0,drop,70,70,0,1,0,1,0
55397,445,0,0,drop,70,70,0,1,0,1,0
55733,445,0,0,drop,66,66,0,1,0,1,0
55387,445,0,0,drop,70,70,0,1,0,1,0
60331,445,0,0,drop,70,70,0,1,0,1,0
55730,445,0,0,drop,66,66,0,1,0,1,0
55728,445,0,0,drop,66,66,0,1,0,1,0
55727,445,0,0,drop,66,66,0,1,0,1,0
55725,445,0,0,drop,66,66,0,1,0,1,0
60328,445,0,0,drop,70,70,0,1,0,1,0
55376,445,0,0,drop,70,70,0,1,0,1,0
55713,445,0,0,drop,66,66,0,1,0,1,0
55372,445,0,0,drop,70,70,0,1,0,1,0
55706,445,0,0,drop,66,66,0,1,0,1,0
60303,445,0,0,drop,70,70,0,1,0,1,0
55361,445,0,0,drop,70,70,0,1,0,1,0
55360,445,0,0,drop,70,70,0,1,0,1,0
55358,445,0,0,drop,70,70,0,1,0,1,0
55355,445,0,0,drop,70,70,0,1,0,1,0
55704,445,0,0,drop,66,66,0,1,0,1,0
55695,445,0,0,drop,66,66,0,1,0,1,0
55691,445,0,0,drop,66,66,0,1,0,1,0
55349,445,0,0,drop,70,70,0,1,0,1,0
55342,445,0,0,drop,70,70,0,1,0,1,0
60292,445,0,0,drop,70,70,0,1,0,1,0
60293,445,0,0,drop,70,70,0,1,0,1,0
60291,445,0,0,drop,70,70,0,1,0,1,0
55674,445,0,0,drop,66,66,0,1,0,1,0
55677,445,0,0,drop,66,66,0,1,0,1,0
55679,445,0,0,drop,66,66,0,1,0,1,0
55680,445,0,0,drop,66,66,0,1,0,1,0
55681,445,0,0,drop,66,66,0,1,0,1,0
55678,445,0,0,drop,66,66,0,1,0,1,0
55675,445,0,0,drop,66,66,0,1,0,1,0
55673,445,0,0,drop,66,66,0,1,0,1,0
55334,445,0,0,drop,70,70,0,1,0,1,0
55330,445,0,0,drop,70,70,0,1,0,1,0
60288,445,0,0,drop,70,70,0,1,0,1,0
60282,445,0,0,drop,70,70,0,1,0,1,0
60276,445,0,0,drop,70,70,0,1,0,1,0
55329,445,0,0,drop,70,70,0,1,0,1,0
55658,445,0,0,drop,66,66,0,1,0,1,0
55661,445,0,0,drop,66,66,0,1,0,1,0
60273,445,0,0,drop,70,70,0,1,0,1,0
60267,445,0,0,drop,70,70,0,1,0,1,0
60266,445,0,0,drop,70,70,0,1,0,1,0
60263,445,0,0,drop,70,70,0,1,0,1,0
55324,445,0,0,drop,70,70,0,1,0,1,0
60254,445,0,0,drop,70,70,0,1,0,1,0
60251,445,0,0,drop,70,70,0,1,0,1,0
64021,53,21293,53,allow,190,97,93,2,30,1,1
55985,53,10494,53,allow,711,87,624,2,30,1,1
49144,443,40050,443,allow,130,70,60,3,5,2,1
44129,53,44129,53,allow,182,81,101,2,30,1,1
56445,53,12217,53,allow,711,87,624,2,30,1,1
56292,53,41121,53,allow,194,99,95,2,30,1,1
49845,53,6637,53,allow,188,96,92,2,31,1,1
55912,53,3506,53,allow,184,94,90,2,30,1,1
55620,53,14188,53,allow,170,87,83,2,30,1,1
59843,443,50473,443,allow,1427,726,701,17,46,8,9
65251,53,48559,53,allow,198,101,97,2,30,1,1
57342,53,37406,53,allow,166,85,81,2,31,1,1
49106,53,49106,53,allow,1415,689,726,3,30,2,1
55820,53,49464,53,allow,184,94,90,2,30,1,1
56472,53,12167,53,allow,711,87,624,2,30,1,1
55851,53,15581,53,allow,749,94,655,2,30,1,1
45663,53,45663,53,allow,507,129,378,2,30,1,1
55264,53,35896,53,allow,170,87,83,2,30,1,1
64566,53,1628,53,allow,188,96,92,2,30,1,1
49825,53,46479,53,allow,793,101,692,2,30,1,1
64535,53,14565,53,allow,763,101,662,2,30,1,1
55267,53,18171,53,allow,168,86,82,2,31,1,1
49913,53,50642,53,allow,216,110,106,2,31,1,1
55640,53,50783,53,allow,742,88,654,2,31,1,1
57009,53,27487,53,allow,1435,98,1337,4,34,2,2
59842,443,63853,443,allow,1307,666,641,15,46,7,8
65107,53,44757,53,allow,266,87,179,4,33,2,2
52658,80,12733,80,allow,214,140,74,4,15,3,1
56694,53,29552,53,allow,192,98,94,2,30,1,1
49483,80,60356,80,allow,318,192,126,6,40,4,2
64751,53,29777,53,allow,172,88,84,2,30,1,1
56100,53,43759,53,allow,701,88,613,2,30,1,1
50134,53,12196,53,allow,768,99,669,2,30,1,1
64493,53,45305,53,allow,198,101,97,2,30,1,1
56850,53,62960,53,allow,763,101,662,2,31,1,1
56889,53,34055,53,allow,170,87,83,2,31,1,1
50233,53,55519,53,allow,756,95,661,2,31,1,1
56550,53,60039,53,allow,182,93,89,2,31,1,1
55142,53,21559,53,allow,770,101,669,2,31,1,1
54973,53,47397,53,allow,731,91,640,2,31,1,1
56374,53,38425,53,allow,770,102,668,2,31,1,1
55368,53,50855,53,allow,760,97,663,2,31,1,1
49166,53,45421,53,allow,770,101,669,2,31,1,1
56757,53,3651,53,allow,783,96,687,2,31,1,1
64791,53,42823,53,allow,184,94,90,2,31,1,1
57100,53,41347,53,allow,192,90,102,2,31,1,1
56612,53,36295,53,allow,184,94,90,2,31,1,1
55105,53,18912,53,allow,747,93,654,2,31,1,1
64766,53,59121,53,allow,212,108,104,2,31,1,1
47493,53,47493,53,allow,227,92,135,2,31,1,1
50196,53,48778,53,allow,756,95,661,2,31,1,1
56308,53,54603,53,allow,184,94,90,2,31,1,1
60247,445,0,0,drop,70,70,0,1,0,1,0
55311,445,0,0,drop,70,70,0,1,0,1,0
55308,445,0,0,deny,70,70,0,1,0,1,0
42110,80,55658,80,allow,1056,682,374,10,15,6,4
55743,53,57939,53,allow,165,86,79,2,30,1,1
50281,53,4430,53,allow,767,102,665,2,30,1,1
55636,445,0,0,drop,66,66,0,1,0,1,0
55303,445,0,0,drop,70,70,0,1,0,1,0
55302,445,0,0,drop,70,70,0,1,0,1,0
50577,23,0,0,deny,60,60,0,1,0,1,0
55267,53,21533,53,allow,168,86,82,2,30,1,1
64021,53,18880,53,allow,195,102,93,2,29,1,1
64188,53,49847,53,allow,216,94,122,2,29,1,1
65325,53,33633,53,allow,216,110,106,2,29,1,1
55264,53,48968,53,allow,177,94,83,2,30,1,1
56141,53,40551,53,allow,713,94,619,4,54,2,2
50019,80,29484,80,allow,814,674,140,6,28,4,2
65107,53,56824,53,allow,266,87,179,4,32,2,2
56292,443,38026,443,allow,162,102,60,2,5,1,1
64554,53,30164,53,allow,94,94,0,1,29,1,0
55820,53,22468,53,allow,184,94,90,2,29,1,1
64493,53,42355,53,allow,199,102,97,2,29,1,1
49771,53,57877,53,allow,177,94,83,2,29,1,1
56717,53,4326,53,allow,183,94,89,2,29,1,1
50320,53,19368,53,allow,754,94,660,2,29,1,1
64566,53,26350,53,allow,194,102,92,2,29,1,1
56717,53,57782,53,allow,183,94,89,2,29,1,1
56694,53,47429,53,allow,196,102,94,2,29,1,1
39444,53,0,0,allow,86,86,0,1,29,1,0
64021,53,54662,53,allow,195,102,93,2,30,1,1
46176,53,12412,53,allow,168,78,90,2,30,1,1
49523,80,32458,80,allow,1399,826,573,11,38,6,5
56506,53,39583,53,allow,807,94,713,2,30,1,1
55912,53,46949,53,allow,184,94,90,2,30,1,1
59325,53,7735,53,allow,211,78,133,2,30,1,1
55223,53,31444,53,allow,168,86,82,2,30,1,1
55738,53,4750,53,allow,309,94,215,2,30,1,1
49913,53,47185,53,allow,216,110,106,2,30,1,1
49168,53,14343,53,allow,196,102,94,2,30,1,1
55912,53,61558,53,allow,184,94,90,2,30,1,1
64722,53,58551,53,allow,214,110,104,2,30,1,1
56308,53,37236,53,allow,184,94,90,2,31,1,1
49713,53,55679,53,allow,734,94,640,2,30,1,1
64751,53,33597,53,allow,178,94,84,2,30,1,1
49925,80,49556,80,allow,1126,609,517,11,15,6,5
65201,53,45437,53,allow,334,94,240,2,30,1,1
65439,53,54009,53,allow,168,86,82,2,30,1,1
56586,53,7181,53,allow,177,94,83,2,30,1,1
57342,53,19842,53,allow,167,86,81,2,30,1,1
49891,53,62229,53,allow,822,102,720,2,30,1,1
49525,80,7498,80,allow,454,262,192,8,38,5,3
49701,53,61542,53,allow,197,102,95,2,30,1,1
55620,53,23313,53,allow,177,94,83,2,30,1,1
60544,53,63580,53,allow,211,78,133,2,30,1,1
65251,53,53427,53,allow,199,102,97,2,30,1,1
64588,53,47202,53,allow,165,86,79,2,30,1,1
49202,53,58969,53,allow,295,86,209,2,30,1,1
64722,53,36705,53,allow,214,110,104,2,30,1,1
65473,53,40939,53,allow,309,94,215,2,30,1,1
56292,53,4815,53,allow,197,102,95,2,30,1,1
55896,53,29667,53,allow,733,94,639,2,30,1,1
49168,53,25368,53,allow,196,102,94,2,30,1,1
49971,53,19251,53,allow,779,110,669,2,30,1,1
56966,53,53823,53,allow,177,94,83,2,30,1,1
65251,53,42946,53,allow,199,102,97,2,30,1,1
49269,53,8382,53,allow,198,110,88,2,30,1,1
59977,53,61405,53,allow,168,78,90,2,30,1,1
50430,53,3410,53,allow,789,102,687,2,30,1,1
49891,53,46766,53,allow,199,102,97,2,30,1,1
55743,53,47802,53,allow,165,86,79,2,30,1,1
55620,53,48166,53,allow,177,94,83,2,30,1,1
56889,53,24379,53,allow,177,94,83,2,30,1,1
42166,443,46667,443,allow,162,102,60,2,5,1,1
46360,443,51396,443,allow,1053,566,487,10,16,6,4
65107,53,20258,53,allow,266,87,179,4,32,2,2
64638,53,33072,53,allow,215,102,113,2,29,1,1
57161,53,42229,53,allow,224,102,122,2,29,1,1
53692,53,53692,53,allow,262,82,180,2,29,1,1
49524,80,21220,80,allow,1401,828,573,11,38,6,5
64493,53,5722,53,allow,353,101,252,4,54,2,2
49771,53,28192,53,allow,177,94,83,2,29,1,1
56292,53,5398,53,allow,197,102,95,2,29,1,1
49484,80,60761,80,allow,318,192,126,6,39,4,2
65325,53,57020,53,allow,216,110,106,2,29,1,1
55043,53,56883,53,allow,167,86,81,2,29,1,1
60792,53,38025,53,allow,168,78,90,2,29,1,1
49168,53,56952,53,allow,196,102,94,2,30,1,1
64733,53,63976,53,allow,889,404,485,10,30,5,5
55820,53,12238,53,allow,184,94,90,2,30,1,1
64650,53,46019,53,allow,193,94,99,2,30,1,1
49432,53,34624,53,allow,812,110,702,2,30,1,1
50545,53,44269,53,allow,765,102,663,2,30,1,1
55123,53,24178,53,allow,295,86,209,2,30,1,1
49797,53,57522,53,allow,306,94,212,2,30,1,1
50289,53,1310,53,allow,189,102,87,2,30,1,1
64791,53,7738,53,allow,184,94,90,2,30,1,1
64722,53,55455,53,allow,214,110,104,2,30,1,1
55235,53,63921,53,allow,178,94,84,2,30,1,1
64592,53,65035,53,allow,209,110,99,2,31,1,1
57362,53,9411,53,allow,346,102,244,2,31,1,1
56612,53,64503,53,allow,184,94,90,2,31,1,1
56986,53,21320,53,allow,177,94,83,2,31,1,1
64021,53,7172,53,allow,402,97,305,4,31,2,2
52998,443,2559,443,allow,190,70,120,4,15,2,2
49482,80,62281,80,allow,378,192,186,7,39,4,3
49514,80,16033,80,allow,1352,832,520,12,38,7,5
56966,53,65099,53,allow,177,94,83,2,30,1,1
52266,53,15275,53,allow,168,78,90,2,30,1,1
56139,53,55354,53,allow,306,94,212,2,30,1,1
55229,53,33453,53,allow,173,94,79,2,30,1,1
50072,53,22723,53,allow,779,86,693,2,30,1,1
49927,80,35490,80,allow,1126,609,517,11,15,6,5
49926,80,8028,80,allow,1126,609,517,11,15,6,5
49701,53,61488,53,allow,197,102,95,2,30,1,1
56986,53,63697,53,allow,177,94,83,2,30,1,1
55229,53,8520,53,allow,173,94,79,2,30,1,1
49928,80,49356,80,allow,1270,679,591,13,15,7,6
52215,80,59875,80,allow,1009,506,503,10,16,5,5
65355,53,46648,53,allow,592,105,487,4,50,2,2
56506,53,3362,53,allow,184,94,90,2,30,1,1
65129,53,27603,53,allow,213,102,111,2,30,1,1
56889,53,34075,53,allow,177,94,83,2,30,1,1
64389,53,21920,53,allow,244,94,150,2,30,1,1
49663,53,27941,53,allow,168,86,82,2,31,1,1
49936,53,50715,53,allow,152,78,74,2,31,1,1
64766,53,62502,53,allow,214,110,104,2,31,1,1
64766,53,32517,53,allow,214,110,104,2,30,1,1
56667,53,18172,53,allow,199,102,97,2,30,1,1
64686,53,28216,53,allow,811,94,717,2,30,1,1
55912,53,21691,53,allow,184,94,90,2,31,1,1
55431,53,2541,53,allow,196,102,94,2,31,1,1
50017,53,58091,53,allow,195,102,93,2,31,1,1
42764,53,15953,53,allow,164,78,86,2,31,1,1
57342,53,16666,53,allow,167,86,81,2,31,1,1
55631,445,0,0,drop,66,66,0,1,0,1,0
49687,53,60160,53,allow,197,102,95,2,31,1,1
64364,53,21283,53,allow,193,94,99,2,31,1,1
49480,53,38554,53,allow,428,96,332,4,52,2,2
56626,80,44276,80,allow,234,234,0,4,12,4,0
64658,53,8151,53,allow,195,102,93,2,30,1,1
56889,53,35698,53,allow,177,94,83,2,30,1,1
56067,53,11884,53,allow,189,102,87,2,31,1,1
49206,53,42939,53,allow,179,94,85,2,31,1,1
50413,123,48114,123,allow,184,94,90,2,31,1,1
57100,53,28423,53,allow,180,94,86,2,31,1,1
49996,53,3311,53,allow,458,188,270,6,31,3,3
65107,53,22367,53,allow,266,87,179,4,35,2,2
57030,53,7649,53,allow,283,101,182,4,39,2,2
57283,53,15261,53,allow,185,102,83,2,30,1,1
55482,53,16639,53,allow,822,102,720,2,30,1,1
50500,53,25369,53,allow,166,86,80,2,30,1,1
55628,445,0,0,drop,66,66,0,1,0,1,0
60233,445,0,0,drop,70,70,0,1,0,1,0
60230,445,0,0,drop,70,70,0,1,0,1,0
60228,445,0,0,drop,70,70,0,1,0,1,0
60222,445,0,0,drop,70,70,0,1,0,1,0
55625,445,0,0,drop,66,66,0,1,0,1,0
55291,445,0,0,drop,70,70,0,1,0,1,0
60218,445,0,0,drop,70,70,0,1,0,1,0
55290,445,0,0,drop,70,70,0,1,0,1,0
60216,445,0,0,drop,70,70,0,1,0,1,0
55289,445,0,0,drop,70,70,0,1,0,1,0
55617,445,0,0,drop,66,66,0,1,0,1,0
55288,445,0,0,drop,70,70,0,1,0,1,0
55286,445,0,0,drop,70,70,0,1,0,1,0
55282,445,0,0,drop,70,70,0,1,0,1,0
55614,445,0,0,drop,66,66,0,1,0,1,0
55616,445,0,0,drop,66,66,0,1,0,1,0
55610,445,0,0,drop,66,66,0,1,0,1,0
55609,445,0,0,drop,66,66,0,1,0,1,0
55608,445,0,0,drop,66,66,0,1,0,1,0
55606,445,0,0,drop,66,66,0,1,0,1,0
55270,445,0,0,drop,70,70,0,1,0,1,0
55268,445,0,0,drop,70,70,0,1,0,1,0
55267,445,0,0,drop,70,70,0,1,0,1,0
55260,445,0,0,drop,70,70,0,1,0,1,0
60210,445,0,0,drop,70,70,0,1,0,1,0
60209,445,0,0,drop,70,70,0,1,0,1,0
60206,445,0,0,drop,70,70,0,1,0,1,0
55604,445,0,0,drop,66,66,0,1,0,1,0
60203,445,0,0,drop,70,70,0,1,0,1,0
55600,445,0,0,drop,66,66,0,1,0,1,0
55598,445,0,0,drop,66,66,0,1,0,1,0
55594,445,0,0,drop,66,66,0,1,0,1,0
55248,445,0,0,drop,70,70,0,1,0,1,0
60198,445,0,0,drop,70,70,0,1,0,1,0
55583,445,0,0,drop,66,66,0,1,0,1,0
55244,445,0,0,drop,70,70,0,1,0,1,0
55235,445,0,0,drop,70,70,0,1,0,1,0
55232,445,0,0,drop,70,70,0,1,0,1,0
55230,445,0,0,drop,70,70,0,1,0,1,0
55576,445,0,0,drop,66,66,0,1,0,1,0
55228,445,0,0,drop,70,70,0,1,0,1,0
60175,445,0,0,drop,70,70,0,1,0,1,0
55573,445,0,0,drop,66,66,0,1,0,1,0
55221,445,0,0,drop,70,70,0,1,0,1,0
55567,445,0,0,drop,66,66,0,1,0,1,0
55561,445,0,0,drop,66,66,0,1,0,1,0
55214,445,0,0,drop,70,70,0,1,0,1,0
60165,445,0,0,drop,70,70,0,1,0,1,0
60164,445,0,0,drop,70,70,0,1,0,1,0
60163,445,0,0,drop,70,70,0,1,0,1,0
55550,445,0,0,drop,66,66,0,1,0,1,0
55546,445,0,0,drop,66,66,0,1,0,1,0
55545,445,0,0,drop,66,66,0,1,0,1,0
55548,445,0,0,drop,66,66,0,1,0,1,0
55551,445,0,0,drop,66,66,0,1,0,1,0
55544,445,0,0,drop,66,66,0,1,0,1,0
55549,445,0,0,drop,66,66,0,1,0,1,0
55543,445,0,0,drop,66,66,0,1,0,1,0
55207,445,0,0,drop,70,70,0,1,0,1,0
55206,445,0,0,drop,70,70,0,1,0,1,0
55202,445,0,0,drop,70,70,0,1,0,1,0
60161,445,0,0,drop,70,70,0,1,0,1,0
60158,445,0,0,drop,70,70,0,1,0,1,0
60148,445,0,0,drop,70,70,0,1,0,1,0
55201,445,0,0,drop,70,70,0,1,0,1,0
55531,445,0,0,drop,66,66,0,1,0,1,0
55529,445,0,0,drop,66,66,0,1,0,1,0
55528,445,0,0,drop,66,66,0,1,0,1,0
60145,445,0,0,drop,70,70,0,1,0,1,0
55196,445,0,0,drop,70,70,0,1,0,1,0
41801,53,41801,53,allow,213,87,126,2,30,1,1
55651,53,6764,53,allow,760,97,663,2,30,1,1
56120,53,56120,53,allow,237,91,146,2,33,1,1
50734,80,51242,80,allow,1114,534,580,12,16,7,5
51807,443,51807,443,allow,1466,856,610,13,27,6,7
50951,80,50951,80,allow,514,246,268,9,42,5,4
65378,53,28736,53,allow,770,102,668,2,30,1,1
49983,53,51189,53,allow,749,89,660,2,30,1,1
56227,53,8068,53,allow,188,96,92,2,30,1,1
56526,443,53927,443,allow,1560,988,572,13,25,7,6
50883,80,50883,80,allow,514,246,268,9,42,5,4
55871,53,11606,53,allow,711,87,624,2,30,1,1
49762,53,23081,53,allow,760,97,663,2,30,1,1
49837,53,39920,53,allow,212,108,104,2,30,1,1
53575,53,50120,53,allow,198,93,105,2,30,1,1
62738,443,30177,443,allow,126,60,66,3,10,2,1
57030,53,58226,53,allow,283,101,182,4,38,2,2
56541,443,2047,443,allow,1560,988,572,13,25,7,6
50757,80,50757,80,allow,514,246,268,9,42,5,4
51140,80,51140,80,allow,514,246,268,9,42,5,4
51810,443,51810,443,allow,1536,856,680,14,27,6,8
56242,53,42071,53,allow,711,87,624,2,30,1,1
49192,53,18280,53,allow,747,93,654,2,30,1,1
64592,53,37714,53,allow,202,103,99,2,31,1,1
55129,53,28774,53,allow,754,94,660,2,31,1,1
55237,53,13670,53,allow,259,87,172,4,56,2,2
50500,53,52272,53,allow,164,84,80,2,30,1,1
57067,53,64624,53,allow,172,88,84,2,30,1,1
56765,53,52854,53,allow,711,87,624,2,30,1,1
64949,53,27237,53,allow,744,89,655,2,30,1,1
56986,53,24262,53,allow,170,87,83,2,30,1,1
55141,53,48144,53,allow,744,89,655,2,30,1,1
65328,53,16469,53,allow,174,89,85,2,30,1,1
56589,53,53742,53,allow,711,87,624,2,30,1,1
55759,53,54947,53,allow,756,95,661,2,30,1,1
55877,53,16386,53,allow,164,84,80,2,30,1,1
56553,53,14002,53,allow,198,101,97,2,30,1,1
49206,53,61280,53,allow,174,89,85,2,31,1,1
65370,53,4186,53,allow,778,103,675,2,31,1,1
56334,53,41390,53,allow,767,102,665,2,31,1,1
52028,53,52028,53,allow,194,87,107,2,31,1,1
50017,53,55318,53,allow,190,97,93,2,31,1,1
59893,53,45221,53,allow,198,93,105,2,30,1,1
64560,53,23612,53,allow,802,104,698,2,30,1,1
49513,53,13327,53,allow,200,102,98,2,31,1,1
55533,53,30263,53,allow,816,97,719,2,31,1,1
56342,53,27382,53,allow,733,93,640,2,31,1,1
56633,53,17988,53,allow,194,99,95,2,31,1,1
56250,53,20280,53,allow,802,104,698,2,31,1,1
64790,53,49419,53,allow,182,93,89,2,31,1,1
64934,53,46124,53,allow,194,99,95,2,31,1,1
56000,53,40530,53,allow,170,87,83,2,31,1,1
49687,53,12525,53,allow,194,99,95,2,31,1,1
56380,53,55619,53,allow,170,87,83,2,31,1,1
56693,53,6310,53,allow,756,95,661,2,31,1,1
65516,53,45586,53,allow,749,94,655,2,31,1,1
64053,53,7121,53,allow,186,95,91,2,31,1,1
64257,53,54453,53,allow,168,86,82,2,31,1,1
65171,53,47372,53,allow,760,97,663,2,31,1,1
55680,53,52561,53,allow,749,94,655,2,31,1,1
55027,53,18379,53,allow,168,86,82,2,31,1,1
49157,53,58041,53,allow,184,94,90,2,31,1,1
56511,53,19992,53,allow,200,102,98,2,31,1,1
57256,53,42871,53,allow,771,101,670,2,31,1,1
55994,53,19158,53,allow,182,93,89,2,31,1,1
64983,53,38581,53,allow,777,87,690,2,31,1,1
55179,53,42268,53,allow,172,88,84,2,31,1,1
55902,53,9062,53,allow,178,91,87,2,31,1,1
49936,53,59450,53,allow,216,110,106,2,31,1,1
57106,53,8204,53,allow,760,97,663,2,31,1,1
64825,53,5593,53,allow,728,96,632,2,31,1,1
60138,445,0,0,drop,70,70,0,1,0,1,0
60135,445,0,0,drop,70,70,0,1,0,1,0
56550,53,61639,53,allow,183,94,89,2,30,1,1
60126,445,0,0,drop,70,70,0,1,0,1,0
60123,445,0,0,drop,70,70,0,1,0,1,0
60119,445,0,0,drop,70,70,0,1,0,1,0
62888,23,0,0,deny,60,60,0,1,0,1,0
55176,445,0,0,drop,70,70,0,1,0,1,0
55504,445,0,0,drop,66,66,0,1,0,1,0
55992,53,33542,53,allow,194,94,100,2,30,1,1
50091,53,37575,53,allow,183,94,89,2,30,1,1
56000,53,49191,53,allow,177,94,83,2,30,1,1
56353,53,32385,53,allow,216,102,114,2,29,1,1
65439,53,5065,53,allow,198,94,104,2,30,1,1
65414,53,56360,53,allow,216,102,114,2,30,1,1
64541,53,6698,53,allow,363,94,269,2,30,1,1
56380,53,5120,53,allow,177,94,83,2,30,1,1
57429,80,55023,80,allow,1056,682,374,10,15,6,4
57117,53,45575,53,allow,366,102,264,4,46,2,2
55475,53,28600,53,allow,757,102,655,2,29,1,1
59368,53,55998,53,allow,241,118,123,2,29,1,1
56550,53,48765,53,allow,183,94,89,2,29,1,1
64658,53,60447,53,allow,195,102,93,2,29,1,1
56369,53,50667,53,allow,168,86,82,2,29,1,1
65439,53,2036,53,allow,168,86,82,2,29,1,1
56667,53,55956,53,allow,199,102,97,2,29,1,1
55235,53,18331,53,allow,178,94,84,2,29,1,1
64332,53,12232,53,allow,195,102,93,2,30,1,1
49646,53,5301,53,allow,199,102,97,2,30,1,1
49687,53,16473,53,allow,197,102,95,2,29,1,1
57258,53,4190,53,allow,177,94,83,2,29,1,1
55027,53,13864,53,allow,168,86,82,2,30,1,1
55933,53,32005,53,allow,177,94,83,2,30,1,1
56612,53,46131,53,allow,184,94,90,2,29,1,1
50289,53,8502,53,allow,189,102,87,2,30,1,1
57258,53,16585,53,allow,177,94,83,2,30,1,1
60638,53,31002,53,allow,337,86,251,2,29,1,1
64792,53,34890,53,allow,338,110,228,2,30,1,1
40273,53,38821,53,allow,164,78,86,2,30,1,1
49837,53,42825,53,allow,214,110,104,2,30,1,1
56242,53,30808,53,allow,231,86,145,2,30,1,1
64882,53,8935,53,allow,246,94,152,2,30,1,1
57135,53,40947,53,allow,443,182,261,6,30,3,3
50200,53,14002,53,allow,758,102,656,2,30,1,1
55295,53,52273,53,allow,779,86,693,2,30,1,1
55439,53,44673,53,allow,177,94,83,2,30,1,1
64620,53,50964,53,allow,166,86,80,2,30,1,1
45157,7,33504,7,allow,138,78,60,2,5,1,1
56000,53,42944,53,allow,177,94,83,2,30,1,1
56553,53,56242,53,allow,199,102,97,2,30,1,1
55675,53,10351,53,allow,195,102,93,2,30,1,1
49329,53,8761,53,allow,258,102,156,2,30,1,1
49646,53,18495,53,allow,199,102,97,2,30,1,1
49837,53,47456,53,allow,214,110,104,2,30,1,1
64591,53,55985,53,allow,179,86,93,2,30,1,1
53868,53,38630,53,allow,164,78,86,2,30,1,1
44409,53,42084,53,allow,199,94,105,2,30,1,1
43770,53,60550,53,allow,199,94,105,2,30,1,1
49889,53,4477,53,allow,338,110,228,2,30,1,1
47483,53,19312,53,allow,164,78,86,2,30,1,1
55933,53,58575,53,allow,177,94,83,2,30,1,1
50456,53,42563,53,allow,754,94,660,2,30,1,1
64332,53,56016,53,allow,195,102,93,2,30,1,1
56928,53,57142,53,allow,178,94,84,2,30,1,1
56421,53,5669,53,allow,350,94,256,2,30,1,1
49708,53,14475,53,allow,185,102,83,2,30,1,1
56668,53,12015,53,allow,199,94,105,2,30,1,1
56989,53,25786,53,allow,168,94,74,2,30,1,1
51806,443,51806,443,allow,1466,856,610,13,27,6,7
63964,53,22176,53,allow,323,85,238,4,34,2,2
55237,53,6417,53,allow,259,87,172,4,56,2,2
56553,53,8293,53,allow,199,102,97,2,30,1,1
49936,53,17708,53,allow,168,94,74,2,30,1,1
57288,53,1558,53,allow,354,94,260,2,30,1,1
56950,53,2496,53,allow,183,94,89,2,30,1,1
55237,53,24870,53,allow,259,87,172,4,56,2,2
44545,443,4712,443,allow,546,280,266,9,26,5,4
51809,443,51809,443,allow,1466,856,610,13,27,6,7
50331,80,36568,80,allow,1677,862,815,10,15,5,5
49891,80,30734,80,allow,1694,666,1028,10,75,6,4
56602,53,56281,53,allow,423,102,321,4,38,2,2
49212,80,10274,80,allow,912,410,502,10,15,5,5
50330,80,61342,80,allow,736,670,66,6,15,5,1
64791,53,16107,53,allow,184,94,90,2,29,1,1
65251,53,12989,53,allow,199,102,97,2,29,1,1
56986,53,31308,53,allow,177,94,83,2,29,1,1
49269,53,5251,53,allow,198,110,88,2,29,1,1
55620,53,11702,53,allow,177,94,83,2,29,1,1
57089,53,22992,53,allow,239,94,145,2,29,1,1
56633,53,19316,53,allow,197,102,95,2,30,1,1
56667,53,35653,53,allow,199,102,97,2,29,1,1
56996,53,30047,53,allow,177,94,83,2,29,1,1
57283,53,20762,53,allow,185,102,83,2,29,1,1
55482,53,39470,53,allow,199,102,97,2,30,1,1
56996,53,54322,53,allow,177,94,83,2,30,1,1
56574,53,4025,53,allow,198,94,104,2,30,1,1
57067,53,26997,53,allow,178,94,84,2,30,1,1
49845,53,33096,53,allow,194,102,92,2,30,1,1
64168,53,53054,53,allow,306,94,212,2,30,1,1
65359,53,4725,53,allow,443,182,261,6,30,3,3
56369,53,3400,53,allow,168,86,82,2,30,1,1
65067,53,58003,53,allow,214,110,104,2,30,1,1
65067,53,2919,53,allow,214,110,104,2,30,1,1
65328,53,23014,53,allow,179,94,85,2,30,1,1
56821,53,11694,53,allow,235,94,141,2,30,1,1
49913,53,6290,53,allow,216,110,106,2,30,1,1
58087,123,31892,123,allow,184,94,90,2,30,1,1
55877,53,52511,53,allow,166,86,80,2,30,1,1
50017,53,60474,53,allow,195,102,93,2,30,1,1
56067,53,20488,53,allow,189,102,87,2,30,1,1
64804,53,31085,53,allow,182,102,80,2,30,1,1
56612,53,50823,53,allow,184,94,90,2,30,1,1
64257,53,1307,53,allow,168,86,82,2,30,1,1
64257,53,50451,53,allow,168,86,82,2,31,1,1
57394,53,17167,53,allow,193,102,91,2,31,1,1
65007,53,7048,53,allow,165,86,79,2,30,1,1
49744,53,33458,53,allow,193,102,91,2,30,1,1
49157,53,4191,53,allow,184,94,90,2,30,1,1
56155,53,9599,53,allow,199,102,97,2,30,1,1
49206,53,44411,53,allow,179,94,85,2,30,1,1
56928,53,51278,53,allow,178,94,84,2,30,1,1
53532,53,52838,53,allow,329,102,227,2,30,1,1
56196,53,38043,53,allow,214,110,104,2,30,1,1
49964,53,63838,53,allow,380,110,270,2,31,1,1
64959,53,63198,53,allow,245,102,143,2,31,1,1
55199,53,53506,53,allow,214,110,104,2,31,1,1
49936,53,6002,53,allow,216,110,106,2,31,1,1
56548,53,54465,53,allow,199,102,97,2,31,1,1
56553,53,46585,53,allow,199,102,97,2,30,1,1
47147,443,62760,443,allow,70,70,0,1,5,1,0
50072,443,58353,443,allow,827,484,343,8,15,5,3
49882,53,52287,53,allow,441,104,337,4,48,2,2
50091,53,60727,53,allow,183,94,89,2,30,1,1
49845,53,47352,53,allow,194,102,92,2,30,1,1
56219,53,21871,53,allow,211,102,109,2,30,1,1
57018,53,10253,53,allow,177,94,83,2,30,1,1
55983,53,48141,53,allow,255,102,153,2,30,1,1
56041,53,6902,53,allow,185,102,83,2,30,1,1
50818,80,50818,80,allow,514,246,268,9,42,5,4
53634,443,2193,443,allow,2005,1100,905,16,17,9,7
51997,53,57972,53,allow,164,78,86,2,30,1,1
56308,53,13825,53,allow,184,94,90,2,30,1,1
55439,53,11568,53,allow,177,94,83,2,30,1,1
64592,53,31524,53,allow,209,110,99,2,30,1,1
56155,53,9723,53,allow,199,102,97,2,30,1,1
45394,53,64814,53,allow,199,94,105,2,30,1,1
55497,53,48989,53,allow,168,86,82,2,30,1,1
65419,53,59811,53,allow,200,102,98,2,30,1,1
49744,53,14742,53,allow,816,102,714,2,30,1,1
49687,53,13204,53,allow,197,102,95,2,31,1,1
51808,443,51808,443,allow,1466,856,610,13,27,6,7
57030,53,12910,53,allow,283,101,182,4,38,2,2
49636,53,5352,53,allow,790,110,680,2,30,1,1
49663,53,41171,53,allow,184,102,82,2,30,1,1
56190,53,16437,53,allow,196,94,102,2,30,1,1
49603,53,17814,53,allow,766,102,664,2,30,1,1
64620,53,58577,53,allow,166,86,80,2,30,1,1
57319,53,46855,53,allow,353,94,259,2,30,1,1
56799,53,3973,53,allow,353,94,259,2,30,1,1
56633,53,60296,53,allow,197,102,95,2,30,1,1
56380,53,35466,53,allow,177,94,83,2,30,1,1
65007,53,25899,53,allow,165,86,79,2,30,1,1
47463,53,25330,53,allow,167,78,89,2,30,1,1
51150,53,51368,53,allow,167,78,89,2,30,1,1
55336,53,18020,53,allow,308,94,214,2,30,1,1
49708,53,2580,53,allow,177,94,83,2,30,1,1
55027,53,18719,53,allow,168,86,82,2,30,1,1
49837,53,16345,53,allow,214,110,104,2,30,1,1
50082,53,51299,53,allow,199,94,105,2,30,1,1
57617,53,32772,53,allow,164,78,86,2,30,1,1
49513,53,36009,53,allow,200,102,98,2,30,1,1
56989,53,15263,53,allow,152,78,74,2,30,1,1
57018,53,57758,53,allow,177,94,83,2,30,1,1
49714,53,21823,53,allow,767,102,665,2,30,1,1
56227,53,19451,53,allow,194,102,92,2,30,1,1
55534,53,6633,53,allow,86,86,0,1,30,1,0
56950,53,53864,53,allow,183,94,89,2,30,1,1
50108,53,30433,53,allow,969,86,883,2,30,1,1
55675,53,24009,53,allow,195,102,93,2,30,1,1
64804,53,26105,53,allow,182,102,80,2,30,1,1
56512,53,17535,53,allow,166,86,80,2,30,1,1
65143,53,18193,53,allow,184,94,90,2,30,1,1
56728,53,16534,53,allow,166,86,80,2,30,1,1
64257,53,2954,53,allow,168,86,82,2,30,1,1
49316,53,24928,53,allow,184,94,90,2,31,1,1
57157,53,38785,53,allow,173,94,79,2,30,1,1
50213,53,31929,53,allow,774,102,672,2,30,1,1
56266,53,40991,53,allow,166,86,80,2,31,1,1
56183,53,29912,53,allow,179,94,85,2,31,1,1
55902,53,8610,53,allow,181,94,87,2,31,1,1
49825,53,30889,53,allow,336,110,226,2,31,1,1
56041,53,39211,53,allow,185,102,83,2,31,1,1
57018,53,23896,53,allow,177,94,83,2,31,1,1
65143,53,4098,53,allow,184,94,90,2,31,1,1
56710,53,40167,53,allow,195,102,93,2,31,1,1
65235,53,33492,53,allow,209,110,99,2,31,1,1
64332,53,56454,53,allow,195,102,93,2,31,1,1
56728,53,8699,53,allow,166,86,80,2,31,1,1
55325,53,11184,53,allow,210,110,100,2,31,1,1
55237,53,51535,53,allow,259,87,172,4,56,2,2
56633,53,46953,53,allow,342,99,243,4,32,2,2
56928,53,11160,53,allow,178,94,84,2,31,1,1
55431,53,1200,53,allow,196,102,94,2,31,1,1
55179,53,2667,53,allow,178,94,84,2,31,1,1
64381,53,50743,53,allow,198,102,96,2,31,1,1
50017,53,24863,53,allow,300,97,203,4,36,2,2
55174,445,0,0,drop,70,70,0,1,0,1,0
60115,445,0,0,drop,70,70,0,1,0,1,0
55502,445,0,0,drop,66,66,0,1,0,1,0
55498,445,0,0,drop,66,66,0,1,0,1,0
60106,445,0,0,drop,70,70,0,1,0,1,0
60102,445,0,0,drop,70,70,0,1,0,1,0
60099,445,0,0,drop,70,70,0,1,0,1,0
60096,445,0,0,drop,70,70,0,1,0,1,0
55165,445,0,0,drop,70,70,0,1,0,1,0
55497,445,0,0,drop,66,66,0,1,0,1,0
55163,445,0,0,drop,70,70,0,1,0,1,0
55162,445,0,0,drop,70,70,0,1,0,1,0
55161,445,0,0,drop,70,70,0,1,0,1,0
60093,445,0,0,drop,70,70,0,1,0,1,0
55160,445,0,0,drop,70,70,0,1,0,1,0
55158,445,0,0,drop,70,70,0,1,0,1,0
55156,445,0,0,drop,70,70,0,1,0,1,0
60084,445,0,0,drop,70,70,0,1,0,1,0
60086,445,0,0,drop,70,70,0,1,0,1,0
55489,445,0,0,drop,66,66,0,1,0,1,0
55485,445,0,0,drop,66,66,0,1,0,1,0
55484,445,0,0,drop,66,66,0,1,0,1,0
55481,445,0,0,drop,66,66,0,1,0,1,0
63814,81,0,0,deny,60,60,0,1,0,1,0
55478,445,0,0,drop,66,66,0,1,0,1,0
38338,443,60739,443,allow,499,425,74,4,0,3,1
53853,443,38658,443,allow,499,425,74,4,0,3,1
53852,443,26865,443,allow,499,425,74,4,0,3,1
38337,443,4269,443,allow,499,425,74,4,1,3,1
55479,445,0,0,drop,66,66,0,1,0,1,0
55476,445,0,0,drop,66,66,0,1,0,1,0
55142,445,0,0,drop,70,70,0,1,0,1,0
55141,445,0,0,drop,70,70,0,1,0,1,0
55137,445,0,0,drop,70,70,0,1,0,1,0
60077,445,0,0,drop,70,70,0,1,0,1,0
60076,445,0,0,drop,70,70,0,1,0,1,0
55473,445,0,0,drop,66,66,0,1,0,1,0
60075,445,0,0,drop,70,70,0,1,0,1,0
55470,445,0,0,drop,66,66,0,1,0,1,0
55469,445,0,0,drop,66,66,0,1,0,1,0
55466,445,0,0,drop,66,66,0,1,0,1,0
55120,445,0,0,drop,70,70,0,1,0,1,0
60074,445,0,0,drop,70,70,0,1,0,1,0
60064,445,0,0,drop,70,70,0,1,0,1,0
60059,445,0,0,drop,70,70,0,1,0,1,0
55116,445,0,0,drop,70,70,0,1,0,1,0
55454,445,0,0,drop,66,66,0,1,0,1,0
55106,445,0,0,drop,70,70,0,1,0,1,0
55107,445,0,0,drop,70,70,0,1,0,1,0
55102,445,0,0,drop,70,70,0,1,0,1,0
55101,445,0,0,drop,70,70,0,1,0,1,0
55099,445,0,0,drop,70,70,0,1,0,1,0
55447,445,0,0,drop,66,66,0,1,0,1,0
55445,445,0,0,drop,66,66,0,1,0,1,0
60133,1,0,0,deny,62,62,0,1,0,1,0
55093,445,0,0,drop,70,70,0,1,0,1,0
55437,445,0,0,drop,66,66,0,1,0,1,0
55427,445,0,0,drop,66,66,0,1,0,1,0
55086,445,0,0,drop,70,70,0,1,0,1,0
55079,445,0,0,drop,70,70,0,1,0,1,0
60036,445,0,0,drop,70,70,0,1,0,1,0
60035,445,0,0,drop,70,70,0,1,0,1,0
55078,445,0,0,drop,70,70,0,1,0,1,0
55422,445,0,0,drop,66,66,0,1,0,1,0
55419,445,0,0,drop,66,66,0,1,0,1,0
55417,445,0,0,drop,66,66,0,1,0,1,0
55416,445,0,0,drop,66,66,0,1,0,1,0
55420,445,0,0,drop,66,66,0,1,0,1,0
55421,445,0,0,drop,66,66,0,1,0,1,0
55418,445,0,0,drop,66,66,0,1,0,1,0
55415,445,0,0,drop,66,66,0,1,0,1,0
50409,53,47032,53,allow,731,85,646,2,30,1,1
56710,53,43417,53,allow,190,97,93,2,31,1,1
65143,53,7897,53,allow,184,94,90,2,30,1,1
49921,53,38148,53,allow,212,108,104,2,31,1,1
57394,53,16872,53,allow,186,95,91,2,31,1,1
54962,53,32571,53,allow,188,96,92,2,30,1,1
50311,80,32414,80,allow,366,180,186,7,57,4,3
55656,53,20503,53,allow,760,96,664,2,30,1,1
64381,53,47350,53,allow,196,100,96,2,30,1,1
61423,443,8022,443,allow,1113,589,524,12,28,6,6
55484,53,28906,53,allow,711,87,624,2,30,1,1
56548,53,6954,53,allow,198,101,97,2,31,1,1
56728,53,35265,53,allow,164,84,80,2,31,1,1
56183,53,46991,53,allow,174,89,85,2,31,1,1
61431,443,2753,443,allow,1401,940,461,11,28,7,4
41543,443,50786,443,allow,78,78,0,1,5,1,0
61424,443,36108,443,allow,1119,589,530,12,28,6,6
52028,53,0,0,allow,354,81,273,2,30,1,1
55580,53,22194,53,allow,788,108,680,2,30,1,1
57005,53,24332,53,allow,762,98,664,2,30,1,1
56262,53,49362,53,allow,701,88,613,2,30,1,1
49995,53,4642,53,allow,99,99,0,1,30,1,0
52606,53,0,0,allow,223,91,132,2,30,1,1
55431,53,28791,53,allow,192,98,94,2,30,1,1
56928,53,33620,53,allow,172,88,84,2,30,1,1
57018,53,1950,53,allow,170,87,83,2,30,1,1
64790,53,30667,53,allow,182,93,89,2,30,1,1
57281,53,42469,53,allow,172,88,84,2,30,1,1
55534,53,23781,53,allow,168,86,82,2,30,1,1
57246,53,53043,53,allow,182,93,89,2,31,1,1
56767,53,17852,53,allow,170,87,83,2,31,1,1
59093,53,0,0,allow,215,77,138,2,31,1,1
65304,53,2754,53,allow,202,103,99,2,31,1,1
56562,53,8442,53,allow,726,85,641,2,30,1,1
56914,53,41623,53,allow,731,85,646,2,30,1,1
55666,53,48851,53,allow,728,96,632,2,30,1,1
64582,53,25024,53,allow,202,103,99,2,30,1,1
55994,53,14780,53,allow,182,93,89,2,30,1,1
57263,53,62100,53,allow,166,85,81,2,30,1,1
55205,53,36429,53,allow,166,85,81,2,31,1,1
49547,53,1649,53,allow,186,95,91,2,31,1,1
49242,53,7199,53,allow,166,85,81,2,31,1,1
55199,53,58104,53,allow,212,108,104,2,30,1,1
59352,53,59352,53,allow,283,114,169,2,31,1,1
49707,53,0,0,allow,82,82,0,1,31,1,0
44967,53,51774,53,allow,198,93,105,2,31,1,1
49806,53,49806,53,allow,229,89,140,2,31,1,1
38910,53,21140,53,allow,198,93,105,2,31,1,1
64016,53,9177,53,allow,93,93,0,1,31,1,0
55440,53,49182,53,allow,752,93,659,2,31,1,1
64074,53,3754,53,allow,202,103,99,2,31,1,1
64678,53,7690,53,allow,758,93,665,2,31,1,1
56729,53,56729,53,allow,229,89,140,2,31,1,1
50201,53,18513,53,allow,751,95,656,2,31,1,1
55937,53,44427,53,allow,758,93,665,2,31,1,1
55489,53,54406,53,allow,186,95,91,2,31,1,1
64761,53,64761,53,allow,220,100,120,2,31,1,1
55271,53,61756,53,allow,751,95,656,2,31,1,1
47787,53,24914,53,allow,198,93,105,2,31,1,1
56396,53,44233,53,allow,182,93,89,2,31,1,1
52377,53,52377,53,allow,229,89,140,2,31,1,1
57146,53,31700,53,allow,198,101,97,2,31,1,1
64820,53,13245,53,allow,190,97,93,2,31,1,1
57346,53,4986,53,allow,204,104,100,2,31,1,1
49157,53,49157,53,allow,229,89,140,2,31,1,1
39029,53,55192,53,allow,198,93,105,2,31,1,1
56487,53,29660,53,allow,778,103,675,2,31,1,1
59583,53,59583,53,allow,229,89,140,2,31,1,1
49334,53,23056,53,allow,184,94,90,2,31,1,1
59444,53,35195,53,allow,489,114,375,2,31,1,1
40159,53,40159,53,allow,229,89,140,2,31,1,1
55855,53,55855,53,allow,221,89,132,2,31,1,1
55074,445,0,0,drop,70,70,0,1,0,1,0
55072,445,0,0,drop,70,70,0,1,0,1,0
60026,445,0,0,drop,70,70,0,1,0,1,0
60021,445,0,0,drop,70,70,0,1,0,1,0
60019,445,0,0,drop,70,70,0,1,0,1,0
55401,445,0,0,drop,66,66,0,1,0,1,0
55402,445,0,0,drop,66,66,0,1,0,1,0
55400,445,0,0,drop,66,66,0,1,0,1,0
49767,53,52894,53,allow,727,86,641,2,30,1,1
38591,53,55685,53,allow,391,102,289,2,30,1,1
55325,53,50233,53,allow,210,110,100,2,30,1,1
57263,53,12000,53,allow,167,86,81,2,30,1,1
55489,53,32012,53,allow,193,102,91,2,30,1,1
50324,80,23988,80,allow,1083,653,430,8,15,5,3
55600,53,57524,53,allow,184,94,90,2,30,1,1
55485,53,64726,53,allow,212,102,110,2,30,1,1
59324,53,10357,53,allow,211,78,133,2,30,1,1
54962,53,15807,53,allow,194,102,92,2,30,1,1
44792,80,52125,80,allow,1295,781,514,12,16,6,6
56767,53,58838,53,allow,177,94,83,2,30,1,1
59944,80,15920,80,allow,1052,612,440,10,15,5,5
49513,53,63183,53,allow,200,102,98,2,29,1,1
55431,53,52036,53,allow,196,102,94,2,29,1,1
59878,53,26296,53,allow,391,102,289,2,29,1,1
65037,53,26531,53,allow,210,110,100,2,29,1,1
49498,53,63118,53,allow,734,94,640,2,29,1,1
59010,53,59010,53,allow,832,106,726,2,29,1,1
56227,53,39156,53,allow,194,102,92,2,30,1,1
64592,53,58811,53,allow,209,110,99,2,30,1,1
56512,53,8579,53,allow,166,86,80,2,29,1,1
57362,53,38084,53,allow,177,94,83,2,30,1,1
65304,53,18529,53,allow,209,110,99,2,30,1,1
56183,53,22164,53,allow,179,94,85,2,30,1,1
56710,53,13287,53,allow,195,102,93,2,30,1,1
57394,53,63615,53,allow,193,102,91,2,30,1,1
55199,53,63151,53,allow,214,110,104,2,30,1,1
55410,53,52970,53,allow,212,102,110,2,30,1,1
54962,53,25167,53,allow,194,102,92,2,30,1,1
60543,53,6634,53,allow,211,78,133,2,30,1,1
38639,80,55224,80,allow,1013,504,509,10,15,6,4
55655,53,4325,53,allow,524,214,310,6,57,3,3
49991,53,12205,53,allow,198,102,96,2,30,1,1
64854,53,12372,53,allow,1431,101,1330,4,50,2,2
63811,80,47846,80,allow,314,192,122,6,15,4,2
55772,53,24055,53,allow,269,110,159,2,30,1,1
55771,53,21538,53,allow,283,98,185,4,52,2,2
49316,53,61603,53,allow,184,94,90,2,30,1,1
65446,53,11171,53,allow,168,86,82,2,30,1,1
57362,53,3531,53,allow,177,94,83,2,30,1,1
55027,53,65292,53,allow,343,86,257,4,58,2,2
65206,53,46359,53,allow,167,86,81,2,30,1,1
57281,53,14335,53,allow,178,94,84,2,30,1,1
57685,53,47518,53,allow,275,86,189,2,30,1,1
56767,53,32268,53,allow,177,94,83,2,30,1,1
56511,53,32498,53,allow,200,102,98,2,30,1,1
61700,53,0,0,allow,202,86,116,2,30,1,1
50067,53,31624,53,allow,177,94,83,2,30,1,1
64381,53,26257,53,allow,198,102,96,2,30,1,1
64582,53,17757,53,allow,209,110,99,2,30,1,1
55450,53,2536,53,allow,102,102,0,1,30,1,0
55475,53,23006,53,allow,784,94,690,2,30,1,1
47370,443,20985,443,allow,350,210,140,6,75,4,2
50315,80,20802,80,allow,1030,310,720,11,56,6,5
60605,53,5384,53,allow,275,86,189,2,30,1,1
56533,53,11547,53,allow,498,204,294,6,30,3,3
56266,53,53849,53,allow,182,102,80,2,30,1,1
55199,53,8107,53,allow,214,110,104,2,30,1,1
56809,53,37625,53,allow,167,86,81,2,30,1,1
57281,53,55108,53,allow,178,94,84,2,30,1,1
49601,53,30637,53,allow,178,94,84,2,30,1,1
65235,53,42179,53,allow,209,110,99,2,30,1,1
64381,53,3642,53,allow,198,102,96,2,30,1,1
64934,53,64886,53,allow,197,102,95,2,30,1,1
64790,53,41786,53,allow,183,94,89,2,30,1,1
65087,53,12187,53,allow,413,170,243,6,30,3,3
65206,53,7977,53,allow,167,86,81,2,30,1,1
57246,53,12592,53,allow,183,94,89,2,30,1,1
65073,53,7816,53,allow,195,102,93,2,30,1,1
55076,80,31296,80,allow,1129,580,549,11,74,6,5
57030,53,42325,53,allow,283,101,182,4,37,2,2
60727,443,60727,443,allow,2169,1158,1011,20,15,11,9
55050,80,49586,80,allow,246,120,126,5,15,3,2
38640,80,6468,80,allow,1013,504,509,10,15,6,4
56196,53,30280,53,allow,214,110,104,2,29,1,1
55534,53,10719,53,allow,168,86,82,2,29,1,1
56380,53,36495,53,allow,177,94,83,2,30,1,1
49991,53,8139,53,allow,198,102,96,2,30,1,1
49936,53,39032,53,allow,216,110,106,2,29,1,1
56000,53,18353,53,allow,177,94,83,2,29,1,1
57157,53,8214,53,allow,165,86,79,2,30,1,1
49206,53,41774,53,allow,301,89,212,4,48,2,2
64598,53,18969,53,allow,222,94,128,2,29,1,1
55497,53,23337,53,allow,184,102,82,2,29,1,1
64053,53,35360,53,allow,193,102,91,2,29,1,1
64766,53,47744,53,allow,214,110,104,2,29,1,1
64053,53,10506,53,allow,193,102,91,2,30,1,1
65037,53,16035,53,allow,210,110,100,2,29,1,1
49601,53,44219,53,allow,178,94,84,2,30,1,1
64484,53,57722,53,allow,168,86,82,2,30,1,1
65037,53,41367,53,allow,210,110,100,2,29,1,1
57246,53,9725,53,allow,183,94,89,2,30,1,1
49157,53,42050,53,allow,184,94,90,2,29,1,1
55179,53,31015,53,allow,178,94,84,2,30,1,1
56548,53,18583,53,allow,199,102,97,2,30,1,1
64053,53,26364,53,allow,193,102,91,2,30,1,1
55994,53,14095,53,allow,183,94,89,2,30,1,1
65446,53,2812,53,allow,184,102,82,2,30,1,1
49730,53,34658,53,allow,194,102,92,2,30,1,1
57281,53,33051,53,allow,178,94,84,2,30,1,1
64582,53,29517,53,allow,209,110,99,2,30,1,1
49157,53,54699,53,allow,184,94,90,2,30,1,1
56629,53,37533,53,allow,177,94,83,2,30,1,1
49547,53,49951,53,allow,193,102,91,2,30,1,1
55205,53,50575,53,allow,167,86,81,2,30,1,1
64587,53,36595,53,allow,167,86,81,2,31,1,1
49921,53,27368,53,allow,214,110,104,2,30,1,1
57193,53,40448,53,allow,229,110,119,2,30,1,1
49730,53,40205,53,allow,194,102,92,2,30,1,1
49921,53,58309,53,allow,214,110,104,2,30,1,1
57263,53,19540,53,allow,167,86,81,2,30,1,1
55205,53,56363,53,allow,167,86,81,2,30,1,1
50034,53,15680,53,allow,179,94,85,2,30,1,1
55889,53,7976,53,allow,168,86,82,2,30,1,1
60542,53,46573,53,allow,260,86,174,2,30,1,1
58600,53,58600,53,allow,217,82,135,2,32,1,1
55250,443,44147,443,allow,1271,918,353,9,15,6,3
56511,53,50821,53,allow,200,102,98,2,30,1,1
55325,53,2560,53,allow,210,110,100,2,30,1,1
50067,53,8496,53,allow,177,94,83,2,30,1,1
57346,53,32731,53,allow,210,110,100,2,30,1,1
56548,53,28244,53,allow,199,102,97,2,31,1,1
56343,53,58460,53,allow,194,102,92,2,31,1,1
55902,53,58638,53,allow,181,94,87,2,30,1,1
64582,53,64118,53,allow,209,110,99,2,30,1,1
55600,53,36294,53,allow,184,94,90,2,30,1,1
50034,53,21368,53,allow,179,94,85,2,30,1,1
55165,53,15099,53,allow,199,102,97,2,30,1,1
56090,53,62587,53,allow,195,94,101,2,30,1,1
56809,53,9821,53,allow,167,86,81,2,30,1,1
56511,53,55404,53,allow,200,102,98,2,30,1,1
55165,53,30043,53,allow,199,102,97,2,30,1,1
57246,53,49639,53,allow,183,94,89,2,31,1,1
64934,53,51307,53,allow,197,102,95,2,33,1,1
50314,80,10727,80,allow,1030,310,720,11,56,6,5
56413,53,29873,53,allow,233,94,139,2,30,1,1
56710,53,54162,53,allow,355,97,258,4,60,2,2
64820,53,3092,53,allow,195,102,93,2,30,1,1
57029,53,54997,53,allow,413,170,243,6,30,3,3
55266,53,20409,53,allow,365,102,263,2,30,1,1
55662,53,45972,53,allow,212,102,110,2,30,1,1
65304,53,46271,53,allow,209,110,99,2,30,1,1
55889,53,65516,53,allow,168,86,82,2,30,1,1
55179,53,47200,53,allow,178,94,84,2,30,1,1
65096,53,51459,53,allow,216,94,122,2,30,1,1
56629,53,33066,53,allow,177,94,83,2,30,1,1
65143,53,45277,53,allow,184,94,90,2,30,1,1
59323,53,1369,53,allow,260,86,174,2,30,1,1
65229,53,45181,53,allow,195,102,93,2,31,1,1
57146,53,33353,53,allow,199,102,97,2,31,1,1
56704,53,8695,53,allow,194,102,92,2,31,1,1
49921,53,21465,53,allow,214,110,104,2,31,1,1
50438,53,15254,53,allow,296,101,195,4,31,2,2
50438,53,44786,53,allow,296,101,195,4,31,2,2
56767,53,44423,53,allow,177,94,83,2,30,1,1
56183,53,23444,53,allow,179,94,85,2,30,1,1
49513,53,20128,53,allow,391,102,289,4,31,2,2
65241,53,34581,53,allow,198,102,96,2,30,1,1
55955,53,56880,53,allow,184,94,90,2,30,1,1
49334,53,14859,53,allow,184,94,90,2,30,1,1
49265,53,12727,53,allow,181,94,87,2,31,1,1
65437,53,61379,53,allow,195,102,93,2,31,1,1
57394,53,39709,53,allow,193,102,91,2,31,1,1
55955,53,35067,53,allow,184,94,90,2,31,1,1
65165,53,21302,53,allow,200,102,98,2,31,1,1
65482,53,46055,53,allow,179,94,85,2,31,1,1
49334,53,54606,53,allow,184,94,90,2,31,1,1
55902,53,57612,53,allow,181,94,87,2,30,1,1
56396,53,37010,53,allow,183,94,89,2,30,1,1
64074,53,54669,53,allow,209,110,99,2,30,1,1
55071,53,33464,53,allow,177,94,83,2,31,1,1
40845,53,40845,53,allow,210,98,112,2,31,1,1
49162,53,30620,53,allow,401,94,307,4,32,2,2
55068,445,0,0,drop,70,70,0,1,0,1,0
60013,445,0,0,drop,70,70,0,1,0,1,0
60009,445,0,0,drop,70,70,0,1,0,1,0
60004,445,0,0,drop,70,70,0,1,0,1,0
50631,23,0,0,deny,60,60,0,1,0,1,0
55053,445,0,0,drop,70,70,0,1,0,1,0
59995,445,0,0,drop,70,70,0,1,0,1,0
59998,445,0,0,drop,70,70,0,1,0,1,0
59993,445,0,0,drop,70,70,0,1,0,1,0
55050,445,0,0,drop,70,70,0,1,0,1,0
55378,445,0,0,drop,66,66,0,1,0,1,0
55042,445,0,0,drop,70,70,0,1,0,1,0
59988,445,0,0,drop,70,70,0,1,0,1,0
55374,445,0,0,drop,66,66,0,1,0,1,0
55035,445,0,0,drop,70,70,0,1,0,1,0
55370,445,0,0,drop,66,66,0,1,0,1,0
55033,445,0,0,drop,70,70,0,1,0,1,0
59971,445,0,0,drop,70,70,0,1,0,1,0
59968,445,0,0,drop,70,70,0,1,0,1,0
55367,445,0,0,drop,66,66,0,1,0,1,0
55032,445,0,0,drop,70,70,0,1,0,1,0
55031,445,0,0,drop,70,70,0,1,0,1,0
55030,445,0,0,drop,70,70,0,1,0,1,0
59964,445,0,0,drop,70,70,0,1,0,1,0
59960,445,0,0,drop,70,70,0,1,0,1,0
59959,445,0,0,drop,70,70,0,1,0,1,0
55361,445,0,0,drop,66,66,0,1,0,1,0
55012,445,0,0,drop,70,70,0,1,0,1,0
55011,445,0,0,drop,70,70,0,1,0,1,0
55358,445,0,0,drop,66,66,0,1,0,1,0
55355,445,0,0,drop,66,66,0,1,0,1,0
55352,445,0,0,drop,66,66,0,1,0,1,0
55009,445,0,0,drop,70,70,0,1,0,1,0
55001,445,0,0,drop,70,70,0,1,0,1,0
55002,445,0,0,drop,70,70,0,1,0,1,0
55351,445,0,0,drop,66,66,0,1,0,1,0
55350,445,0,0,drop,66,66,0,1,0,1,0
55349,445,0,0,drop,66,66,0,1,0,1,0
59954,445,0,0,drop,70,70,0,1,0,1,0
59952,445,0,0,drop,70,70,0,1,0,1,0
55346,445,0,0,drop,66,66,0,1,0,1,0
59947,445,0,0,drop,70,70,0,1,0,1,0
55343,445,0,0,drop,66,66,0,1,0,1,0
55341,445,0,0,drop,66,66,0,1,0,1,0
55339,445,0,0,drop,66,66,0,1,0,1,0
55338,445,0,0,drop,66,66,0,1,0,1,0
59941,445,0,0,drop,70,70,0,1,0,1,0
54986,445,0,0,drop,70,70,0,1,0,1,0
54975,445,0,0,drop,70,70,0,1,0,1,0
55327,445,0,0,drop,66,66,0,1,0,1,0
54971,445,0,0,drop,70,70,0,1,0,1,0
54974,445,0,0,drop,70,70,0,1,0,1,0
54970,445,0,0,drop,70,70,0,1,0,1,0
55319,445,0,0,drop,66,66,0,1,0,1,0
59919,445,0,0,drop,70,70,0,1,0,1,0
55316,445,0,0,drop,66,66,0,1,0,1,0
54963,445,0,0,drop,70,70,0,1,0,1,0
55310,445,0,0,drop,66,66,0,1,0,1,0
55300,445,0,0,drop,66,66,0,1,0,1,0
54954,445,0,0,drop,70,70,0,1,0,1,0
36061,53,36061,53,allow,220,100,120,2,30,1,1
55771,53,58272,53,allow,283,98,185,4,51,2,2
46633,53,46633,53,allow,237,91,146,2,32,1,1
65497,53,35507,53,allow,194,99,95,2,31,1,1
64335,53,18778,53,allow,186,95,91,2,30,1,1
57174,53,65010,53,allow,755,94,661,2,30,1,1
49162,53,60010,53,allow,182,93,89,2,31,1,1
55955,53,59557,53,allow,184,94,90,2,30,1,1
55071,53,10472,53,allow,170,87,83,2,31,1,1
49265,53,7053,53,allow,178,91,87,2,31,1,1
56695,53,57441,53,allow,776,102,674,2,30,1,1
57406,53,28886,53,allow,761,100,661,2,30,1,1
38678,443,31559,443,allow,484,210,274,8,26,4,4
65437,53,50016,53,allow,190,97,93,2,30,1,1
55450,53,15433,53,allow,186,95,91,2,30,1,1
65241,53,65497,53,allow,196,100,96,2,30,1,1
59828,53,0,0,allow,275,75,200,2,30,1,1
65229,53,65354,53,allow,190,97,93,2,31,1,1
56704,53,19637,53,allow,188,96,92,2,31,1,1
65165,53,54019,53,allow,200,102,98,2,31,1,1
57072,53,1078,53,allow,190,97,93,2,31,1,1
48422,53,48422,53,allow,229,89,140,2,30,1,1
50034,53,9396,53,allow,174,89,85,2,30,1,1
64587,53,28928,53,allow,166,85,81,2,30,1,1
38791,53,38791,53,allow,229,89,140,2,30,1,1
55032,53,0,0,allow,288,79,209,2,31,1,1
57275,53,1884,53,allow,186,95,91,2,31,1,1
55871,53,0,0,allow,82,82,0,1,31,1,0
49843,53,31745,53,allow,186,95,91,2,31,1,1
36306,53,36306,53,allow,229,89,140,2,30,1,1
64999,53,11642,53,allow,757,98,659,2,31,1,1
50054,53,65410,53,allow,775,103,672,2,31,1,1
57266,53,10699,53,allow,753,96,657,2,31,1,1
47163,53,47163,53,allow,825,99,726,2,31,1,1
57096,53,22814,53,allow,196,100,96,2,31,1,1
57296,53,12062,53,allow,200,102,98,2,31,1,1
64904,53,60868,53,allow,198,101,97,2,31,1,1
49654,53,58330,53,allow,184,94,90,2,31,1,1
49522,53,15202,53,allow,753,96,657,2,31,1,1
65439,53,55852,53,allow,751,95,656,2,31,1,1
64946,53,40387,53,allow,202,95,107,2,31,1,1
55481,53,52263,53,allow,793,101,692,2,31,1,1
49812,53,21383,53,allow,164,84,80,2,31,1,1
49159,53,33263,53,allow,733,86,647,2,31,1,1
65482,53,40607,53,allow,174,89,85,2,31,1,1
49761,53,10383,53,allow,182,93,89,2,31,1,1
56536,53,9836,53,allow,202,103,99,2,31,1,1
64559,53,44867,53,allow,168,86,82,2,31,1,1
56387,53,8885,53,allow,757,98,659,2,31,1,1
56783,53,31906,53,allow,751,95,656,2,31,1,1
56855,53,37174,53,allow,775,103,672,2,31,1,1
57109,53,37634,53,allow,168,86,82,2,31,1,1
65345,53,26359,53,allow,782,105,677,2,31,1,1
55062,53,13920,53,allow,733,86,647,2,31,1,1
54950,445,0,0,drop,70,70,0,1,0,1,0
54948,445,0,0,drop,70,70,0,1,0,1,0
59909,445,0,0,drop,70,70,0,1,0,1,0
55489,53,26827,53,allow,193,102,91,2,30,1,1
55208,53,14602,53,allow,177,94,83,2,30,1,1
64587,53,13030,53,allow,167,86,81,2,30,1,1
49568,53,17593,53,allow,214,102,112,2,30,1,1
55771,53,45760,53,allow,283,98,185,4,51,2,2
59908,445,0,0,drop,70,70,0,1,0,1,0
59907,445,0,0,drop,70,70,0,1,0,1,0
55294,445,0,0,drop,66,66,0,1,0,1,0
55293,445,0,0,drop,66,66,0,1,0,1,0
55292,445,0,0,drop,66,66,0,1,0,1,0
55291,445,0,0,drop,66,66,0,1,0,1,0
55290,445,0,0,drop,66,66,0,1,0,1,0
55289,445,0,0,drop,66,66,0,1,0,1,0
55288,445,0,0,drop,66,66,0,1,0,1,0
55287,445,0,0,drop,66,66,0,1,0,1,0
54944,445,0,0,drop,70,70,0,1,0,1,0
54943,445,0,0,drop,70,70,0,1,0,1,0
64820,53,5211,53,allow,195,102,93,2,29,1,1
56343,53,26376,53,allow,194,102,92,2,29,1,1
49242,53,1581,53,allow,167,86,81,2,29,1,1
56106,53,61650,53,allow,816,102,714,2,30,1,1
61702,80,48411,80,allow,1553,953,600,14,47,8,6
56655,53,21531,53,allow,209,110,99,2,30,1,1
65482,53,50244,53,allow,179,94,85,2,30,1,1
65360,53,6269,53,allow,763,102,661,2,30,1,1
49186,53,28433,53,allow,821,102,719,2,30,1,1
56704,53,43778,53,allow,194,102,92,2,29,1,1
61701,80,22637,80,allow,1495,954,541,13,47,8,5
65437,53,38141,53,allow,195,102,93,2,29,1,1
57146,53,5349,53,allow,199,102,97,2,29,1,1
49547,53,33121,53,allow,193,102,91,2,29,1,1
49242,53,38872,53,allow,167,86,81,2,29,1,1
55450,53,40761,53,allow,193,102,91,2,29,1,1
57146,53,13566,53,allow,199,102,97,2,29,1,1
64335,53,30399,53,allow,193,102,91,2,29,1,1
56396,53,60964,53,allow,183,94,89,2,30,1,1
65073,53,50486,53,allow,195,102,93,2,29,1,1
57263,53,2666,53,allow,167,86,81,2,29,1,1
55571,53,22113,53,allow,70,70,0,1,29,1,0
54962,53,60392,53,allow,194,102,92,2,29,1,1
55205,53,45357,53,allow,167,86,81,2,29,1,1
64074,53,30034,53,allow,209,110,99,2,29,1,1
55858,53,14376,53,allow,214,102,112,2,30,1,1
61704,80,4261,80,allow,1555,954,601,14,47,8,6
49242,53,5506,53,allow,167,86,81,2,30,1,1
49769,53,30329,53,allow,785,110,675,2,30,1,1
49169,53,65143,53,allow,184,94,90,2,30,1,1
49162,53,28701,53,allow,183,94,89,2,30,1,1
56010,53,24880,53,allow,184,94,90,2,30,1,1
64587,53,63035,53,allow,167,86,81,2,30,1,1
56935,53,51699,53,allow,821,102,719,2,30,1,1
49337,53,44481,53,allow,199,102,97,2,30,1,1
65229,53,47918,53,allow,195,102,93,2,30,1,1
49186,53,38504,53,allow,198,102,96,2,30,1,1
39296,80,42810,80,allow,740,452,288,11,17,7,4
64922,53,63289,53,allow,431,95,336,4,55,2,2
57536,53,46039,53,allow,199,94,105,2,30,1,1
51424,53,58777,53,allow,269,94,175,2,30,1,1
50377,53,24974,53,allow,753,94,659,2,30,1,1
49773,53,17034,53,allow,199,94,105,2,30,1,1
49850,53,46784,53,allow,166,86,80,2,30,1,1
55095,53,28399,53,allow,194,102,92,2,30,1,1
49812,53,5502,53,allow,166,86,80,2,30,1,1
55972,53,29588,53,allow,262,126,136,2,30,1,1
64904,53,43718,53,allow,199,102,97,2,30,1,1
50033,53,63649,53,allow,533,184,349,6,76,3,3
55771,53,49572,53,allow,283,98,185,4,51,2,2
65530,53,2612,53,allow,102,102,0,1,30,1,0
65443,53,19494,53,allow,215,102,113,2,30,1,1
49242,53,51879,53,allow,183,94,89,2,30,1,1
65005,53,27346,53,allow,776,102,674,2,30,1,1
64016,53,48329,53,allow,183,94,89,2,30,1,1
49327,53,15373,53,allow,396,102,294,2,30,1,1
49337,53,52249,53,allow,199,102,97,2,30,1,1
49242,53,36950,53,allow,183,94,89,2,30,1,1
64789,53,40256,53,allow,193,102,91,2,30,1,1
50354,53,23392,53,allow,209,110,99,2,30,1,1
56665,53,14967,53,allow,223,86,137,2,30,1,1
49936,53,34115,53,allow,318,110,208,4,50,2,2
56625,80,20338,80,allow,234,234,0,4,11,4,0
52585,53,6341,53,allow,265,91,174,4,40,2,2
64397,53,47942,53,allow,658,186,472,6,51,3,3
50518,443,27027,443,allow,1352,691,661,14,47,8,6
55534,53,27868,53,allow,168,86,82,2,29,1,1
54835,443,59753,443,allow,678,280,398,11,26,5,6
55489,53,32876,53,allow,193,102,91,2,29,1,1
65497,53,55657,53,allow,197,102,95,2,29,1,1
56343,443,34805,443,allow,350,210,140,6,27,4,2
65241,53,47217,53,allow,198,102,96,2,29,1,1
56728,53,11841,53,allow,166,86,80,2,30,1,1
55450,53,10732,53,allow,193,102,91,2,29,1,1
57072,53,9949,53,allow,195,102,93,2,30,1,1
55208,53,2198,53,allow,177,94,83,2,30,1,1
49547,53,39009,53,allow,193,102,91,2,30,1,1
60047,443,35596,443,allow,1350,689,661,14,44,8,6
60045,443,3000,443,allow,1573,769,804,16,47,9,7
50072,53,48106,53,allow,172,94,78,2,30,1,1
65497,53,26978,53,allow,197,102,95,2,30,1,1
55071,53,59621,53,allow,177,94,83,2,30,1,1
49928,53,49928,53,allow,229,90,139,2,30,1,1
57072,53,19221,53,allow,195,102,93,2,30,1,1
57346,53,23622,53,allow,210,110,100,2,29,1,1
64789,53,62569,53,allow,816,102,714,2,30,1,1
49843,53,13877,53,allow,193,102,91,2,30,1,1
50354,53,24829,53,allow,209,110,99,2,30,1,1
64335,53,25261,53,allow,193,102,91,2,30,1,1
49630,53,20567,53,allow,374,126,248,2,30,1,1
49812,53,4769,53,allow,166,86,80,2,30,1,1
57096,53,45247,53,allow,198,102,96,2,30,1,1
56322,53,19434,53,allow,166,86,80,2,30,1,1
50234,53,30924,53,allow,775,102,673,2,30,1,1
55810,53,5823,53,allow,183,94,89,2,31,1,1
55342,53,57972,53,allow,994,86,908,2,30,1,1
56616,53,31793,53,allow,183,94,89,2,30,1,1
64837,53,23710,53,allow,196,94,102,2,30,1,1
65012,53,58709,53,allow,775,102,673,2,30,1,1
56935,53,62999,53,allow,198,102,96,2,30,1,1
64719,53,54824,53,allow,196,102,94,2,30,1,1
56396,53,42377,53,allow,183,94,89,2,30,1,1
55071,53,51447,53,allow,177,94,83,2,30,1,1
55192,53,5787,53,allow,178,94,84,2,31,1,1
49162,53,41472,53,allow,183,94,89,2,30,1,1
49220,53,32308,53,allow,755,94,661,2,30,1,1
50072,53,26115,53,allow,164,86,78,2,30,1,1
44511,53,15897,53,allow,199,94,105,2,30,1,1
45872,53,25002,53,allow,199,94,105,2,30,1,1
65165,53,53498,53,allow,200,102,98,2,30,1,1
64414,53,3637,53,allow,193,102,91,2,30,1,1
50516,443,44017,443,allow,1575,771,804,16,47,9,7
42446,123,14987,123,allow,184,94,90,2,30,1,1
65304,53,61262,53,allow,209,110,99,2,30,1,1
49265,53,37179,53,allow,181,94,87,2,30,1,1
56616,53,21461,53,allow,183,94,89,2,30,1,1
49850,53,15104,53,allow,166,86,80,2,30,1,1
49156,53,27997,53,allow,304,118,186,2,30,1,1
56106,53,18399,53,allow,193,102,91,2,30,1,1
57275,53,22434,53,allow,193,102,91,2,30,1,1
55624,80,56586,80,allow,70,70,0,1,5,1,0
51459,443,53569,443,allow,202,70,132,3,11,1,2
64074,53,19017,53,allow,209,110,99,2,30,1,1
65241,53,1849,53,allow,198,102,96,2,30,1,1
65216,53,15859,53,allow,994,86,908,2,30,1,1
50034,53,20576,53,allow,179,94,85,2,30,1,1
49337,53,49651,53,allow,199,102,97,2,30,1,1
64820,53,31810,53,allow,195,102,93,2,30,1,1
49840,53,48921,53,allow,277,102,175,2,30,1,1
64137,53,61015,53,allow,216,102,114,2,30,1,1
49676,53,9085,53,allow,200,94,106,2,30,1,1
55786,53,42852,53,allow,200,102,98,2,30,1,1
50257,53,13525,53,allow,199,102,97,2,30,1,1
49843,53,43292,53,allow,193,102,91,2,30,1,1
55955,53,53026,53,allow,184,94,90,2,30,1,1
56536,53,49265,53,allow,209,110,99,2,30,1,1
57202,53,28601,53,allow,184,94,90,2,30,1,1
56409,53,35272,53,allow,199,102,97,2,30,1,1
56536,53,3128,53,allow,209,110,99,2,31,1,1
64719,53,44200,53,allow,196,102,94,2,31,1,1
65165,53,58294,53,allow,200,102,98,2,31,1,1
57275,53,13596,53,allow,193,102,91,2,31,1,1
64461,53,47213,53,allow,177,94,83,2,31,1,1
57296,53,45722,53,allow,200,102,98,2,30,1,1
56086,53,3627,53,allow,172,94,78,2,30,1,1
57275,53,15169,53,allow,193,102,91,2,30,1,1
64917,53,1366,53,allow,243,94,149,2,30,1,1
56409,53,61903,53,allow,199,102,97,2,31,1,1
55192,53,55863,53,allow,178,94,84,2,30,1,1
64414,53,29559,53,allow,193,102,91,2,31,1,1
57150,53,61382,53,allow,166,86,80,2,31,1,1
64390,53,22708,53,allow,225,110,115,2,30,1,1
65487,53,64939,53,allow,184,94,90,2,31,1,1
56308,443,13053,443,allow,1622,1137,485,11,26,7,4
56352,80,27612,80,allow,1258,752,506,13,16,7,6
56704,53,10036,53,allow,194,102,92,2,31,1,1
56342,443,42448,443,allow,1463,988,475,12,27,7,5
59892,445,0,0,drop,70,70,0,1,0,1,0
54938,445,0,0,drop,70,70,0,1,0,1,0
55272,445,0,0,drop,66,66,0,1,0,1,0
55274,445,0,0,drop,66,66,0,1,0,1,0
55271,445,0,0,drop,66,66,0,1,0,1,0
59890,445,0,0,drop,70,70,0,1,0,1,0
59883,445,0,0,drop,70,70,0,1,0,1,0
59882,445,0,0,drop,70,70,0,1,0,1,0
59884,445,0,0,drop,70,70,0,1,0,1,0
54925,445,0,0,drop,70,70,0,1,0,1,0
54922,445,0,0,drop,70,70,0,1,0,1,0
59868,445,0,0,drop,70,70,0,1,0,1,0
59867,445,0,0,drop,70,70,0,1,0,1,0
59864,445,0,0,drop,70,70,0,1,0,1,0
54918,445,0,0,drop,70,70,0,1,0,1,0
54914,445,0,0,drop,70,70,0,1,0,1,0
55249,445,0,0,drop,66,66,0,1,0,1,0
53840,443,34687,443,allow,499,425,74,4,0,3,1
53847,443,28382,443,allow,499,425,74,4,0,3,1
53841,443,33528,443,allow,499,425,74,4,0,3,1
54907,445,0,0,drop,70,70,0,1,0,1,0
55246,445,0,0,drop,66,66,0,1,0,1,0
53843,443,32315,443,allow,499,425,74,4,0,3,1
53844,443,56188,443,allow,499,425,74,4,0,3,1
53845,443,42345,443,allow,499,425,74,4,0,3,1
53846,443,62098,443,allow,499,425,74,4,0,3,1
53842,443,26608,443,allow,499,425,74,4,0,3,1
53839,443,31646,443,allow,499,425,74,4,0,3,1
53837,443,2999,443,allow,499,425,74,4,0,3,1
53836,443,61812,443,allow,499,425,74,4,0,3,1
53834,443,62616,443,allow,499,425,74,4,0,3,1
53838,443,50005,443,allow,499,425,74,4,0,3,1
53831,443,39132,443,allow,499,425,74,4,0,3,1
53832,443,1159,443,allow,499,425,74,4,0,3,1
54905,445,0,0,drop,70,70,0,1,0,1,0
55242,445,0,0,drop,66,66,0,1,0,1,0
59847,445,0,0,drop,70,70,0,1,0,1,0
59844,445,0,0,drop,70,70,0,1,0,1,0
53829,443,25937,443,allow,499,425,74,4,0,3,1
53835,443,32854,443,allow,499,425,74,4,0,3,1
53823,443,24155,443,allow,499,425,74,4,0,3,1
53827,443,32061,443,allow,499,425,74,4,0,3,1
53830,443,40467,443,allow,499,425,74,4,0,3,1
53826,443,31854,443,allow,499,425,74,4,0,3,1
53825,443,49613,443,allow,499,425,74,4,0,3,1
53833,443,61114,443,allow,499,425,74,4,0,3,1
53822,443,12016,443,allow,499,425,74,4,0,3,1
53828,443,58283,443,allow,499,425,74,4,0,3,1
53824,443,33513,443,allow,499,425,74,4,0,3,1
53821,443,22487,443,allow,499,425,74,4,0,3,1
59845,445,0,0,drop,70,70,0,1,0,1,0
59843,445,0,0,drop,70,70,0,1,0,1,0
54904,445,0,0,drop,70,70,0,1,0,1,0
55238,445,0,0,drop,66,66,0,1,0,1,0
54903,445,0,0,drop,70,70,0,1,0,1,0
54902,445,0,0,drop,70,70,0,1,0,1,0
54897,445,0,0,drop,70,70,0,1,0,1,0
54896,445,0,0,drop,70,70,0,1,0,1,0
59832,445,0,0,drop,70,70,0,1,0,1,0
59830,445,0,0,drop,70,70,0,1,0,1,0
54884,445,0,0,drop,70,70,0,1,0,1,0
54883,445,0,0,drop,70,70,0,1,0,1,0
55233,445,0,0,drop,66,66,0,1,0,1,0
54873,445,0,0,drop,70,70,0,1,0,1,0
55675,53,17939,53,allow,190,97,93,2,0,1,1
55225,445,0,0,drop,66,66,0,1,0,1,0
55228,445,0,0,drop,66,66,0,1,0,1,0
55229,445,0,0,drop,66,66,0,1,0,1,0
55222,445,0,0,drop,66,66,0,1,0,1,0
55223,445,0,0,drop,66,66,0,1,0,1,0
55221,445,0,0,drop,66,66,0,1,0,1,0
59824,445,0,0,drop,70,70,0,1,0,1,0
59822,445,0,0,drop,70,70,0,1,0,1,0
59820,445,0,0,drop,70,70,0,1,0,1,0
55217,445,0,0,drop,66,66,0,1,0,1,0
59819,445,0,0,drop,70,70,0,1,0,1,0
54862,445,0,0,drop,70,70,0,1,0,1,0
55215,445,0,0,drop,66,66,0,1,0,1,0
55213,445,0,0,drop,66,66,0,1,0,1,0
55211,445,0,0,drop,66,66,0,1,0,1,0
55210,445,0,0,drop,66,66,0,1,0,1,0
54858,445,0,0,drop,70,70,0,1,0,1,0
59813,445,0,0,drop,70,70,0,1,0,1,0
54848,445,0,0,drop,70,70,0,1,0,1,0
54844,445,0,0,drop,70,70,0,1,0,1,0
54846,445,0,0,drop,70,70,0,1,0,1,0
54841,445,0,0,drop,70,70,0,1,0,1,0
55199,445,0,0,drop,66,66,0,1,0,1,0
55192,53,45038,53,allow,172,88,84,2,30,1,1
50759,53,62224,53,allow,578,286,292,9,16,5,4
55311,53,55274,53,allow,298,101,197,4,31,2,2
46404,53,46404,53,allow,237,91,146,2,32,1,1
65446,53,45033,53,allow,204,104,100,2,30,1,1
64461,53,10856,53,allow,170,87,83,2,30,1,1
64414,53,6612,53,allow,186,95,91,2,30,1,1
56788,53,36118,53,allow,198,101,97,2,30,1,1
37234,443,63563,443,allow,1622,1137,485,11,26,7,4
64882,53,2357,53,allow,176,90,86,2,30,1,1
49962,53,19275,53,allow,184,94,90,2,31,1,1
49749,53,61513,53,allow,200,102,98,2,30,1,1
55810,53,12633,53,allow,182,93,89,2,30,1,1
56978,53,58165,53,allow,774,101,673,2,30,1,1
57202,53,47171,53,allow,184,94,90,2,30,1,1
55171,53,21824,53,allow,198,101,97,2,31,1,1
55788,53,13740,53,allow,755,93,662,2,31,1,1
64128,53,11418,53,allow,186,95,91,2,31,1,1
55095,53,24827,53,allow,188,96,92,2,30,1,1
55042,53,54765,53,allow,782,105,677,2,30,1,1
65117,53,5041,53,allow,196,100,96,2,31,1,1
64719,53,59437,53,allow,192,98,94,2,30,1,1
65487,53,21256,53,allow,184,94,90,2,30,1,1
57150,53,55226,53,allow,164,84,80,2,30,1,1
55997,53,30863,53,allow,716,95,621,2,30,1,1
49263,53,22784,53,allow,172,88,84,2,31,1,1
60914,53,60914,53,allow,220,100,120,2,31,1,1
64266,53,49573,53,allow,168,86,82,2,31,1,1
56455,53,48314,53,allow,182,93,89,2,31,1,1
64538,53,28152,53,allow,188,96,92,2,31,1,1
57406,53,60835,53,allow,188,96,92,2,30,1,1
64169,53,10688,53,allow,202,103,99,2,30,1,1
56846,53,23614,53,allow,192,98,94,2,31,1,1
56837,53,43966,53,allow,176,90,86,2,31,1,1
55271,53,11109,53,allow,168,86,82,2,31,1,1
63964,53,46604,53,allow,190,97,93,2,31,1,1
64482,53,10257,53,allow,192,98,94,2,31,1,1
49317,53,61249,53,allow,164,84,80,2,31,1,1
55066,53,18793,53,allow,176,90,86,2,31,1,1
56945,53,27105,53,allow,176,90,86,2,31,1,1
64695,53,9580,53,allow,186,95,91,2,31,1,1
55191,445,0,0,drop,66,66,0,1,0,1,0
54836,445,0,0,drop,70,70,0,1,0,1,0
55188,445,0,0,drop,66,66,0,1,0,1,0
37428,53,37182,53,allow,168,78,90,2,30,1,1
64169,53,8733,53,allow,209,110,99,2,30,1,1
49431,53,43013,53,allow,194,102,92,2,30,1,1
65331,53,36726,53,allow,193,102,91,2,30,1,1
55182,445,0,0,drop,66,66,0,1,0,1,0
55174,445,0,0,drop,66,66,0,1,0,1,0
54822,445,0,0,drop,70,70,0,1,0,1,0
54820,445,0,0,drop,70,70,0,1,0,1,0
59782,445,0,0,drop,70,70,0,1,0,1,0
59779,445,0,0,drop,70,70,0,1,0,1,0
59780,445,0,0,drop,70,70,0,1,0,1,0
55163,445,0,0,drop,66,66,0,1,0,1,0
55164,445,0,0,drop,66,66,0,1,0,1,0
55162,445,0,0,drop,66,66,0,1,0,1,0
55166,445,0,0,drop,66,66,0,1,0,1,0
55165,445,0,0,drop,66,66,0,1,0,1,0
55159,445,0,0,drop,66,66,0,1,0,1,0
55158,445,0,0,drop,66,66,0,1,0,1,0
55161,445,0,0,drop,66,66,0,1,0,1,0
54815,445,0,0,drop,70,70,0,1,0,1,0
59770,445,0,0,drop,70,70,0,1,0,1,0
59765,445,0,0,drop,70,70,0,1,0,1,0
54810,445,0,0,drop,70,70,0,1,0,1,0
55146,445,0,0,drop,66,66,0,1,0,1,0
50140,53,17472,53,allow,209,110,99,2,30,1,1
56536,53,64182,53,allow,209,110,99,2,30,1,1
49812,53,11228,53,allow,166,86,80,2,30,1,1
47866,53,1378,53,allow,199,94,105,2,30,1,1
65085,53,47896,53,allow,196,94,102,2,30,1,1
49843,53,21434,53,allow,193,102,91,2,30,1,1
65100,53,65386,53,allow,720,94,626,2,30,1,1
56312,443,54503,443,allow,564,292,272,9,25,5,4
51439,443,29374,443,allow,396,66,330,7,17,2,5
52931,80,5991,80,allow,234,234,0,4,11,4,0
38406,443,5076,443,allow,564,292,272,9,26,5,4
56086,53,3323,53,allow,172,94,78,2,29,1,1
57202,53,54278,53,allow,293,94,199,4,43,2,2
55095,53,63653,53,allow,194,102,92,2,29,1,1
65487,53,58054,53,allow,184,94,90,2,29,1,1
55810,53,35208,53,allow,183,94,89,2,29,1,1
64559,53,60231,53,allow,258,110,148,2,29,1,1
58850,53,58850,53,allow,231,90,141,2,29,1,1
57150,53,42037,53,allow,166,86,80,2,29,1,1
49667,443,61228,443,allow,334,140,194,6,25,3,3
65446,53,26325,53,allow,210,110,100,2,30,1,1
56322,53,21211,53,allow,166,86,80,2,29,1,1
55786,53,41972,53,allow,200,102,98,2,29,1,1
49379,53,28766,53,allow,199,102,97,2,30,1,1
55627,53,60150,53,allow,193,102,91,2,30,1,1
57109,53,6255,53,allow,168,86,82,2,30,1,1
64942,53,20482,53,allow,215,94,121,2,30,1,1
57406,53,49515,53,allow,194,102,92,2,30,1,1
49749,53,60642,53,allow,200,102,98,2,30,1,1
54995,53,57538,53,allow,199,102,97,2,30,1,1
64461,53,2582,53,allow,177,94,83,2,30,1,1
39872,53,48299,53,allow,78,78,0,1,30,1,0
49962,53,48309,53,allow,184,94,90,2,30,1,1
57292,53,58837,53,allow,395,102,293,2,30,1,1
47136,53,53463,53,allow,222,78,144,2,30,1,1
55171,53,40871,53,allow,199,102,97,2,30,1,1
55271,53,6211,53,allow,168,86,82,2,30,1,1
46509,53,4834,53,allow,168,78,90,2,30,1,1
50468,80,2157,80,allow,314,192,122,6,28,4,2
57406,53,10288,53,allow,194,102,92,2,30,1,1
36042,53,8305,53,allow,168,78,90,2,30,1,1
49761,53,14047,53,allow,183,94,89,2,30,1,1
65446,53,21925,53,allow,210,110,100,2,30,1,1
64719,53,8538,53,allow,381,98,283,4,51,2,2
64169,53,20022,53,allow,209,110,99,2,30,1,1
54427,53,16738,53,allow,199,94,105,2,30,1,1
64559,53,43720,53,allow,168,86,82,2,30,1,1
49171,53,3246,53,allow,199,102,97,2,30,1,1
49654,53,49736,53,allow,184,94,90,2,30,1,1
56455,53,58599,53,allow,183,94,89,2,30,1,1
50290,53,2460,53,allow,211,110,101,2,30,1,1
55627,53,4823,53,allow,193,102,91,2,30,1,1
49761,53,31558,53,allow,183,94,89,2,30,1,1
49654,53,26382,53,allow,184,94,90,2,30,1,1
46734,53,39721,53,allow,168,78,90,2,30,1,1
55849,53,3530,53,allow,889,404,485,10,30,5,5
56788,53,30869,53,allow,199,102,97,2,30,1,1
55935,53,36129,53,allow,819,102,717,2,30,1,1
55967,53,30635,53,allow,209,110,99,2,30,1,1
49787,53,35169,53,allow,193,102,91,2,30,1,1
49475,53,56421,53,allow,196,102,94,2,30,1,1
56113,53,57844,53,allow,194,102,92,2,30,1,1
55935,53,44322,53,allow,196,102,94,2,30,1,1
65482,53,43448,53,allow,179,94,85,2,30,1,1
63964,53,35341,53,allow,195,102,93,2,30,1,1
56788,53,1582,53,allow,199,102,97,2,30,1,1
55192,53,17598,53,allow,178,94,84,2,30,1,1
65122,53,25897,53,allow,410,110,300,2,30,1,1
64904,53,63887,53,allow,199,102,97,2,30,1,1
64396,53,1161,53,allow,211,102,109,2,30,1,1
53621,443,63130,443,allow,2005,1100,905,16,17,9,7
39340,443,15093,443,allow,334,140,194,6,25,3,3
54959,53,54959,53,allow,230,90,140,2,29,1,1
64904,53,57832,53,allow,199,102,97,2,29,1,1
60761,53,45233,53,allow,198,86,112,2,29,1,1
56677,53,50989,53,allow,286,103,183,4,49,2,2
57202,53,37225,53,allow,184,94,90,2,29,1,1
55810,53,11576,53,allow,183,94,89,2,29,1,1
56655,53,57319,53,allow,209,110,99,2,29,1,1
49171,53,6707,53,allow,199,102,97,2,30,1,1
57346,53,18432,53,allow,210,110,100,2,29,1,1
50257,53,50801,53,allow,199,102,97,2,29,1,1
57096,53,11827,53,allow,198,102,96,2,30,1,1
49962,53,28111,53,allow,184,94,90,2,30,1,1
57072,53,14779,53,allow,195,102,93,2,30,1,1
57296,53,58059,53,allow,200,102,98,2,29,1,1
49265,53,28768,53,allow,181,94,87,2,29,1,1
56455,53,12391,53,allow,183,94,89,2,30,1,1
65229,53,24708,53,allow,195,102,93,2,30,1,1
50140,53,26490,53,allow,209,110,99,2,30,1,1
57296,53,48552,53,allow,200,102,98,2,30,1,1
65331,53,63156,53,allow,816,102,714,2,30,1,1
57096,53,39504,53,allow,198,102,96,2,30,1,1
55967,53,41577,53,allow,209,110,99,2,30,1,1
50629,53,6662,53,allow,756,94,662,2,30,1,1
64882,53,14352,53,allow,180,94,86,2,30,1,1
65342,53,59254,53,allow,183,94,89,2,30,1,1
56846,53,43478,53,allow,196,102,94,2,30,1,1
57095,53,22428,53,allow,211,110,101,2,30,1,1
63964,53,34726,53,allow,195,102,93,2,30,1,1
55066,53,62750,53,allow,180,94,86,2,30,1,1
56846,53,22209,53,allow,196,102,94,2,31,1,1
56907,53,11065,53,allow,193,102,91,2,31,1,1
55095,53,40942,53,allow,194,102,92,2,30,1,1
64256,53,29163,53,allow,244,94,150,2,30,1,1
64634,53,16629,53,allow,786,110,676,2,30,1,1
64071,53,55557,53,allow,194,102,92,2,31,1,1
49317,53,16697,53,allow,166,86,80,2,31,1,1
49379,53,24029,53,allow,199,102,97,2,30,1,1
65385,53,9523,53,allow,227,110,117,2,30,1,1
57352,53,35059,53,allow,816,102,714,2,30,1,1
56952,53,60759,53,allow,193,102,91,2,30,1,1
64260,53,40725,53,allow,230,86,144,2,30,1,1
49236,53,40534,53,allow,723,102,621,2,30,1,1
49544,53,31008,53,allow,226,86,140,2,30,1,1
64112,53,32226,53,allow,281,94,187,2,30,1,1
55311,53,15716,53,allow,298,101,197,4,31,2,2
55311,53,38927,53,allow,298,101,197,4,31,2,2
64439,53,35218,53,allow,199,102,97,2,31,1,1
55618,53,59211,53,allow,255,102,153,2,30,1,1
50899,80,61517,80,allow,130,70,60,2,15,1,1
49654,53,5508,53,allow,184,94,90,2,30,1,1
56113,53,19299,53,allow,817,102,715,2,30,1,1
57352,53,28583,53,allow,193,102,91,2,30,1,1
56846,53,45229,53,allow,196,102,94,2,30,1,1
49749,53,2042,53,allow,200,102,98,2,30,1,1
49787,53,19694,53,allow,193,102,91,2,30,1,1
55171,53,44438,53,allow,199,102,97,2,30,1,1
56788,53,32214,53,allow,199,102,97,2,30,1,1
55311,53,61632,53,allow,298,101,197,4,31,2,2
49431,53,39469,53,allow,817,102,715,2,30,1,1
49475,53,30283,53,allow,819,102,717,2,30,1,1
54995,53,9641,53,allow,199,102,97,2,30,1,1
54211,53,7944,53,allow,339,94,245,2,30,1,1
50290,53,11389,53,allow,211,110,101,2,30,1,1
65342,53,40557,53,allow,183,94,89,2,30,1,1
64128,53,37051,53,allow,193,102,91,2,30,1,1
65487,53,62444,53,allow,184,94,90,2,30,1,1
64169,53,31527,53,allow,209,110,99,2,30,1,1
56952,53,29584,53,allow,193,102,91,2,30,1,1
49263,53,43703,53,allow,178,94,84,2,30,1,1
56773,53,31138,53,allow,183,94,89,2,30,1,1
65117,53,17216,53,allow,198,102,96,2,30,1,1
56200,53,10019,53,allow,211,110,101,2,30,1,1
64565,53,48582,53,allow,226,110,116,2,30,1,1
57406,53,8433,53,allow,194,102,92,2,31,1,1
56769,53,51571,53,allow,183,94,89,2,31,1,1
36262,53,36262,53,allow,216,90,126,2,30,1,1
64414,53,43076,53,allow,193,102,91,2,30,1,1
49472,53,42476,53,allow,210,110,100,2,31,1,1
56200,53,31034,53,allow,211,110,101,2,31,1,1
49962,53,58375,53,allow,184,94,90,2,31,1,1
64128,53,2686,53,allow,193,102,91,2,30,1,1
55023,53,43972,53,allow,216,102,114,2,30,1,1
56907,53,52225,53,allow,193,102,91,2,30,1,1
49263,53,17752,53,allow,178,94,84,2,30,1,1
49749,53,47748,53,allow,200,102,98,2,30,1,1
65117,53,1871,53,allow,198,102,96,2,30,1,1
63981,53,11790,53,allow,199,102,97,2,30,1,1
48822,53,49162,53,allow,168,78,90,2,30,1,1
56907,53,55203,53,allow,193,102,91,2,30,1,1
49472,53,37751,53,allow,210,110,100,2,30,1,1
56837,53,12687,53,allow,180,94,86,2,30,1,1
55066,53,23255,53,allow,180,94,86,2,31,1,1
65446,53,24128,53,allow,210,110,100,2,30,1,1
56455,53,54287,53,allow,183,94,89,2,31,1,1
49379,53,35998,53,allow,199,102,97,2,31,1,1
40103,443,5740,443,allow,416,210,206,7,34,4,3
41233,443,15671,443,allow,1807,1048,759,16,26,8,8
41235,443,2013,443,allow,1807,1048,759,16,26,8,8
49349,53,37003,53,allow,183,94,89,2,31,1,1
49735,443,60036,443,allow,378,256,122,7,18,5,2
56624,80,12583,80,allow,234,234,0,4,12,4,0
55143,445,0,0,drop,66,66,0,1,0,1,0
55145,445,0,0,drop,66,66,0,1,0,1,0
59761,445,0,0,drop,70,70,0,1,0,1,0
35944,23,0,0,deny,60,60,0,1,0,1,0
59756,445,0,0,drop,70,70,0,1,0,1,0
59750,445,0,0,drop,70,70,0,1,0,1,0
59749,445,0,0,drop,70,70,0,1,0,1,0
54794,445,0,0,drop,70,70,0,1,0,1,0
59740,445,0,0,drop,70,70,0,1,0,1,0
59736,445,0,0,drop,70,70,0,1,0,1,0
59737,445,0,0,drop,70,70,0,1,0,1,0
54789,445,0,0,drop,70,70,0,1,0,1,0
54786,445,0,0,drop,70,70,0,1,0,1,0
55123,445,0,0,drop,66,66,0,1,0,1,0
54779,445,0,0,drop,70,70,0,1,0,1,0
54777,445,0,0,drop,70,70,0,1,0,1,0
55116,445,0,0,drop,66,66,0,1,0,1,0
55114,445,0,0,drop,66,66,0,1,0,1,0
54776,445,0,0,drop,70,70,0,1,0,1,0
59724,445,0,0,drop,70,70,0,1,0,1,0
54775,445,0,0,drop,70,70,0,1,0,1,0
54774,445,0,0,drop,70,70,0,1,0,1,0
59712,445,0,0,drop,70,70,0,1,0,1,0
54770,445,0,0,drop,70,70,0,1,0,1,0
54772,445,0,0,drop,70,70,0,1,0,1,0
55110,445,0,0,drop,66,66,0,1,0,1,0
54756,445,0,0,deny,70,70,0,1,0,1,0
54755,445,0,0,drop,70,70,0,1,0,1,0
59709,445,0,0,drop,70,70,0,1,0,1,0
54746,445,0,0,drop,70,70,0,1,0,1,0
59704,445,0,0,drop,70,70,0,1,0,1,0
59700,445,0,0,drop,70,70,0,1,0,1,0
55105,445,0,0,drop,66,66,0,1,0,1,0
55102,445,0,0,drop,66,66,0,1,0,1,0
55099,445,0,0,drop,66,66,0,1,0,1,0
55097,445,0,0,drop,66,66,0,1,0,1,0
55095,445,0,0,drop,66,66,0,1,0,1,0
55094,445,0,0,drop,66,66,0,1,0,1,0
55093,445,0,0,drop,66,66,0,1,0,1,0
54734,445,0,0,drop,70,70,0,1,0,1,0
59697,445,0,0,drop,70,70,0,1,0,1,0
59696,445,0,0,drop,70,70,0,1,0,1,0
55090,445,0,0,drop,66,66,0,1,0,1,0
59691,445,0,0,drop,70,70,0,1,0,1,0
55087,445,0,0,drop,66,66,0,1,0,1,0
55085,445,0,0,drop,66,66,0,1,0,1,0
55083,445,0,0,drop,66,66,0,1,0,1,0
55082,445,0,0,drop,66,66,0,1,0,1,0
54730,445,0,0,drop,70,70,0,1,0,1,0
56078,22,0,0,deny,60,60,0,1,0,1,0
59685,445,0,0,drop,70,70,0,1,0,1,0
57038,53,13307,53,allow,735,88,647,2,30,1,1
64017,53,51575,53,allow,202,103,99,2,30,1,1
57452,53,64588,53,allow,774,101,673,2,30,1,1
56677,53,25915,53,allow,286,103,183,4,48,2,2
60435,80,6093,80,allow,1155,781,374,10,15,6,4
49754,80,3257,80,allow,1793,634,1159,11,15,6,5
65477,53,60369,53,allow,182,93,89,2,31,1,1
64711,53,44473,53,allow,206,105,101,2,31,1,1
56952,53,7156,53,allow,186,95,91,2,30,1,1
49379,53,1311,53,allow,198,101,97,2,30,1,1
56200,53,9546,53,allow,206,105,101,2,30,1,1
56769,53,28212,53,allow,182,93,89,2,30,1,1
39039,443,4727,443,allow,572,292,280,9,32,5,4
54996,80,15340,80,allow,1979,826,1153,13,17,9,4
45409,80,10508,80,allow,1155,781,374,10,15,6,4
63981,53,63404,53,allow,198,101,97,2,30,1,1
56340,53,20646,53,allow,780,104,676,2,30,1,1
54994,53,46934,53,allow,747,90,657,2,30,1,1
49750,80,55648,80,allow,1788,628,1160,11,15,6,5
64439,53,21739,53,allow,198,101,97,2,30,1,1
56907,53,30481,53,allow,186,95,91,2,30,1,1
49270,53,41673,53,allow,735,88,647,2,30,1,1
45232,53,0,0,allow,82,82,0,1,31,1,0
49601,53,30079,53,allow,88,88,0,1,31,1,0
49323,53,32529,53,allow,204,104,100,2,31,1,1
64071,53,30972,53,allow,188,96,92,2,31,1,1
64756,53,52664,53,allow,190,97,93,2,31,1,1
49905,53,43598,53,allow,176,90,86,2,31,1,1
49926,53,49666,53,allow,176,90,86,2,31,1,1
55487,53,20467,53,allow,198,101,97,2,31,1,1
63962,53,53078,53,allow,188,96,92,2,31,1,1
49349,53,29426,53,allow,182,93,89,2,31,1,1
49282,53,46163,53,allow,172,88,84,2,31,1,1
64484,53,55455,53,allow,168,86,82,2,31,1,1
54720,445,0,0,drop,70,70,0,1,0,1,0
54719,445,0,0,drop,70,70,0,1,0,1,0
59679,445,0,0,drop,70,70,0,1,0,1,0
59676,445,0,0,drop,70,70,0,1,0,1,0
54716,445,0,0,drop,70,70,0,1,0,1,0
54717,445,0,0,drop,70,70,0,1,0,1,0
54713,445,0,0,drop,70,70,0,1,0,1,0
55070,445,0,0,drop,66,66,0,1,0,1,0
56834,53,25406,53,allow,178,94,84,2,30,1,1
55063,445,0,0,drop,66,66,0,1,0,1,0
54707,445,0,0,drop,70,70,0,1,0,1,0
59663,445,0,0,drop,70,70,0,1,0,1,0
55061,445,0,0,drop,66,66,0,1,0,1,0
54700,445,0,0,drop,70,70,0,1,0,1,0
54698,445,0,0,drop,70,70,0,1,0,1,0
55054,445,0,0,drop,66,66,0,1,0,1,0
55043,445,0,0,drop,66,66,0,1,0,1,0
54693,445,0,0,drop,70,70,0,1,0,1,0
54692,445,0,0,drop,70,70,0,1,0,1,0
59653,445,0,0,drop,70,70,0,1,0,1,0
59652,445,0,0,drop,70,70,0,1,0,1,0
64266,53,27142,53,allow,168,86,82,2,30,1,1
49555,53,21166,53,allow,199,102,97,2,30,1,1
57290,53,54259,53,allow,178,94,84,2,30,1,1
41232,443,32307,443,allow,1807,1048,759,16,25,8,8
64439,53,36450,53,allow,199,102,97,2,30,1,1
55927,53,41588,53,allow,720,94,626,2,29,1,1
41234,443,28858,443,allow,1741,1048,693,15,25,8,7
57095,53,1337,53,allow,211,110,101,2,29,1,1
55271,53,23423,53,allow,168,86,82,2,30,1,1
51443,443,35232,443,allow,322,66,256,6,16,2,4
36692,443,41344,443,allow,996,526,470,15,30,8,7
65300,53,17594,53,allow,329,88,241,4,50,2,2
64695,53,52435,53,allow,193,102,91,2,30,1,1
64711,53,17611,53,allow,211,110,101,2,30,1,1
55773,53,34274,53,allow,199,102,97,2,30,1,1
49905,53,29720,53,allow,180,94,86,2,30,1,1
65477,53,61765,53,allow,183,94,89,2,30,1,1
55487,53,40739,53,allow,199,102,97,2,30,1,1
49747,53,62194,53,allow,355,102,253,2,30,1,1
57207,53,1251,53,allow,195,102,93,2,30,1,1
64105,53,18897,53,allow,182,86,96,2,30,1,1
64017,53,3169,53,allow,209,110,99,2,30,1,1
51441,443,28224,443,allow,322,66,256,6,16,2,4
64266,53,43619,53,allow,168,86,82,2,30,1,1
49751,80,48363,80,allow,1876,998,878,12,15,7,5
49602,53,63187,53,allow,178,94,84,2,30,1,1
49981,53,37329,53,allow,438,180,258,6,30,3,3
56769,53,53195,53,allow,183,94,89,2,30,1,1
64439,53,3142,53,allow,199,102,97,2,30,1,1
49555,53,37709,53,allow,199,102,97,2,30,1,1
57290,53,13860,53,allow,178,94,84,2,30,1,1
49602,53,1592,53,allow,178,94,84,2,30,1,1
56945,53,62206,53,allow,180,94,86,2,30,1,1
43937,123,21193,123,allow,184,94,90,2,30,1,1
64538,53,37074,53,allow,194,102,92,2,30,1,1
64482,53,15277,53,allow,196,102,94,2,30,1,1
55538,53,48787,53,allow,195,102,93,2,30,1,1
55773,53,61209,53,allow,199,102,97,2,30,1,1
47905,443,5382,443,allow,172,172,0,2,5,2,0
52143,443,25458,443,allow,712,452,260,8,25,4,4
64017,53,64345,53,allow,325,103,222,4,45,2,2
65213,53,54852,53,allow,298,94,204,2,30,1,1
55859,53,59697,53,allow,210,110,100,2,30,1,1
64695,53,11927,53,allow,193,102,91,2,30,1,1
56677,53,32244,53,allow,286,103,183,4,48,2,2
56677,53,36331,53,allow,286,103,183,4,48,2,2
63981,53,13175,53,allow,199,102,97,2,29,1,1
60502,443,31971,443,allow,416,210,206,7,28,4,3
55171,53,9139,53,allow,199,102,97,2,29,1,1
65460,53,21678,53,allow,387,102,285,2,29,1,1
65117,53,55253,53,allow,542,100,442,4,51,2,2
41236,443,52117,443,allow,1807,1048,759,16,25,8,8
56769,53,31740,53,allow,183,94,89,2,30,1,1
64128,53,50271,53,allow,606,182,424,6,71,3,3
65159,53,58481,53,allow,500,204,296,6,75,3,3
55271,53,59088,53,allow,168,86,82,2,29,1,1
64482,53,47729,53,allow,196,102,94,2,30,1,1
56773,53,53330,53,allow,183,94,89,2,29,1,1
49263,53,54586,53,allow,178,94,84,2,30,1,1
45863,53,45863,53,allow,229,90,139,2,30,1,1
49464,53,1533,53,allow,213,102,111,2,30,1,1
65477,53,57278,53,allow,183,94,89,2,30,1,1
56945,53,11659,53,allow,180,94,86,2,30,1,1
64711,53,46738,53,allow,211,110,101,2,30,1,1
57207,53,55086,53,allow,195,102,93,2,30,1,1
49926,53,63439,53,allow,180,94,86,2,30,1,1
64484,53,23929,53,allow,86,86,0,1,30,1,0
49268,53,5165,53,allow,353,118,235,2,30,1,1
55859,53,29640,53,allow,210,110,100,2,30,1,1
50006,53,55896,53,allow,378,94,284,2,30,1,1
65187,53,19736,53,allow,392,86,306,2,30,1,1
56200,53,42161,53,allow,211,110,101,2,30,1,1
65477,53,48091,53,allow,183,94,89,2,30,1,1
50116,22,50116,22,allow,152,66,86,2,10,1,1
57384,443,63051,443,allow,546,280,266,9,28,5,4
55312,53,35283,53,allow,438,180,258,6,30,3,3
55066,53,27707,53,allow,180,94,86,2,30,1,1
64538,53,57273,53,allow,194,102,92,2,30,1,1
56945,53,12864,53,allow,180,94,86,2,30,1,1
54973,53,3418,53,allow,308,102,206,2,30,1,1
64642,53,54204,53,allow,751,94,657,2,30,1,1
50642,53,37858,53,allow,775,102,673,2,30,1,1
64017,53,52336,53,allow,209,110,99,2,30,1,1
49317,53,48476,53,allow,166,86,80,2,30,1,1
49905,53,25136,53,allow,180,94,86,2,30,1,1
55093,53,0,0,allow,318,86,232,2,30,1,1
55538,53,14832,53,allow,195,102,93,2,30,1,1
49349,53,14349,53,allow,183,94,89,2,30,1,1
64711,53,26786,53,allow,211,110,101,2,30,1,1
49323,53,60402,53,allow,210,110,100,2,31,1,1
64808,53,34038,53,allow,239,94,145,2,30,1,1
55487,53,60324,53,allow,199,102,97,2,31,1,1
64071,53,28084,53,allow,424,104,320,4,31,2,2
53654,53,13764,53,allow,523,85,438,4,31,2,2
64347,53,32269,53,allow,193,102,91,2,30,1,1
56834,53,6671,53,allow,178,94,84,2,31,1,1
47450,443,22297,443,allow,162,102,60,2,5,1,1
50018,80,3941,80,allow,825,685,140,6,33,4,2
49926,53,15614,53,allow,180,94,86,2,30,1,1
55038,445,0,0,drop,66,66,0,1,0,1,0
55030,445,0,0,drop,66,66,0,1,0,1,0
55034,445,0,0,drop,66,66,0,1,0,1,0
55036,445,0,0,drop,66,66,0,1,0,1,0
55035,445,0,0,drop,66,66,0,1,0,1,0
55033,445,0,0,drop,66,66,0,1,0,1,0
55037,445,0,0,drop,66,66,0,1,0,1,0
55031,445,0,0,drop,66,66,0,1,0,1,0
54687,445,0,0,drop,70,70,0,1,0,1,0
54682,445,0,0,drop,70,70,0,1,0,1,0
59649,445,0,0,drop,70,70,0,1,0,1,0
59637,445,0,0,drop,70,70,0,1,0,1,0
59635,445,0,0,drop,70,70,0,1,0,1,0
55018,445,0,0,drop,66,66,0,1,0,1,0
55015,445,0,0,drop,66,66,0,1,0,1,0
55016,445,0,0,drop,66,66,0,1,0,1,0
59631,445,0,0,drop,70,70,0,1,0,1,0
59630,445,0,0,drop,70,70,0,1,0,1,0
59624,445,0,0,drop,70,70,0,1,0,1,0
59622,445,0,0,drop,70,70,0,1,0,1,0
54669,445,0,0,drop,70,70,0,1,0,1,0
54666,445,0,0,drop,70,70,0,1,0,1,0
59612,445,0,0,drop,70,70,0,1,0,1,0
59610,445,0,0,drop,70,70,0,1,0,1,0
59609,445,0,0,drop,70,70,0,1,0,1,0
54661,445,0,0,drop,70,70,0,1,0,1,0
54658,445,0,0,drop,70,70,0,1,0,1,0
54996,445,0,0,drop,66,66,0,1,0,1,0
59606,445,0,0,drop,70,70,0,1,0,1,0
54651,445,0,0,drop,70,70,0,1,0,1,0
54649,445,0,0,drop,70,70,0,1,0,1,0
54648,445,0,0,drop,70,70,0,1,0,1,0
54988,445,0,0,drop,66,66,0,1,0,1,0
54647,445,0,0,drop,70,70,0,1,0,1,0
54646,445,0,0,drop,70,70,0,1,0,1,0
41562,123,0,0,deny,234,234,0,1,0,1,0
54643,445,0,0,drop,70,70,0,1,0,1,0
54986,445,0,0,drop,66,66,0,1,0,1,0
59592,445,0,0,drop,70,70,0,1,0,1,0
59589,445,0,0,drop,70,70,0,1,0,1,0
59588,445,0,0,drop,70,70,0,1,0,1,0
54984,445,0,0,drop,66,66,0,1,0,1,0
54628,445,0,0,drop,70,70,0,1,0,1,0
54627,445,0,0,drop,70,70,0,1,0,1,0
54618,445,0,0,drop,70,70,0,1,0,1,0
54617,445,0,0,drop,70,70,0,1,0,1,0
59581,445,0,0,drop,70,70,0,1,0,1,0
59574,445,0,0,drop,70,70,0,1,0,1,0
59572,445,0,0,drop,70,70,0,1,0,1,0
54977,445,0,0,drop,66,66,0,1,0,1,0
54973,445,0,0,drop,66,66,0,1,0,1,0
54968,445,0,0,drop,66,66,0,1,0,1,0
54970,445,0,0,drop,66,66,0,1,0,1,0
54967,445,0,0,drop,66,66,0,1,0,1,0
54964,445,0,0,drop,66,66,0,1,0,1,0
54965,445,0,0,drop,66,66,0,1,0,1,0
54606,445,0,0,drop,70,70,0,1,0,1,0
52912,53,52912,53,allow,237,91,146,2,32,1,1
38820,80,32872,80,allow,1150,613,537,10,16,6,4
59210,80,59210,80,allow,1990,833,1157,10,21,6,4
42811,80,59018,80,allow,1114,534,580,12,16,7,5
60330,80,20724,80,allow,374,192,182,7,61,4,3
60329,80,45049,80,allow,374,192,182,7,61,4,3
60327,80,34206,80,allow,2125,1159,966,13,61,7,6
49225,53,55909,53,allow,295,101,194,4,49,2,2
64347,53,36083,53,allow,186,95,91,2,30,1,1
57207,53,13941,53,allow,190,97,93,2,30,1,1
43676,80,43895,80,allow,2132,997,1135,14,20,8,6
60328,80,20117,80,allow,2006,1095,911,11,61,6,5
41924,53,41924,53,allow,237,91,146,2,33,1,1
65530,53,49940,53,allow,96,96,0,1,30,1,0
56834,53,36228,53,allow,172,88,84,2,30,1,1
59568,445,0,0,drop,70,70,0,1,0,1,0
59570,445,0,0,drop,70,70,0,1,0,1,0
54962,445,0,0,drop,66,66,0,1,0,1,0
59563,445,0,0,drop,70,70,0,1,0,1,0
54958,445,0,0,drop,66,66,0,1,0,1,0
54955,445,0,0,drop,66,66,0,1,0,1,0
49282,53,64879,53,allow,178,94,84,2,30,1,1
49282,53,56718,53,allow,178,94,84,2,30,1,1
54954,445,0,0,drop,66,66,0,1,0,1,0
54592,445,0,0,drop,70,70,0,1,0,1,0
54593,445,0,0,drop,70,70,0,1,0,1,0
54588,445,0,0,drop,70,70,0,1,0,1,0
54590,445,0,0,drop,70,70,0,1,0,1,0
59557,445,0,0,drop,70,70,0,1,0,1,0
54586,445,0,0,drop,70,70,0,1,0,1,0
59546,445,0,0,drop,70,70,0,1,0,1,0
54579,445,0,0,drop,70,70,0,1,0,1,0
54935,445,0,0,drop,66,66,0,1,0,1,0
59535,445,0,0,drop,70,70,0,1,0,1,0
54932,445,0,0,drop,66,66,0,1,0,1,0
54926,445,0,0,drop,66,66,0,1,0,1,0
54566,445,0,0,drop,70,70,0,1,0,1,0
63243,53,40178,53,allow,330,228,102,3,33,2,1
46392,443,48556,443,allow,232,172,60,3,5,2,1
52731,80,58843,80,allow,1029,567,462,10,17,6,4
64695,53,40312,53,allow,193,102,91,2,29,1,1
60146,53,47250,53,allow,218,78,140,2,30,1,1
61682,80,36902,80,allow,1804,884,920,12,49,6,6
49225,53,59832,53,allow,295,101,194,4,49,2,2
64617,53,31755,53,allow,389,102,287,4,33,2,2
51409,443,49977,443,allow,394,70,324,7,31,2,5
49926,53,46406,53,allow,333,90,243,4,41,2,2
57207,53,1667,53,allow,195,102,93,2,29,1,1
49905,53,31462,53,allow,180,94,86,2,29,1,1
49323,53,50782,53,allow,210,110,100,2,29,1,1
46860,53,42204,53,allow,447,101,346,4,29,2,2
62155,53,41278,53,allow,263,86,177,2,29,1,1
55995,53,32542,53,allow,329,118,211,2,30,1,1
55242,443,59852,443,allow,214,140,74,4,15,3,1
57311,53,54078,53,allow,211,102,109,2,30,1,1
49343,53,20254,53,allow,478,106,372,4,48,2,2
46140,443,48726,443,allow,172,172,0,2,5,2,0
49267,53,55057,53,allow,209,94,115,2,30,1,1
46269,123,16380,123,allow,184,94,90,2,30,1,1
36690,443,36517,443,allow,1520,1058,462,12,29,8,4
64329,53,19539,53,allow,281,110,171,2,30,1,1
65530,53,53494,53,allow,194,102,92,2,30,1,1
57643,80,14145,80,allow,172,172,0,2,5,2,0
60504,443,51319,443,allow,1875,1165,710,13,28,7,6
49225,53,22731,53,allow,295,101,194,4,48,2,2
64912,53,22829,53,allow,258,102,156,2,30,1,1
63550,80,63550,80,allow,1232,481,751,10,15,5,5
39423,80,38195,80,allow,78,78,0,1,4,1,0
49317,53,7671,53,allow,657,187,470,6,72,3,3
64071,53,46762,53,allow,194,102,92,2,29,1,1
64772,53,16557,53,allow,416,107,309,4,29,2,2
63960,53,46740,53,allow,228,110,118,2,29,1,1
64347,53,53125,53,allow,193,102,91,2,29,1,1
64756,53,60471,53,allow,195,102,93,2,30,1,1
55487,53,48616,53,allow,199,102,97,2,29,1,1
55639,53,39796,53,allow,292,102,190,2,29,1,1
55762,53,29389,53,allow,249,94,155,2,29,1,1
56834,53,24622,53,allow,178,94,84,2,29,1,1
64538,53,8098,53,allow,194,102,92,2,29,1,1
49282,53,14515,53,allow,178,94,84,2,30,1,1
55379,53,3403,53,allow,358,102,256,2,30,1,1
56679,53,5371,53,allow,216,102,114,2,30,1,1
64756,53,21500,53,allow,195,102,93,2,30,1,1
56424,53,14436,53,allow,306,94,212,2,30,1,1
49225,53,32550,53,allow,295,101,194,4,49,2,2
49323,53,9705,53,allow,210,110,100,2,30,1,1
54511,53,42780,53,allow,304,86,218,2,30,1,1
49601,53,32118,53,allow,178,94,84,2,30,1,1
64756,53,35378,53,allow,195,102,93,2,30,1,1
65083,53,18755,53,allow,198,94,104,2,30,1,1
49631,53,32416,53,allow,323,102,221,2,30,1,1
54564,445,0,0,drop,70,70,0,1,0,1,0
54922,445,0,0,drop,66,66,0,1,0,1,0
54560,445,0,0,drop,70,70,0,1,0,1,0
59524,445,0,0,drop,70,70,0,1,0,1,0
54903,445,0,0,drop,66,66,0,1,0,1,0
54906,445,0,0,drop,66,66,0,1,0,1,0
54909,445,0,0,drop,66,66,0,1,0,1,0
54910,445,0,0,drop,66,66,0,1,0,1,0
54905,445,0,0,drop,66,66,0,1,0,1,0
54904,445,0,0,drop,66,66,0,1,0,1,0
54908,445,0,0,drop,66,66,0,1,0,1,0
54902,445,0,0,drop,66,66,0,1,0,1,0
54554,445,0,0,drop,70,70,0,1,0,1,0
59518,445,0,0,drop,70,70,0,1,0,1,0
59514,445,0,0,drop,70,70,0,1,0,1,0
54888,445,0,0,drop,66,66,0,1,0,1,0
54889,445,0,0,drop,66,66,0,1,0,1,0
54887,445,0,0,drop,66,66,0,1,0,1,0
59506,445,0,0,drop,70,70,0,1,0,1,0
54541,445,0,0,drop,70,70,0,1,0,1,0
59504,445,0,0,drop,70,70,0,1,0,1,0
59502,445,0,0,drop,70,70,0,1,0,1,0
59498,445,0,0,drop,70,70,0,1,0,1,0
54538,445,0,0,drop,70,70,0,1,0,1,0
54533,445,0,0,drop,70,70,0,1,0,1,0
54532,445,0,0,drop,70,70,0,1,0,1,0
59486,445,0,0,drop,70,70,0,1,0,1,0
59481,445,0,0,drop,70,70,0,1,0,1,0
59482,445,0,0,drop,70,70,0,1,0,1,0
54523,445,0,0,drop,70,70,0,1,0,1,0
54867,445,0,0,drop,66,66,0,1,0,1,0
59478,445,0,0,drop,70,70,0,1,0,1,0
54521,445,0,0,drop,70,70,0,1,0,1,0
54520,445,0,0,drop,70,70,0,1,0,1,0
54519,445,0,0,drop,70,70,0,1,0,1,0
54518,445,0,0,drop,70,70,0,1,0,1,0
54860,445,0,0,drop,66,66,0,1,0,1,0
54858,445,0,0,drop,66,66,0,1,0,1,0
59465,445,0,0,drop,70,70,0,1,0,1,0
59459,445,0,0,drop,70,70,0,1,0,1,0
59456,445,0,0,drop,70,70,0,1,0,1,0
59454,445,0,0,drop,70,70,0,1,0,1,0
54500,445,0,0,drop,70,70,0,1,0,1,0
54855,445,0,0,drop,66,66,0,1,0,1,0
54499,445,0,0,drop,70,70,0,1,0,1,0
54497,445,0,0,drop,70,70,0,1,0,1,0
54490,445,0,0,drop,70,70,0,1,0,1,0
54489,445,0,0,drop,70,70,0,1,0,1,0
62888,53,0,0,allow,193,78,115,2,30,1,1
38602,443,28302,443,allow,130,70,60,3,5,2,1
37751,53,37751,53,allow,194,87,107,2,30,1,1
57598,80,57598,80,allow,1810,821,989,10,20,6,4
57286,443,36985,443,allow,134,60,74,3,10,2,1
63955,53,0,0,allow,219,81,138,2,30,1,1
58131,53,58131,53,allow,194,87,107,2,30,1,1
49744,80,34902,80,allow,1111,749,362,9,15,5,4
40146,53,0,0,allow,300,86,214,2,30,1,1
64799,443,56278,443,allow,1671,1004,667,16,76,8,8
63724,23,0,0,deny,60,60,0,1,0,1,0
59448,445,0,0,drop,70,70,0,1,0,1,0
59444,445,0,0,drop,70,70,0,1,0,1,0
54849,445,0,0,drop,66,66,0,1,0,1,0
54845,445,0,0,drop,66,66,0,1,0,1,0
54844,445,0,0,drop,66,66,0,1,0,1,0
54846,445,0,0,drop,66,66,0,1,0,1,0
64797,53,45567,53,allow,216,102,114,2,30,1,1
54839,445,0,0,drop,66,66,0,1,0,1,0
54838,445,0,0,drop,66,66,0,1,0,1,0
54837,445,0,0,drop,66,66,0,1,0,1,0
59442,445,0,0,drop,70,70,0,1,0,1,0
59440,445,0,0,drop,70,70,0,1,0,1,0
54832,445,0,0,drop,66,66,0,1,0,1,0
59435,445,0,0,drop,70,70,0,1,0,1,0
54830,445,0,0,drop,66,66,0,1,0,1,0
54472,445,0,0,drop,70,70,0,1,0,1,0
54829,445,0,0,drop,66,66,0,1,0,1,0
54827,445,0,0,drop,66,66,0,1,0,1,0
54826,445,0,0,drop,66,66,0,1,0,1,0
54463,445,0,0,drop,70,70,0,1,0,1,0
54461,445,0,0,drop,70,70,0,1,0,1,0
54458,445,0,0,drop,70,70,0,1,0,1,0
54457,445,0,0,drop,70,70,0,1,0,1,0
59430,445,0,0,drop,70,70,0,1,0,1,0
59422,445,0,0,drop,70,70,0,1,0,1,0
59423,445,0,0,drop,70,70,0,1,0,1,0
54817,445,0,0,drop,66,66,0,1,0,1,0
54450,445,0,0,drop,70,70,0,1,0,1,0
45155,53,0,0,allow,226,86,140,2,29,1,1
49637,53,40941,53,allow,255,102,153,2,30,1,1
55117,443,14752,443,allow,1350,689,661,14,18,8,6
39599,443,45420,443,allow,1352,691,661,14,18,8,6
39597,443,19827,443,allow,1350,689,661,14,18,8,6
56826,53,57035,53,allow,94,94,0,1,29,1,0
64288,53,63361,53,allow,229,110,119,2,29,1,1
64937,53,3891,53,allow,360,118,242,2,30,1,1
65263,53,26647,53,allow,356,88,268,4,55,2,2
57886,53,57886,53,allow,216,90,126,2,29,1,1
55984,53,2333,53,allow,216,102,114,2,30,1,1
62122,53,41697,53,allow,179,86,93,2,30,1,1
50863,443,18214,443,allow,1501,590,911,12,26,6,6
64793,80,12166,80,allow,508,256,252,9,77,5,4
56599,53,21288,53,allow,258,110,148,2,30,1,1
50862,443,25283,443,allow,1501,590,911,12,26,6,6
63800,80,60637,80,allow,314,192,122,6,15,4,2
53077,80,56021,80,allow,1352,625,727,8,75,5,3
49744,53,4877,53,allow,211,102,109,2,30,1,1
49741,80,28243,80,allow,1149,412,737,8,17,5,3
55525,53,40797,53,allow,210,102,108,2,30,1,1
55115,443,23390,443,allow,1348,687,661,14,18,8,6
56623,80,56144,80,allow,234,234,0,4,12,4,0
63953,53,20506,53,allow,426,89,337,4,49,2,2
64800,80,8529,80,allow,508,256,252,9,75,5,4
51167,80,51167,80,allow,1502,817,685,10,20,6,4
52491,53,62857,53,allow,289,86,203,2,30,1,1
37902,123,60994,123,allow,184,94,90,2,30,1,1
60314,80,12778,80,allow,1498,539,959,10,77,6,4
65320,53,12285,53,allow,227,110,117,2,30,1,1
50861,443,62102,443,allow,1501,590,911,12,26,6,6
49905,80,54689,80,allow,1173,672,501,8,31,5,3
55617,53,58686,53,allow,196,94,102,2,30,1,1
64232,53,50382,53,allow,258,110,148,2,30,1,1
49928,53,15390,53,allow,243,102,141,2,30,1,1
57314,443,14727,443,allow,134,60,74,3,6,2,1
57310,443,42139,443,allow,134,60,74,3,6,2,1
49534,80,31376,80,allow,1702,611,1091,8,30,4,4
65474,53,12902,53,allow,198,94,104,2,30,1,1
57311,443,59894,443,allow,134,60,74,3,6,2,1
57309,443,42080,443,allow,134,60,74,3,6,2,1
54807,445,0,0,drop,66,66,0,1,0,1,0
59407,445,0,0,drop,70,70,0,1,0,1,0
54442,445,0,0,drop,70,70,0,1,0,1,0
54440,445,0,0,drop,70,70,0,1,0,1,0
54804,445,0,0,drop,66,66,0,1,0,1,0
54436,445,0,0,drop,70,70,0,1,0,1,0
54797,445,0,0,drop,66,66,0,1,0,1,0
54794,445,0,0,drop,66,66,0,1,0,1,0
60000,80,0,0,deny,60,60,0,1,0,1,0
65068,23,0,0,deny,60,60,0,1,0,1,0
54430,445,0,0,drop,70,70,0,1,0,1,0
54429,445,0,0,drop,70,70,0,1,0,1,0
59396,445,0,0,drop,70,70,0,1,0,1,0
54780,445,0,0,drop,66,66,0,1,0,1,0
54776,445,0,0,drop,66,66,0,1,0,1,0
54779,445,0,0,drop,66,66,0,1,0,1,0
54781,445,0,0,drop,66,66,0,1,0,1,0
54782,445,0,0,drop,66,66,0,1,0,1,0
54774,445,0,0,drop,66,66,0,1,0,1,0
54778,445,0,0,drop,66,66,0,1,0,1,0
54775,445,0,0,drop,66,66,0,1,0,1,0
54424,445,0,0,drop,70,70,0,1,0,1,0
59394,445,0,0,drop,70,70,0,1,0,1,0
59389,445,0,0,drop,70,70,0,1,0,1,0
59390,445,0,0,drop,70,70,0,1,0,1,0
54760,445,0,0,drop,66,66,0,1,0,1,0
54761,445,0,0,drop,66,66,0,1,0,1,0
54759,445,0,0,drop,66,66,0,1,0,1,0
59377,445,0,0,drop,70,70,0,1,0,1,0
54411,445,0,0,drop,70,70,0,1,0,1,0
59375,445,0,0,drop,70,70,0,1,0,1,0
54408,445,0,0,drop,70,70,0,1,0,1,0
59374,445,0,0,drop,70,70,0,1,0,1,0
59370,445,0,0,drop,70,70,0,1,0,1,0
60133,1,0,0,deny,66,66,0,1,0,1,0
54402,445,0,0,drop,70,70,0,1,0,1,0
54400,445,0,0,drop,70,70,0,1,0,1,0
59358,445,0,0,drop,70,70,0,1,0,1,0
59356,445,0,0,drop,70,70,0,1,0,1,0
59353,445,0,0,drop,70,70,0,1,0,1,0
54393,445,0,0,drop,70,70,0,1,0,1,0
54391,445,0,0,drop,70,70,0,1,0,1,0
54739,445,0,0,drop,66,66,0,1,0,1,0
59350,445,0,0,drop,70,70,0,1,0,1,0
54390,445,0,0,drop,70,70,0,1,0,1,0
54405,53,0,0,allow,174,79,95,2,30,1,1
58714,53,58714,53,allow,197,76,121,2,30,1,1
52280,995,52280,995,allow,142,78,64,2,5,1,1
54389,445,0,0,drop,70,70,0,1,0,1,0
54388,445,0,0,drop,70,70,0,1,0,1,0
54386,445,0,0,drop,70,70,0,1,0,1,0
54385,445,0,0,drop,70,70,0,1,0,1,0
54731,445,0,0,drop,66,66,0,1,0,1,0
52286,995,52286,995,allow,146,82,64,2,5,1,1
55746,53,18233,53,allow,302,84,218,4,46,2,2
64326,53,53148,53,allow,323,107,216,4,38,2,2
57315,443,25232,443,allow,134,60,74,3,5,2,1
64723,53,23544,53,allow,677,198,479,6,68,3,3
56476,53,63647,53,allow,239,94,145,2,30,1,1
40165,443,53877,443,allow,232,172,60,3,5,2,1
56596,53,31877,53,allow,350,94,256,2,30,1,1
64494,53,52141,53,allow,337,110,227,2,29,1,1
57312,443,4774,443,allow,134,60,74,3,5,2,1
49475,53,49996,53,allow,243,110,133,2,30,1,1
60715,443,1663,443,allow,1716,1136,580,15,30,9,6
56441,80,25376,80,allow,130,70,60,2,15,1,1
57093,80,11310,80,allow,130,70,60,2,15,1,1
49450,53,42470,53,allow,330,118,212,2,30,1,1
36754,7,13340,7,allow,138,78,60,2,5,1,1
51952,80,54561,80,allow,1263,640,623,12,45,7,5
51951,80,24462,80,allow,1265,642,623,12,45,7,5
49404,53,39531,53,allow,253,102,151,2,30,1,1
56579,53,36844,53,allow,288,94,194,2,30,1,1
49597,80,42235,80,allow,130,70,60,2,15,1,1
50414,443,29700,443,allow,1346,918,428,10,25,6,4
57319,443,43757,443,allow,134,60,74,3,5,2,1
57313,443,59852,443,allow,134,60,74,3,5,2,1
46092,443,17410,443,allow,130,70,60,2,15,1,1
64539,53,23141,53,allow,712,214,498,6,44,3,3
57328,443,39932,443,allow,134,60,74,3,4,2,1
52285,995,52285,995,allow,146,82,64,2,5,1,1
49414,53,44484,53,allow,561,112,449,4,53,2,2
63994,53,4398,53,allow,225,110,115,2,30,1,1
43976,80,46864,80,allow,130,70,60,2,15,1,1
51944,80,27996,80,allow,2120,1080,1040,17,55,10,7
51950,80,41291,80,allow,1268,645,623,12,45,7,5
53244,53,53244,53,allow,217,82,135,2,32,1,1
55979,53,61976,53,allow,275,110,165,2,30,1,1
64731,53,27701,53,allow,403,142,261,2,30,1,1
55060,123,26864,123,allow,184,94,90,2,30,1,1
60980,443,25213,443,allow,134,60,74,3,6,2,1
48344,443,40212,443,allow,232,172,60,3,5,2,1
56930,53,11324,53,allow,297,94,203,2,30,1,1
49292,53,63112,53,allow,323,94,229,2,31,1,1
54730,445,0,0,drop,66,66,0,1,0,1,0
59328,445,0,0,drop,70,70,0,1,0,1,0
54370,445,0,0,drop,70,70,0,1,0,1,0
54369,445,0,0,drop,70,70,0,1,0,1,0
54366,445,0,0,drop,70,70,0,1,0,1,0
59320,445,0,0,drop,70,70,0,1,0,1,0
59317,445,0,0,drop,70,70,0,1,0,1,0
54359,445,0,0,drop,70,70,0,1,0,1,0
54728,445,0,0,drop,66,66,0,1,0,1,0
59301,445,0,0,drop,70,70,0,1,0,1,0
59297,445,0,0,drop,70,70,0,1,0,1,0
59295,445,0,0,drop,70,70,0,1,0,1,0
54721,445,0,0,drop,66,66,0,1,0,1,0
54348,445,0,0,drop,70,70,0,1,0,1,0
54717,445,0,0,drop,66,66,0,1,0,1,0
54716,445,0,0,drop,66,66,0,1,0,1,0
54712,445,0,0,drop,66,66,0,1,0,1,0
54711,445,0,0,drop,66,66,0,1,0,1,0
54710,445,0,0,drop,66,66,0,1,0,1,0
54709,445,0,0,drop,66,66,0,1,0,1,0
59292,445,0,0,drop,70,70,0,1,0,1,0
59286,445,0,0,drop,70,70,0,1,0,1,0
54706,445,0,0,drop,66,66,0,1,0,1,0
54702,445,0,0,drop,66,66,0,1,0,1,0
54701,445,0,0,drop,66,66,0,1,0,1,0
54700,445,0,0,drop,66,66,0,1,0,1,0
54334,445,0,0,drop,70,70,0,1,0,1,0
54335,445,0,0,drop,70,70,0,1,0,1,0
54698,445,0,0,drop,66,66,0,1,0,1,0
54332,445,0,0,drop,70,70,0,1,0,1,0
54331,445,0,0,drop,70,70,0,1,0,1,0
59277,445,0,0,drop,70,70,0,1,0,1,0
59270,445,0,0,drop,70,70,0,1,0,1,0
54321,445,0,0,drop,70,70,0,1,0,1,0
54687,445,0,0,drop,66,66,0,1,0,1,0
54679,445,0,0,drop,66,66,0,1,0,1,0
54312,445,0,0,drop,70,70,0,1,0,1,0
51051,22,51051,22,deny,327,140,187,4,0,2,2
59257,445,0,0,drop,70,70,0,1,0,1,0
54676,445,0,0,drop,66,66,0,1,0,1,0
54308,445,0,0,drop,70,70,0,1,0,1,0
54670,445,0,0,drop,66,66,0,1,0,1,0
54666,445,0,0,drop,66,66,0,1,0,1,0
54301,445,0,0,drop,70,70,0,1,0,1,0
59248,445,0,0,drop,70,70,0,1,0,1,0
59246,445,0,0,drop,70,70,0,1,0,1,0
54651,445,0,0,drop,66,66,0,1,0,1,0
54647,445,0,0,drop,66,66,0,1,0,1,0
54652,445,0,0,drop,66,66,0,1,0,1,0
54648,445,0,0,drop,66,66,0,1,0,1,0
54649,445,0,0,drop,66,66,0,1,0,1,0
54653,445,0,0,drop,66,66,0,1,0,1,0
54650,445,0,0,drop,66,66,0,1,0,1,0
54654,445,0,0,drop,66,66,0,1,0,1,0
54296,445,0,0,drop,70,70,0,1,0,1,0
59232,445,0,0,drop,70,70,0,1,0,1,0
59229,445,0,0,drop,70,70,0,1,0,1,0
59230,445,0,0,drop,70,70,0,1,0,1,0
54632,445,0,0,drop,66,66,0,1,0,1,0
54633,445,0,0,drop,66,66,0,1,0,1,0
54631,445,0,0,drop,66,66,0,1,0,1,0
54283,445,0,0,drop,70,70,0,1,0,1,0
59227,445,0,0,drop,70,70,0,1,0,1,0
54280,445,0,0,drop,70,70,0,1,0,1,0
59225,445,0,0,drop,70,70,0,1,0,1,0
59216,445,0,0,drop,70,70,0,1,0,1,0
59214,445,0,0,drop,70,70,0,1,0,1,0
54276,445,0,0,drop,70,70,0,1,0,1,0
54274,445,0,0,drop,70,70,0,1,0,1,0
54272,445,0,0,drop,70,70,0,1,0,1,0
49535,80,31379,80,allow,1548,847,701,10,16,5,5
37981,80,45214,80,allow,1572,755,817,11,15,6,5
56002,53,0,0,allow,213,88,125,2,30,1,1
65239,53,65239,53,allow,231,90,141,2,30,1,1
58611,53,0,0,allow,172,78,94,2,30,1,1
57700,53,0,0,allow,300,90,210,2,30,1,1
44912,443,31289,443,allow,414,140,274,7,26,3,4
57674,53,0,0,allow,195,79,116,2,30,1,1
64172,53,0,0,allow,174,79,95,2,30,1,1
58217,53,0,0,allow,266,85,181,2,30,1,1
57240,53,0,0,allow,230,87,143,2,30,1,1
58120,53,58120,53,allow,825,99,726,2,30,1,1
51091,53,51091,53,allow,243,96,147,2,30,1,1
55866,53,45530,53,allow,732,89,643,2,30,1,1
52763,53,0,0,allow,296,87,209,2,30,1,1
54908,53,0,0,allow,174,79,95,2,30,1,1
49845,53,0,0,allow,206,83,123,2,30,1,1
61452,53,0,0,allow,223,89,134,2,30,1,1
42008,53,0,0,allow,82,82,0,1,30,1,0
42891,53,42891,53,allow,224,88,136,2,30,1,1
59891,53,0,0,allow,248,75,173,2,30,1,1
59208,445,0,0,drop,70,70,0,1,0,1,0
59207,445,0,0,drop,70,70,0,1,0,1,0
59203,445,0,0,drop,70,70,0,1,0,1,0
54265,445,0,0,drop,70,70,0,1,0,1,0
54263,445,0,0,drop,70,70,0,1,0,1,0
64378,53,28947,53,allow,273,94,179,2,30,1,1
57304,443,45886,443,allow,134,60,74,3,5,2,1
54612,445,0,0,drop,66,66,0,1,0,1,0
54262,445,0,0,drop,70,70,0,1,0,1,0
59200,445,0,0,drop,70,70,0,1,0,1,0
59198,445,0,0,drop,70,70,0,1,0,1,0
54261,445,0,0,drop,70,70,0,1,0,1,0
54260,445,0,0,drop,70,70,0,1,0,1,0
54254,445,0,0,drop,70,70,0,1,0,1,0
54256,445,0,0,drop,70,70,0,1,0,1,0
54605,445,0,0,drop,66,66,0,1,0,1,0
54242,445,0,0,drop,70,70,0,1,0,1,0
54241,445,0,0,deny,70,70,0,1,0,1,0
54235,445,0,0,drop,70,70,0,1,0,1,0
54232,445,0,0,drop,70,70,0,1,0,1,0
54602,445,0,0,drop,66,66,0,1,0,1,0
59180,445,0,0,drop,70,70,0,1,0,1,0
59177,445,0,0,drop,70,70,0,1,0,1,0
54600,445,0,0,drop,66,66,0,1,0,1,0
64835,53,44115,53,allow,371,126,245,2,30,1,1
39228,53,7632,53,allow,199,94,105,2,30,1,1
55684,53,0,0,allow,219,86,133,2,29,1,1
52837,53,0,0,allow,86,86,0,1,29,1,0
50211,53,50211,53,allow,217,90,127,2,29,1,1
50491,53,0,0,allow,183,86,97,2,29,1,1
56969,53,53086,53,allow,196,94,102,2,29,1,1
65191,53,21889,53,allow,196,94,102,2,29,1,1
57426,66,63838,66,allow,70,70,0,1,5,1,0
49710,53,2087,53,allow,179,94,85,2,30,1,1
51433,443,11382,443,allow,194,70,124,3,11,1,2
56592,53,8567,53,allow,262,94,168,2,30,1,1
49710,53,37323,53,allow,179,94,85,2,30,1,1
52763,53,0,0,allow,641,87,554,2,30,1,1
49562,53,45656,53,allow,380,90,290,4,48,2,2
56235,53,15523,53,allow,199,94,105,2,30,1,1
65200,53,35834,53,allow,290,102,188,2,30,1,1
53318,80,64678,80,allow,1536,982,554,10,76,6,4
54246,80,56298,80,allow,506,292,214,8,16,5,3
56622,80,24066,80,allow,234,234,0,4,12,4,0
53716,443,15837,443,allow,70,70,0,1,5,1,0
49434,53,30404,53,allow,326,134,192,2,30,1,1
65009,53,56985,53,allow,737,94,643,2,30,1,1
51432,443,60618,443,allow,194,70,124,3,11,1,2
50567,443,27568,443,allow,198,120,78,4,15,3,1
49881,53,28793,53,allow,395,102,293,2,30,1,1
55624,80,8124,80,allow,70,70,0,2,8,2,0
51447,443,8869,443,allow,202,70,132,3,11,1,2
49849,53,48086,53,allow,325,126,199,2,30,1,1
53707,53,63109,53,allow,86,86,0,1,30,1,0
63990,53,19922,53,allow,270,94,176,2,30,1,1
53981,53,31166,53,allow,199,94,105,2,31,1,1
52743,443,59107,443,allow,1547,960,587,14,26,8,6
59329,53,2601,53,allow,199,94,105,2,30,1,1
43531,53,58732,53,allow,199,94,105,2,30,1,1
59174,445,0,0,drop,70,70,0,1,0,1,0
54220,445,0,0,drop,70,70,0,1,0,1,0
59170,445,0,0,drop,70,70,0,1,0,1,0
59166,445,0,0,drop,70,70,0,1,0,1,0
54593,445,0,0,drop,66,66,0,1,0,1,0
54587,445,0,0,drop,66,66,0,1,0,1,0
54588,445,0,0,drop,66,66,0,1,0,1,0
54586,445,0,0,drop,66,66,0,1,0,1,0
54583,445,0,0,drop,66,66,0,1,0,1,0
54582,445,0,0,drop,66,66,0,1,0,1,0
54580,445,0,0,drop,66,66,0,1,0,1,0
54216,445,0,0,deny,70,70,0,1,0,1,0
59164,445,0,0,drop,70,70,0,1,0,1,0
59162,445,0,0,drop,70,70,0,1,0,1,0
54577,445,0,0,drop,66,66,0,1,0,1,0
59157,445,0,0,drop,70,70,0,1,0,1,0
54575,445,0,0,drop,66,66,0,1,0,1,0
54205,445,0,0,drop,70,70,0,1,0,1,0
54206,445,0,0,drop,70,70,0,1,0,1,0
54204,445,0,0,drop,70,70,0,1,0,1,0
54573,445,0,0,drop,66,66,0,1,0,1,0
54572,445,0,0,drop,66,66,0,1,0,1,0
54200,445,0,0,drop,70,70,0,1,0,1,0
54570,445,0,0,drop,66,66,0,1,0,1,0
59149,445,0,0,drop,70,70,0,1,0,1,0
55898,443,55898,443,deny,1850,431,1419,5,0,3,2
54194,445,0,0,drop,70,70,0,1,0,1,0
54559,445,0,0,drop,66,66,0,1,0,1,0
54186,445,0,0,drop,70,70,0,1,0,1,0
54183,445,0,0,drop,70,70,0,1,0,1,0
54551,445,0,0,drop,66,66,0,1,0,1,0
59129,445,0,0,drop,70,70,0,1,0,1,0
54180,445,0,0,drop,70,70,0,1,0,1,0
54549,445,0,0,drop,66,66,0,1,0,1,0
54174,445,0,0,drop,70,70,0,1,0,1,0
54540,445,0,0,drop,66,66,0,1,0,1,0
54539,445,0,0,drop,66,66,0,1,0,1,0
54173,445,0,0,drop,70,70,0,1,0,1,0
54168,445,0,0,drop,70,70,0,1,0,1,0
59122,445,0,0,drop,70,70,0,1,0,1,0
59118,445,0,0,drop,70,70,0,1,0,1,0
59117,445,0,0,drop,70,70,0,1,0,1,0
54518,445,0,0,drop,66,66,0,1,0,1,0
54520,445,0,0,drop,66,66,0,1,0,1,0
54524,445,0,0,drop,66,66,0,1,0,1,0
54521,445,0,0,drop,66,66,0,1,0,1,0
54526,445,0,0,drop,66,66,0,1,0,1,0
54525,445,0,0,drop,66,66,0,1,0,1,0
54523,445,0,0,drop,66,66,0,1,0,1,0
54519,445,0,0,drop,66,66,0,1,0,1,0
59112,445,0,0,drop,70,70,0,1,0,1,0
59109,445,0,0,drop,70,70,0,1,0,1,0
59101,445,0,0,drop,70,70,0,1,0,1,0
54155,445,0,0,drop,70,70,0,1,0,1,0
54505,445,0,0,drop,66,66,0,1,0,1,0
54504,445,0,0,drop,66,66,0,1,0,1,0
54503,445,0,0,drop,66,66,0,1,0,1,0
54152,445,0,0,drop,70,70,0,1,0,1,0
59100,445,0,0,drop,70,70,0,1,0,1,0
52052,80,64577,80,allow,2188,593,1595,11,16,5,6
41543,443,55490,443,allow,234,234,0,4,12,4,0
56590,53,0,0,allow,82,82,0,1,30,1,0
46232,53,46232,53,allow,194,87,107,2,30,1,1
53615,867,2680,867,allow,70,70,0,1,5,1,0
52064,80,49794,80,allow,2125,709,1416,11,16,5,6
58115,53,48692,53,allow,578,286,292,9,15,5,4
52963,80,22153,80,allow,1600,581,1019,10,15,6,4
59097,445,0,0,drop,70,70,0,1,0,1,0
59093,445,0,0,drop,70,70,0,1,0,1,0
59091,445,0,0,drop,70,70,0,1,0,1,0
65199,53,63329,53,allow,793,207,586,6,59,3,3
39916,53,62317,53,allow,168,78,90,2,30,1,1
56180,53,56180,53,allow,229,98,131,2,30,1,1
37321,53,37321,53,allow,197,90,107,2,30,1,1
42843,53,7011,53,allow,168,78,90,2,30,1,1
50550,53,58594,53,allow,168,78,90,2,30,1,1
64221,53,19919,53,allow,262,102,160,2,30,1,1
36448,53,11652,53,allow,199,94,105,2,30,1,1
49574,53,2504,53,allow,496,92,404,4,58,2,2
65138,53,7886,53,allow,418,94,324,2,30,1,1
52727,443,14385,443,allow,1369,708,661,14,45,8,6
49537,53,41171,53,allow,686,276,410,8,74,4,4
63974,53,33864,53,allow,618,111,507,4,30,2,2
49823,53,39316,53,allow,388,102,286,2,30,1,1
55044,53,47229,53,allow,168,78,90,2,30,1,1
55392,53,63211,53,allow,418,94,324,2,30,1,1
46232,53,46232,53,allow,216,90,126,2,30,1,1
51836,53,49755,53,allow,168,78,90,2,30,1,1
58785,53,58785,53,allow,216,90,126,2,30,1,1
60505,443,23004,443,allow,1061,727,334,9,26,4,5
55041,80,12804,80,allow,486,240,246,9,35,5,4
56114,53,31669,53,allow,194,86,108,2,30,1,1
59080,445,0,0,drop,70,70,0,1,0,1,0
59079,445,0,0,drop,70,70,0,1,0,1,0
59075,445,0,0,drop,70,70,0,1,0,1,0
54137,445,0,0,drop,70,70,0,1,0,1,0
54135,445,0,0,drop,70,70,0,1,0,1,0
54134,445,0,0,drop,70,70,0,1,0,1,0
54133,445,0,0,drop,70,70,0,1,0,1,0
54128,445,0,0,drop,70,70,0,1,0,1,0
54484,445,0,0,drop,66,66,0,1,0,1,0
59072,445,0,0,drop,70,70,0,1,0,1,0
59070,445,0,0,drop,70,70,0,1,0,1,0
54114,445,0,0,drop,70,70,0,1,0,1,0
54113,445,0,0,drop,70,70,0,1,0,1,0
54109,445,0,0,drop,70,70,0,1,0,1,0
54103,445,0,0,drop,70,70,0,1,0,1,0
54475,445,0,0,drop,66,66,0,1,0,1,0
54474,445,0,0,drop,66,66,0,1,0,1,0
59053,445,0,0,drop,70,70,0,1,0,1,0
59049,445,0,0,drop,70,70,0,1,0,1,0
59050,445,0,0,drop,70,70,0,1,0,1,0
54471,445,0,0,drop,66,66,0,1,0,1,0
54092,445,0,0,drop,70,70,0,1,0,1,0
59044,445,0,0,drop,70,70,0,1,0,1,0
59042,445,0,0,drop,70,70,0,1,0,1,0
59041,445,0,0,drop,70,70,0,1,0,1,0
59039,445,0,0,drop,70,70,0,1,0,1,0
54464,445,0,0,drop,66,66,0,1,0,1,0
54460,445,0,0,drop,66,66,0,1,0,1,0
54459,445,0,0,drop,66,66,0,1,0,1,0
54456,445,0,0,drop,66,66,0,1,0,1,0
54454,445,0,0,drop,66,66,0,1,0,1,0
54455,445,0,0,drop,66,66,0,1,0,1,0
54452,445,0,0,drop,66,66,0,1,0,1,0
62908,21,0,0,deny,60,60,0,1,0,1,0
59034,445,0,0,drop,70,70,0,1,0,1,0
59033,445,0,0,drop,70,70,0,1,0,1,0
54078,445,0,0,drop,70,70,0,1,0,1,0
54077,445,0,0,drop,70,70,0,1,0,1,0
54450,445,0,0,drop,66,66,0,1,0,1,0
54074,445,0,0,drop,70,70,0,1,0,1,0
54076,445,0,0,drop,70,70,0,1,0,1,0
54446,445,0,0,drop,66,66,0,1,0,1,0
54445,445,0,0,drop,66,66,0,1,0,1,0
54443,445,0,0,drop,66,66,0,1,0,1,0
54442,445,0,0,drop,66,66,0,1,0,1,0
59021,445,0,0,drop,70,70,0,1,0,1,0
54065,445,0,0,drop,70,70,0,1,0,1,0
59012,445,0,0,drop,70,70,0,1,0,1,0
54432,445,0,0,drop,66,66,0,1,0,1,0
54058,445,0,0,drop,70,70,0,1,0,1,0
54057,445,0,0,drop,70,70,0,1,0,1,0
54423,445,0,0,drop,66,66,0,1,0,1,0
54051,445,0,0,drop,70,70,0,1,0,1,0
59001,445,0,0,drop,70,70,0,1,0,1,0
54050,445,0,0,drop,70,70,0,1,0,1,0
54420,445,0,0,drop,66,66,0,1,0,1,0
50804,1,0,0,deny,62,62,0,1,0,1,0
54046,445,0,0,drop,70,70,0,1,0,1,0
54413,445,0,0,drop,66,66,0,1,0,1,0
54045,445,0,0,drop,70,70,0,1,0,1,0
54410,445,0,0,drop,66,66,0,1,0,1,0
58992,445,0,0,drop,70,70,0,1,0,1,0
58991,445,0,0,drop,70,70,0,1,0,1,0
58989,445,0,0,drop,70,70,0,1,0,1,0
54392,445,0,0,drop,66,66,0,1,0,1,0
54395,445,0,0,drop,66,66,0,1,0,1,0
54397,445,0,0,drop,66,66,0,1,0,1,0
54398,445,0,0,drop,66,66,0,1,0,1,0
54394,445,0,0,drop,66,66,0,1,0,1,0
54393,445,0,0,drop,66,66,0,1,0,1,0
54396,445,0,0,drop,66,66,0,1,0,1,0
54390,445,0,0,drop,66,66,0,1,0,1,0
53608,1024,20573,1024,allow,70,70,0,1,5,1,0
56944,80,48541,80,allow,214,140,74,4,30,3,1
53612,1032,48115,1032,allow,130,70,60,2,6,1,1
61189,443,61189,443,allow,1092,645,447,10,34,6,4
39328,80,5790,80,allow,78,78,0,1,5,1,0
54144,443,15023,443,allow,2227,1018,1209,17,16,8,9
58981,445,0,0,drop,70,70,0,1,0,1,0
58980,445,0,0,drop,70,70,0,1,0,1,0
58973,445,0,0,drop,70,70,0,1,0,1,0
54024,445,0,0,drop,70,70,0,1,0,1,0
54377,445,0,0,drop,66,66,0,1,0,1,0
64315,53,11433,53,allow,322,102,220,2,30,1,1
60798,443,60798,443,allow,1092,645,447,10,34,6,4
49765,53,55989,53,allow,233,102,131,2,30,1,1
55047,80,59301,80,allow,306,180,126,6,32,4,2
48467,80,55817,80,allow,1113,534,579,12,15,7,5
49504,443,22336,443,allow,62,62,0,1,5,1,0
56445,53,50550,53,allow,353,110,243,4,46,2,2
56966,80,60389,80,allow,214,140,74,4,30,3,1
56939,80,26245,80,allow,194,128,66,4,31,3,1
55042,80,32886,80,allow,306,180,126,6,34,4,2
55213,53,60229,53,allow,238,94,144,2,30,1,1
53669,80,61903,80,allow,1119,665,454,12,15,7,5
55043,80,21312,80,allow,306,180,126,6,34,4,2
64067,53,26067,53,allow,331,102,229,2,30,1,1
49998,53,11230,53,allow,467,90,377,4,39,2,2
60709,443,60709,443,allow,1092,645,447,10,34,6,4
49921,80,16260,80,allow,1126,609,517,11,15,6,5
49922,80,11141,80,allow,1126,609,517,11,15,6,5
56965,80,39996,80,allow,526,304,222,8,30,5,3
49923,80,28185,80,allow,1126,609,517,11,15,6,5
57929,53,0,0,allow,294,86,208,2,30,1,1
64349,53,48163,53,allow,392,102,290,2,30,1,1
55209,53,33482,53,allow,196,102,94,2,33,1,1
57353,443,50919,443,allow,70,70,0,1,5,1,0
54287,443,5975,443,allow,250,190,60,2,5,1,1
60891,443,53303,443,allow,204,70,134,4,25,2,2
49860,53,13520,53,allow,550,129,421,4,57,2,2
64379,53,61307,53,allow,333,94,239,2,30,1,1
64506,53,36287,53,allow,184,86,98,2,30,1,1
55040,80,41951,80,allow,486,240,246,9,34,5,4
55044,80,26880,80,allow,306,180,126,6,34,4,2
56800,1,46367,1,allow,70,70,0,1,5,1,0
58858,443,49748,443,allow,208,60,148,4,10,2,2
56955,80,64782,80,allow,214,140,74,4,30,3,1
41184,53,29887,53,allow,168,78,90,2,30,1,1
64102,53,25876,53,allow,274,94,180,2,29,1,1
64353,53,31104,53,allow,225,102,123,2,29,1,1
64162,53,14611,53,allow,225,110,115,2,30,1,1
49924,80,4925,80,allow,1126,609,517,11,15,6,5
60875,443,60875,443,allow,1092,645,447,10,34,6,4
60721,443,60721,443,allow,1092,645,447,10,34,6,4
56621,80,4891,80,allow,234,234,0,4,12,4,0
56946,80,58825,80,allow,214,140,74,4,30,3,1
56945,80,24790,80,allow,214,140,74,4,30,3,1
49774,53,40062,53,allow,234,102,132,2,30,1,1
50875,53,21370,53,allow,78,78,0,1,30,1,0
60031,443,5116,443,allow,350,210,140,6,15,4,2
51943,53,57117,53,allow,200,86,114,2,30,1,1
63941,53,9002,53,allow,228,94,134,2,30,1,1
41311,443,64855,443,allow,70,70,0,1,5,1,0
58930,443,53896,443,allow,70,70,0,1,5,1,0
53668,80,20063,80,allow,1173,665,508,13,16,7,6
54376,445,0,0,drop,66,66,0,1,0,1,0
54375,445,0,0,drop,66,66,0,1,0,1,0
58969,445,0,0,drop,70,70,0,1,0,1,0
54019,445,0,0,drop,70,70,0,1,0,1,0
58968,445,0,0,drop,70,70,0,1,0,1,0
58962,445,0,0,drop,70,70,0,1,0,1,0
54018,445,0,0,drop,70,70,0,1,0,1,0
54016,445,0,0,drop,70,70,0,1,0,1,0
58952,445,0,0,drop,70,70,0,1,0,1,0
58950,445,0,0,drop,70,70,0,1,0,1,0
58946,445,0,0,drop,70,70,0,1,0,1,0
54009,445,0,0,drop,70,70,0,1,0,1,0
54007,445,0,0,drop,70,70,0,1,0,1,0
54006,445,0,0,drop,70,70,0,1,0,1,0
54005,445,0,0,drop,70,70,0,1,0,1,0
54004,445,0,0,drop,70,70,0,1,0,1,0
53999,445,0,0,drop,70,70,0,1,0,1,0
54355,445,0,0,drop,66,66,0,1,0,1,0
58944,445,0,0,drop,70,70,0,1,0,1,0
53986,445,0,0,drop,70,70,0,1,0,1,0
53985,445,0,0,drop,70,70,0,1,0,1,0
53976,445,0,0,drop,70,70,0,1,0,1,0
53975,445,0,0,drop,70,70,0,1,0,1,0
62907,21,0,0,deny,60,60,0,1,0,1,0
54348,445,0,0,drop,66,66,0,1,0,1,0
54345,445,0,0,drop,66,66,0,1,0,1,0
58924,445,0,0,drop,70,70,0,1,0,1,0
58922,445,0,0,drop,70,70,0,1,0,1,0
54342,445,0,0,drop,66,66,0,1,0,1,0
50522,443,53720,443,allow,460,394,66,4,0,3,1
58917,445,0,0,drop,70,70,0,1,0,1,0
58914,445,0,0,drop,70,70,0,1,0,1,0
58912,445,0,0,drop,70,70,0,1,0,1,0
54336,445,0,0,drop,66,66,0,1,0,1,0
52160,1,0,0,deny,145,145,0,1,0,1,0
54330,445,0,0,drop,66,66,0,1,0,1,0
54332,445,0,0,drop,66,66,0,1,0,1,0
54328,445,0,0,drop,66,66,0,1,0,1,0
53960,445,0,0,drop,70,70,0,1,0,1,0
54324,445,0,0,drop,66,66,0,1,0,1,0
54323,445,0,0,drop,66,66,0,1,0,1,0
54325,445,0,0,drop,66,66,0,1,0,1,0
53950,445,0,0,drop,70,70,0,1,0,1,0
53949,445,0,0,drop,70,70,0,1,0,1,0
53945,445,0,0,drop,70,70,0,1,0,1,0
53948,445,0,0,drop,70,70,0,1,0,1,0
58909,445,0,0,drop,70,70,0,1,0,1,0
58906,445,0,0,drop,70,70,0,1,0,1,0
53944,445,0,0,drop,70,70,0,1,0,1,0
54320,445,0,0,drop,66,66,0,1,0,1,0
54318,445,0,0,drop,66,66,0,1,0,1,0
54315,445,0,0,drop,66,66,0,1,0,1,0
54314,445,0,0,drop,66,66,0,1,0,1,0
54313,445,0,0,drop,66,66,0,1,0,1,0
53938,445,0,0,drop,70,70,0,1,0,1,0
58893,445,0,0,drop,70,70,0,1,0,1,0
58891,445,0,0,drop,70,70,0,1,0,1,0
53928,445,0,0,drop,70,70,0,1,0,1,0
54304,445,0,0,drop,66,66,0,1,0,1,0
53924,445,0,0,drop,70,70,0,1,0,1,0
54294,445,0,0,drop,66,66,0,1,0,1,0
58879,445,0,0,drop,70,70,0,1,0,1,0
53918,445,0,0,drop,70,70,0,1,0,1,0
54292,445,0,0,drop,66,66,0,1,0,1,0
53917,445,0,0,drop,70,70,0,1,0,1,0
54285,445,0,0,drop,66,66,0,1,0,1,0
54278,445,0,0,drop,66,66,0,1,0,1,0
37096,443,16174,443,allow,130,70,60,2,15,1,1
64797,80,54604,80,allow,378,192,186,7,71,4,3
47750,443,44039,443,allow,70,70,0,1,5,1,0
39630,443,32291,443,allow,70,70,0,1,5,1,0
47871,443,47202,443,allow,70,70,0,1,5,1,0
38557,443,3043,443,allow,70,70,0,1,5,1,0
59240,53,59240,53,allow,194,87,107,2,30,1,1
53912,445,0,0,drop,70,70,0,1,0,1,0
58865,445,0,0,drop,70,70,0,1,0,1,0
58861,445,0,0,drop,70,70,0,1,0,1,0
55996,53,10816,53,allow,168,86,82,2,30,1,1
63788,80,49704,80,allow,314,192,122,6,15,4,2
51403,443,50805,443,allow,190,70,120,4,8,2,2
52438,443,56919,443,allow,70,70,0,1,4,1,0
57160,53,20461,53,allow,255,110,145,2,29,1,1
39596,53,5876,53,allow,168,78,90,2,30,1,1
64700,53,35656,53,allow,239,86,153,2,29,1,1
65404,53,47407,53,allow,334,226,108,3,29,2,1
52409,443,39608,443,allow,1369,708,661,14,24,8,6
56519,80,41989,80,allow,370,222,148,6,32,4,2
52405,53,59064,53,allow,168,78,90,2,30,1,1
56351,53,2881,53,allow,195,102,93,2,30,1,1
55996,53,61146,53,allow,196,86,110,2,30,1,1
49511,443,56126,443,allow,1200,623,577,13,27,6,7
60192,53,4239,53,allow,236,94,142,2,30,1,1
56259,53,56259,53,allow,244,98,146,2,32,1,1
56452,53,0,0,allow,82,82,0,2,40,2,0
55980,123,7764,123,allow,184,94,90,2,30,1,1
56584,53,11866,53,allow,214,102,112,2,30,1,1
56977,53,42818,53,allow,273,102,171,2,30,1,1
53392,53,29793,53,allow,164,78,86,2,31,1,1
49477,443,54783,443,allow,1332,876,456,11,27,6,5
64907,53,16767,53,allow,211,102,109,2,30,1,1
56351,53,53304,53,allow,195,102,93,2,33,1,1
49491,443,28351,443,allow,1627,884,743,12,27,6,6
64778,53,20977,53,allow,269,110,159,2,30,1,1
49988,53,19025,53,allow,214,102,112,2,30,1,1
60180,53,36445,53,allow,225,110,115,2,30,1,1
36516,443,59096,443,allow,70,70,0,1,4,1,0
64609,53,8196,53,allow,404,95,309,4,43,2,2
48713,80,47813,80,allow,1767,751,1016,10,15,6,4
44417,53,0,0,allow,82,82,0,2,40,2,0
64488,53,54282,53,allow,356,98,258,4,35,2,2
54972,80,43170,80,allow,1074,691,383,12,66,7,5
62883,53,56502,53,allow,205,86,119,2,29,1,1
48883,53,16845,53,allow,168,78,90,2,30,1,1
49489,443,60116,443,allow,1627,884,743,12,27,6,6
65087,53,63765,53,allow,230,110,120,2,30,1,1
64979,53,11759,53,allow,254,102,152,2,30,1,1
65072,53,64909,53,allow,338,110,228,2,29,1,1
49490,443,58298,443,allow,1627,884,743,12,27,6,6
63925,53,47553,53,allow,388,134,254,2,30,1,1
49713,53,41539,53,allow,233,94,139,2,30,1,1
65037,53,14259,53,allow,243,94,149,2,30,1,1
49500,443,37954,443,allow,1197,620,577,13,27,6,7
53103,443,15301,443,allow,130,70,60,2,15,1,1
65340,53,10565,53,allow,226,102,124,2,30,1,1
65102,53,16634,53,allow,210,102,108,2,30,1,1
59052,53,10639,53,allow,504,110,394,2,30,1,1
56816,53,22918,53,allow,233,94,139,2,30,1,1
65209,53,17107,53,allow,212,102,110,2,30,1,1
56707,53,58987,53,allow,199,94,105,2,30,1,1
54266,445,0,0,drop,66,66,0,1,0,1,0
54269,445,0,0,drop,66,66,0,1,0,1,0
54264,445,0,0,drop,66,66,0,1,0,1,0
54267,445,0,0,drop,66,66,0,1,0,1,0
54268,445,0,0,drop,66,66,0,1,0,1,0
54263,445,0,0,drop,66,66,0,1,0,1,0
54262,445,0,0,drop,66,66,0,1,0,1,0
54261,445,0,0,drop,66,66,0,1,0,1,0
53899,445,0,0,drop,70,70,0,1,0,1,0
53894,445,0,0,drop,70,70,0,1,0,1,0
58853,445,0,0,drop,70,70,0,1,0,1,0
58851,445,0,0,drop,70,70,0,1,0,1,0
58850,445,0,0,drop,70,70,0,1,0,1,0
54248,445,0,0,drop,66,66,0,1,0,1,0
54247,445,0,0,drop,66,66,0,1,0,1,0
54246,445,0,0,drop,66,66,0,1,0,1,0
55248,67,0,0,deny,60,60,0,1,0,1,0
53890,445,0,0,drop,70,70,0,1,0,1,0
58841,445,0,0,drop,70,70,0,1,0,1,0
58840,445,0,0,drop,70,70,0,1,0,1,0
58839,445,0,0,drop,70,70,0,1,0,1,0
58835,445,0,0,drop,70,70,0,1,0,1,0
57473,23,0,0,deny,60,60,0,1,0,1,0
53879,445,0,0,drop,70,70,0,1,0,1,0
58824,445,0,0,drop,70,70,0,1,0,1,0
58822,445,0,0,drop,70,70,0,1,0,1,0
58818,445,0,0,drop,70,70,0,1,0,1,0
53877,445,0,0,drop,70,70,0,1,0,1,0
53876,445,0,0,drop,70,70,0,1,0,1,0
53875,445,0,0,drop,70,70,0,1,0,1,0
53872,445,0,0,drop,70,70,0,1,0,1,0
53870,445,0,0,drop,70,70,0,1,0,1,0
54223,445,0,0,drop,66,66,0,1,0,1,0
58815,445,0,0,drop,70,70,0,1,0,1,0
58814,445,0,0,drop,70,70,0,1,0,1,0
53855,445,0,0,drop,70,70,0,1,0,1,0
53853,445,0,0,drop,70,70,0,1,0,1,0
53846,445,0,0,drop,70,70,0,1,0,1,0
54218,445,0,0,drop,66,66,0,1,0,1,0
54217,445,0,0,drop,66,66,0,1,0,1,0
47030,81,0,0,deny,60,60,0,1,0,1,0
58800,445,0,0,drop,70,70,0,1,0,1,0
58792,445,0,0,drop,70,70,0,1,0,1,0
53834,445,0,0,drop,70,70,0,1,0,1,0
54214,445,0,0,drop,66,66,0,1,0,1,0
58790,445,0,0,drop,70,70,0,1,0,1,0
58786,445,0,0,drop,70,70,0,1,0,1,0
58785,445,0,0,drop,70,70,0,1,0,1,0
54206,445,0,0,drop,66,66,0,1,0,1,0
54204,445,0,0,drop,66,66,0,1,0,1,0
54202,445,0,0,drop,66,66,0,1,0,1,0
54199,445,0,0,drop,66,66,0,1,0,1,0
54197,445,0,0,drop,66,66,0,1,0,1,0
54198,445,0,0,drop,66,66,0,1,0,1,0
54196,445,0,0,drop,66,66,0,1,0,1,0
53820,445,0,0,drop,70,70,0,1,0,1,0
53819,445,0,0,drop,70,70,0,1,0,1,0
53817,445,0,0,drop,70,70,0,1,0,1,0
53816,445,0,0,drop,70,70,0,1,0,1,0
53813,445,0,0,drop,70,70,0,1,0,1,0
58778,445,0,0,drop,70,70,0,1,0,1,0
58777,445,0,0,drop,70,70,0,1,0,1,0
54191,445,0,0,drop,66,66,0,1,0,1,0
54189,445,0,0,drop,66,66,0,1,0,1,0
54188,445,0,0,drop,66,66,0,1,0,1,0
54187,445,0,0,drop,66,66,0,1,0,1,0
54184,445,0,0,drop,66,66,0,1,0,1,0
53807,445,0,0,drop,70,70,0,1,0,1,0
58765,445,0,0,drop,70,70,0,1,0,1,0
54176,445,0,0,drop,66,66,0,1,0,1,0
53792,445,0,0,drop,70,70,0,1,0,1,0
54166,445,0,0,drop,66,66,0,1,0,1,0
58747,445,0,0,drop,70,70,0,1,0,1,0
53788,445,0,0,deny,70,70,0,1,0,1,0
36445,443,53718,443,allow,78,78,0,1,5,1,0
44320,443,45352,443,allow,1657,1128,529,15,35,9,6
51035,443,33243,443,allow,2227,1018,1209,17,16,8,9
65257,53,65257,53,allow,176,78,98,2,30,1,1
64253,53,64253,53,allow,288,83,205,2,30,1,1
49710,53,26259,53,allow,89,89,0,1,30,1,0
53366,53,53366,53,allow,237,98,139,2,30,1,1
59177,53,0,0,allow,619,76,543,2,30,1,1
59177,53,0,0,allow,426,152,274,4,30,2,2
57709,53,57709,53,allow,265,111,154,2,30,1,1
54164,445,0,0,drop,66,66,0,1,0,1,0
53786,445,0,0,drop,70,70,0,1,0,1,0
60319,23,0,0,deny,60,60,0,1,0,1,0
54155,445,0,0,drop,66,66,0,1,0,1,0
54149,445,0,0,drop,66,66,0,1,0,1,0
48681,80,45826,80,allow,918,461,457,9,15,6,3
49778,53,5798,53,allow,319,98,221,4,53,2,2
56947,53,0,0,allow,86,86,0,1,29,1,0
64099,53,12065,53,allow,227,110,117,2,30,1,1
64219,53,37826,53,allow,264,102,162,2,30,1,1
64596,53,15356,53,allow,215,86,129,2,30,1,1
39423,80,5862,80,allow,234,234,0,4,12,4,0
64667,53,24129,53,allow,353,118,235,2,30,1,1
46034,53,59880,53,allow,168,78,90,2,30,1,1
49510,443,46546,443,allow,1012,495,517,10,26,4,6
36410,53,36410,53,allow,268,114,154,2,30,1,1
49518,53,34801,53,allow,213,102,111,2,30,1,1
56620,80,60684,80,allow,234,234,0,4,12,4,0
49316,53,52712,53,allow,338,102,236,2,30,1,1
49180,53,47398,53,allow,402,102,300,2,30,1,1
63062,53,18913,53,allow,70,70,0,1,30,1,0
39487,80,41504,80,allow,1403,651,752,10,15,6,4
49402,80,31803,80,allow,405,285,120,5,15,3,2
38761,123,12089,123,allow,184,94,90,2,30,1,1
64370,53,62116,53,allow,399,102,297,4,54,2,2
64075,53,49394,53,allow,352,86,266,4,36,2,2
65194,53,62268,53,allow,298,102,196,2,29,1,1
54891,80,41573,80,allow,1222,782,440,11,15,6,5
54160,53,34866,53,allow,199,94,105,2,29,1,1
64893,53,31080,53,allow,232,102,130,2,30,1,1
58568,53,2690,53,allow,294,86,208,2,30,1,1
56723,53,3556,53,allow,198,94,104,2,30,1,1
64276,53,2055,53,allow,436,89,347,4,42,2,2
51499,443,54241,443,allow,1610,1073,537,14,15,8,6
64649,53,33149,53,allow,225,102,123,2,30,1,1
50471,53,24459,53,allow,168,78,90,2,30,1,1
54130,53,45665,53,allow,168,78,90,2,30,1,1
53782,445,0,0,drop,70,70,0,1,0,1,0
58734,445,0,0,drop,70,70,0,1,0,1,0
58733,445,0,0,drop,70,70,0,1,0,1,0
54141,445,0,0,drop,66,66,0,1,0,1,0
54139,445,0,0,drop,66,66,0,1,0,1,0
54138,445,0,0,drop,66,66,0,1,0,1,0
54140,445,0,0,drop,66,66,0,1,0,1,0
54137,445,0,0,drop,66,66,0,1,0,1,0
54136,445,0,0,drop,66,66,0,1,0,1,0
54135,445,0,0,drop,66,66,0,1,0,1,0
54133,445,0,0,drop,66,66,0,1,0,1,0
53769,445,0,0,drop,70,70,0,1,0,1,0
53766,445,0,0,drop,70,70,0,1,0,1,0
58729,445,0,0,drop,70,70,0,1,0,1,0
58728,445,0,0,drop,70,70,0,1,0,1,0
58727,445,0,0,drop,70,70,0,1,0,1,0
54121,445,0,0,drop,66,66,0,1,0,1,0
54120,445,0,0,drop,66,66,0,1,0,1,0
54119,445,0,0,drop,66,66,0,1,0,1,0
58716,445,0,0,drop,70,70,0,1,0,1,0
53760,445,0,0,drop,70,70,0,1,0,1,0
37876,23,0,0,deny,60,60,0,1,0,1,0
41561,23,0,0,deny,60,60,0,1,0,1,0
58713,445,0,0,drop,70,70,0,1,0,1,0
58705,445,0,0,drop,70,70,0,1,0,1,0
53751,445,0,0,drop,70,70,0,1,0,1,0
53749,445,0,0,drop,70,70,0,1,0,1,0
58694,445,0,0,drop,70,70,0,1,0,1,0
58695,445,0,0,drop,70,70,0,1,0,1,0
58691,445,0,0,drop,70,70,0,1,0,1,0
53747,445,0,0,drop,70,70,0,1,0,1,0
53740,445,0,0,drop,70,70,0,1,0,1,0
53741,445,0,0,drop,70,70,0,1,0,1,0
53727,445,0,0,drop,70,70,0,1,0,1,0
54096,445,0,0,drop,66,66,0,1,0,1,0
58686,445,0,0,drop,70,70,0,1,0,1,0
54091,445,0,0,drop,66,66,0,1,0,1,0
54089,445,0,0,drop,66,66,0,1,0,1,0
58668,445,0,0,drop,70,70,0,1,0,1,0
58665,445,0,0,drop,70,70,0,1,0,1,0
54086,445,0,0,drop,66,66,0,1,0,1,0
58660,445,0,0,drop,70,70,0,1,0,1,0
53702,445,0,0,drop,70,70,0,1,0,1,0
58238,23,0,0,deny,60,60,0,1,0,1,0
58658,445,0,0,drop,70,70,0,1,0,1,0
58656,445,0,0,drop,70,70,0,1,0,1,0
54078,445,0,0,drop,66,66,0,1,0,1,0
54073,445,0,0,drop,66,66,0,1,0,1,0
54075,445,0,0,drop,66,66,0,1,0,1,0
54074,445,0,0,drop,66,66,0,1,0,1,0
53692,445,0,0,drop,70,70,0,1,0,1,0
53693,445,0,0,drop,70,70,0,1,0,1,0
53688,445,0,0,drop,70,70,0,1,0,1,0
53689,445,0,0,drop,70,70,0,1,0,1,0
54070,445,0,0,drop,66,66,0,1,0,1,0
54069,445,0,0,drop,66,66,0,1,0,1,0
54067,445,0,0,drop,66,66,0,1,0,1,0
53685,445,0,0,drop,70,70,0,1,0,1,0
58652,445,0,0,drop,70,70,0,1,0,1,0
58649,445,0,0,drop,70,70,0,1,0,1,0
54064,445,0,0,drop,66,66,0,1,0,1,0
54061,445,0,0,drop,66,66,0,1,0,1,0
54060,445,0,0,drop,66,66,0,1,0,1,0
54059,445,0,0,drop,66,66,0,1,0,1,0
53680,445,0,0,drop,70,70,0,1,0,1,0
54057,445,0,0,drop,66,66,0,1,0,1,0
44934,443,47157,443,allow,416,210,206,7,24,4,3
38133,53,38133,53,allow,194,87,107,2,30,1,1
51496,443,43516,443,allow,416,210,206,7,15,4,3
59952,53,59952,53,allow,215,80,135,2,32,1,1
52375,80,39641,80,allow,78,78,0,1,5,1,0
59762,443,29034,443,allow,382,164,218,2,31,1,1
63529,53,63529,53,allow,217,91,126,2,30,1,1
56118,53,56118,53,allow,233,91,142,2,30,1,1
60939,53,60939,53,allow,237,91,146,2,32,1,1
58638,445,0,0,drop,70,70,0,1,0,1,0
53670,445,0,0,drop,70,70,0,1,0,1,0
43319,53,43319,53,allow,237,91,146,2,32,1,1
49238,53,49238,53,allow,235,90,145,2,32,1,1
59761,53,13611,53,allow,569,164,405,2,31,1,1
38655,443,22510,443,allow,498,210,288,8,26,4,4
43601,80,43601,80,allow,1252,539,713,10,20,5,5
37052,53,37052,53,allow,259,104,155,2,30,1,1
47521,53,9404,53,allow,198,93,105,2,30,1,1
38867,53,38867,53,allow,213,79,134,2,32,1,1
47821,53,47821,53,allow,228,97,131,2,30,1,1
45846,443,47275,443,allow,2227,1018,1209,17,15,8,9
50422,53,50422,53,allow,194,87,107,2,30,1,1
36037,53,7009,53,allow,198,93,105,2,30,1,1
36649,53,5716,53,allow,198,93,105,2,30,1,1
59831,53,14617,53,allow,198,93,105,2,30,1,1
54047,445,0,0,drop,66,66,0,1,0,1,0
53664,445,0,0,drop,70,70,0,1,0,1,0
37759,53,3026,53,allow,199,94,105,2,30,1,1
51497,443,10165,443,allow,350,210,140,6,14,4,2
49904,53,31561,53,allow,217,94,123,2,29,1,1
48620,53,31132,53,allow,199,94,105,2,29,1,1
50777,53,12522,53,allow,199,94,105,2,30,1,1
55454,53,34563,53,allow,321,105,216,4,40,2,2
43674,53,36130,53,allow,199,94,105,2,30,1,1
47050,53,14793,53,allow,199,94,105,2,30,1,1
53793,53,24147,53,allow,213,78,135,2,30,1,1
63957,53,57529,53,allow,211,102,109,2,30,1,1
47824,53,65037,53,allow,199,94,105,2,30,1,1
57415,53,16994,53,allow,223,86,137,2,30,1,1
58601,53,45683,53,allow,198,86,112,2,30,1,1
64294,53,36421,53,allow,329,118,211,2,30,1,1
60287,53,47078,53,allow,215,86,129,2,30,1,1
43039,53,37075,53,allow,241,78,163,2,30,1,1
64752,53,43912,53,allow,210,94,116,2,30,1,1
55080,53,5647,53,allow,330,86,244,2,30,1,1
59764,53,23530,53,allow,304,86,218,2,30,1,1
64280,53,51701,53,allow,211,94,117,2,30,1,1
59765,443,22401,443,allow,571,166,405,2,30,1,1
64019,53,58991,53,allow,267,94,173,2,30,1,1
62023,53,10426,53,allow,301,102,199,2,30,1,1
57138,443,50278,443,allow,498,210,288,8,26,4,4
63967,53,14948,53,allow,283,97,186,4,36,2,2
53192,80,30945,80,allow,814,335,479,10,15,5,5
42705,80,6053,80,allow,1222,782,440,11,15,6,5
51448,80,39374,80,allow,214,140,74,4,15,3,1
51689,53,28477,53,allow,198,86,112,2,29,1,1
57149,53,45353,53,allow,222,86,136,2,30,1,1
56508,80,35273,80,allow,318,192,126,6,30,4,2
61559,53,9585,53,allow,376,86,290,2,29,1,1
55784,53,34530,53,allow,199,94,105,2,29,1,1
42895,53,15137,53,allow,168,78,90,2,30,1,1
59766,53,33803,53,allow,512,166,346,2,30,1,1
59752,443,12592,443,allow,304,86,218,2,30,1,1
59751,53,11335,53,allow,304,86,218,2,30,1,1
39484,80,6764,80,allow,1403,651,752,10,16,6,4
64449,53,61840,53,allow,197,94,103,2,30,1,1
53792,53,47522,53,allow,224,86,138,2,30,1,1
55454,53,16777,53,allow,168,78,90,2,30,1,1
53791,53,53567,53,allow,260,86,174,2,30,1,1
58511,53,45280,53,allow,302,86,216,2,30,1,1
49762,53,13712,53,allow,335,142,193,2,30,1,1
59763,443,40613,443,allow,304,86,218,2,30,1,1
60318,123,6592,123,allow,184,94,90,2,30,1,1
45937,53,13210,53,allow,241,78,163,2,30,1,1
43382,53,39674,53,allow,86,86,0,1,30,1,0
58616,80,39662,80,allow,1056,682,374,10,15,6,4
64989,53,60666,53,allow,214,102,112,2,30,1,1
53789,53,10128,53,allow,167,78,89,2,30,1,1
45237,53,45237,53,allow,235,90,145,2,33,1,1
61075,53,61075,53,allow,244,98,146,2,32,1,1
49914,53,31140,53,allow,215,86,129,2,30,1,1
49863,53,59500,53,allow,200,86,114,2,30,1,1
59755,443,15018,443,allow,448,166,282,2,30,1,1
64180,53,33989,53,allow,296,91,205,4,55,2,2
64858,53,1882,53,allow,227,102,125,2,30,1,1
64468,53,38719,53,allow,259,118,141,2,30,1,1
53660,445,0,0,drop,70,70,0,1,0,1,0
54038,445,0,0,drop,66,66,0,1,0,1,0
58624,445,0,0,drop,70,70,0,1,0,1,0
53659,445,0,0,drop,70,70,0,1,0,1,0
54035,445,0,0,drop,66,66,0,1,0,1,0
54029,445,0,0,drop,66,66,0,1,0,1,0
54021,445,0,0,drop,66,66,0,1,0,1,0
49950,23,0,0,deny,60,60,0,1,0,1,0
58609,445,0,0,drop,70,70,0,1,0,1,0
58606,445,0,0,drop,70,70,0,1,0,1,0
58605,445,0,0,drop,70,70,0,1,0,1,0
54013,445,0,0,drop,66,66,0,1,0,1,0
54011,445,0,0,drop,66,66,0,1,0,1,0
54012,445,0,0,drop,66,66,0,1,0,1,0
54010,445,0,0,drop,66,66,0,1,0,1,0
54009,445,0,0,drop,66,66,0,1,0,1,0
54007,445,0,0,drop,66,66,0,1,0,1,0
54006,445,0,0,drop,66,66,0,1,0,1,0
54005,445,0,0,drop,66,66,0,1,0,1,0
53641,445,0,0,drop,70,70,0,1,0,1,0
53638,445,0,0,drop,70,70,0,1,0,1,0
54703,23,0,0,deny,60,60,0,1,0,1,0
58596,445,0,0,drop,70,70,0,1,0,1,0
58594,445,0,0,drop,70,70,0,1,0,1,0
53634,445,0,0,drop,70,70,0,1,0,1,0
53990,445,0,0,drop,66,66,0,1,0,1,0
53992,445,0,0,drop,66,66,0,1,0,1,0
53991,445,0,0,drop,66,66,0,1,0,1,0
53632,445,0,0,drop,70,70,0,1,0,1,0
53630,445,0,0,drop,70,70,0,1,0,1,0
58585,445,0,0,drop,70,70,0,1,0,1,0
58575,445,0,0,drop,70,70,0,1,0,1,0
37589,443,25099,443,allow,499,425,74,4,0,3,1
37590,443,21881,443,allow,499,425,74,4,0,3,1
37592,443,5868,443,allow,499,425,74,4,0,3,1
37588,443,34121,443,allow,499,425,74,4,0,3,1
37591,443,50251,443,allow,499,425,74,4,0,3,1
37585,443,50718,443,allow,499,425,74,4,2,3,1
53623,445,0,0,drop,70,70,0,1,0,1,0
53621,445,0,0,drop,70,70,0,1,0,1,0
53620,445,0,0,drop,70,70,0,1,0,1,0
58568,445,0,0,drop,70,70,0,1,0,1,0
58566,445,0,0,drop,70,70,0,1,0,1,0
58562,445,0,0,drop,70,70,0,1,0,1,0
53619,445,0,0,drop,70,70,0,1,0,1,0
53618,445,0,0,drop,70,70,0,1,0,1,0
53616,445,0,0,drop,70,70,0,1,0,1,0
53810,23,0,0,deny,60,60,0,1,0,1,0
53600,445,0,0,drop,70,70,0,1,0,1,0
53594,445,0,0,drop,70,70,0,1,0,1,0
53590,445,0,0,drop,70,70,0,1,0,1,0
53968,445,0,0,drop,66,66,0,1,0,1,0
58558,445,0,0,drop,70,70,0,1,0,1,0
58559,445,0,0,drop,70,70,0,1,0,1,0
53578,445,0,0,drop,70,70,0,1,0,1,0
53963,445,0,0,drop,66,66,0,1,0,1,0
53961,445,0,0,drop,66,66,0,1,0,1,0
58541,445,0,0,drop,70,70,0,1,0,1,0
58536,445,0,0,drop,70,70,0,1,0,1,0
53959,445,0,0,drop,66,66,0,1,0,1,0
58533,445,0,0,drop,70,70,0,1,0,1,0
58530,445,0,0,drop,70,70,0,1,0,1,0
58526,445,0,0,drop,70,70,0,1,0,1,0
58528,445,0,0,drop,70,70,0,1,0,1,0
53563,445,0,0,drop,70,70,0,1,0,1,0
53564,445,0,0,drop,70,70,0,1,0,1,0
53951,445,0,0,drop,66,66,0,1,0,1,0
53562,445,0,0,drop,70,70,0,1,0,1,0
53557,445,0,0,drop,70,70,0,1,0,1,0
53948,445,0,0,drop,66,66,0,1,0,1,0
53949,445,0,0,drop,66,66,0,1,0,1,0
53947,445,0,0,drop,66,66,0,1,0,1,0
53942,445,0,0,drop,66,66,0,1,0,1,0
53940,445,0,0,drop,66,66,0,1,0,1,0
53939,445,0,0,drop,66,66,0,1,0,1,0
59404,53,59404,53,allow,237,91,146,2,32,1,1
59754,53,13358,53,allow,303,85,218,2,30,1,1
59457,53,59457,53,allow,213,87,126,2,30,1,1
50367,53,22257,53,allow,578,286,292,9,15,5,4
54051,53,54051,53,allow,617,67,550,2,30,1,1
59753,443,43725,443,allow,303,85,218,2,30,1,1
58519,445,0,0,drop,70,70,0,1,0,1,0
53937,445,0,0,drop,66,66,0,1,0,1,0
58517,445,0,0,drop,70,70,0,1,0,1,0
53551,445,0,0,drop,70,70,0,1,0,1,0
53933,445,0,0,drop,66,66,0,1,0,1,0
53931,445,0,0,drop,66,66,0,1,0,1,0
53930,445,0,0,drop,66,66,0,1,0,1,0
53928,445,0,0,drop,66,66,0,1,0,1,0
53716,443,47470,443,allow,70,70,0,2,8,2,0
53544,445,0,0,drop,70,70,0,1,0,1,0
53543,445,0,0,deny,70,70,0,1,0,1,0
58510,445,0,0,drop,70,70,0,1,0,1,0
58507,445,0,0,drop,70,70,0,1,0,1,0
58505,445,0,0,drop,70,70,0,1,0,1,0
53538,445,0,0,drop,70,70,0,1,0,1,0
53536,445,0,0,drop,70,70,0,1,0,1,0
53917,445,0,0,drop,66,66,0,1,0,1,0
56624,53,53106,53,allow,259,118,141,2,29,1,1
65516,53,35992,53,allow,305,89,216,4,41,2,2
49185,53,26156,53,allow,307,94,213,2,29,1,1
64305,53,21382,53,allow,598,196,402,6,71,3,3
50015,53,57649,53,allow,287,94,193,2,29,1,1
59749,443,34617,443,allow,304,86,218,2,29,1,1
49483,53,5607,53,allow,273,94,179,2,30,1,1
59750,53,24886,53,allow,304,86,218,2,29,1,1
51491,443,61886,443,allow,343,163,180,6,15,3,3
50260,53,44495,53,allow,168,86,82,2,30,1,1
53034,53,25305,53,allow,238,94,144,2,30,1,1
60911,53,60911,53,allow,216,90,126,2,30,1,1
49370,53,35451,53,allow,430,85,345,4,54,2,2
49300,53,25911,53,allow,232,86,146,2,30,1,1
49192,53,8580,53,allow,212,102,110,2,30,1,1
57426,66,14765,66,allow,70,70,0,2,8,2,0
55434,53,55434,53,allow,198,90,108,2,30,1,1
59859,53,1491,53,allow,218,86,132,2,30,1,1
55514,53,24000,53,allow,216,94,122,2,30,1,1
51492,80,15284,80,allow,1517,481,1036,11,15,6,5
49665,53,62694,53,allow,289,99,190,4,35,2,2
51411,443,26944,443,allow,509,329,180,6,8,3,3
56619,80,59686,80,allow,234,234,0,4,12,4,0
59760,53,48696,53,allow,384,166,218,2,29,1,1
59758,443,28743,443,allow,384,166,218,2,29,1,1
53790,53,7041,53,allow,167,78,89,2,29,1,1
51694,80,56366,80,allow,1307,649,658,8,75,5,3
59748,53,27175,53,allow,304,86,218,2,29,1,1
65116,53,7436,53,allow,220,94,126,2,29,1,1
59759,53,55695,53,allow,384,166,218,2,29,1,1
59757,443,52007,443,allow,384,166,218,2,29,1,1
64065,53,29677,53,allow,270,94,176,2,30,1,1
59756,53,64652,53,allow,571,166,405,2,29,1,1
59747,443,7939,443,allow,304,86,218,2,29,1,1
50260,53,50381,53,allow,196,86,110,2,30,1,1
51413,443,55199,443,allow,695,575,120,4,6,2,2
58166,53,23423,53,allow,224,94,130,2,30,1,1
45567,443,10380,443,allow,1473,988,485,12,25,7,5
49791,53,7553,53,allow,216,94,122,2,30,1,1
64952,53,2309,53,allow,232,94,138,2,30,1,1
62061,53,49325,53,allow,181,78,103,2,30,1,1
49612,53,33123,53,allow,234,94,140,2,31,1,1
64668,53,24152,53,allow,211,102,109,2,30,1,1
44691,53,43758,53,allow,199,94,105,2,30,1,1
64990,53,21080,53,allow,323,94,229,2,30,1,1
65372,53,52621,53,allow,330,91,239,4,44,2,2
57464,80,18705,80,allow,78,78,0,1,5,1,0
51072,80,39928,80,allow,1299,793,506,12,16,6,6
53910,445,0,0,drop,66,66,0,1,0,1,0
58495,445,0,0,drop,70,70,0,1,0,1,0
53907,445,0,0,drop,66,66,0,1,0,1,0
53526,445,0,0,drop,70,70,0,1,0,1,0
53901,445,0,0,drop,66,66,0,1,0,1,0
53897,445,0,0,drop,66,66,0,1,0,1,0
53513,445,0,0,drop,70,70,0,1,0,1,0
58481,445,0,0,drop,70,70,0,1,0,1,0
58477,445,0,0,drop,70,70,0,1,0,1,0
58478,445,0,0,drop,70,70,0,1,0,1,0
53881,445,0,0,drop,66,66,0,1,0,1,0
53884,445,0,0,drop,66,66,0,1,0,1,0
53878,445,0,0,drop,66,66,0,1,0,1,0
53880,445,0,0,drop,66,66,0,1,0,1,0
53882,445,0,0,drop,66,66,0,1,0,1,0
53883,445,0,0,drop,66,66,0,1,0,1,0
53877,445,0,0,drop,66,66,0,1,0,1,0
53879,445,0,0,drop,66,66,0,1,0,1,0
53510,445,0,0,drop,70,70,0,1,0,1,0
58470,445,0,0,drop,70,70,0,1,0,1,0
58468,445,0,0,drop,70,70,0,1,0,1,0
58464,445,0,0,drop,70,70,0,1,0,1,0
53505,445,0,0,drop,70,70,0,1,0,1,0
53504,445,0,0,drop,70,70,0,1,0,1,0
53864,445,0,0,drop,66,66,0,1,0,1,0
53865,445,0,0,drop,66,66,0,1,0,1,0
53862,445,0,0,drop,66,66,0,1,0,1,0
53502,445,0,0,drop,70,70,0,1,0,1,0
58459,445,0,0,drop,70,70,0,1,0,1,0
45410,1,0,0,deny,62,62,0,1,0,1,0
58449,445,0,0,drop,70,70,0,1,0,1,0
58445,445,0,0,drop,70,70,0,1,0,1,0
53495,445,0,0,drop,70,70,0,1,0,1,0
53493,445,0,0,drop,70,70,0,1,0,1,0
53492,445,0,0,drop,70,70,0,1,0,1,0
53491,445,0,0,drop,70,70,0,1,0,1,0
53490,445,0,0,drop,70,70,0,1,0,1,0
53488,445,0,0,drop,70,70,0,1,0,1,0
56946,1,0,0,deny,66,66,0,1,0,1,0
58440,445,0,0,drop,70,70,0,1,0,1,0
58438,445,0,0,drop,70,70,0,1,0,1,0
58435,445,0,0,drop,70,70,0,1,0,1,0
53472,445,0,0,drop,70,70,0,1,0,1,0
53470,445,0,0,drop,70,70,0,1,0,1,0
53466,445,0,0,drop,70,70,0,1,0,1,0
53461,445,0,0,drop,70,70,0,1,0,1,0
53841,445,0,0,drop,66,66,0,1,0,1,0
58432,445,0,0,drop,70,70,0,1,0,1,0
58430,445,0,0,drop,70,70,0,1,0,1,0
53450,445,0,0,drop,70,70,0,1,0,1,0
53835,445,0,0,drop,66,66,0,1,0,1,0
53833,445,0,0,drop,66,66,0,1,0,1,0
58419,445,0,0,drop,70,70,0,1,0,1,0
58416,445,0,0,drop,70,70,0,1,0,1,0
58409,445,0,0,drop,70,70,0,1,0,1,0
58411,445,0,0,drop,70,70,0,1,0,1,0
53829,445,0,0,drop,66,66,0,1,0,1,0
53446,445,0,0,drop,70,70,0,1,0,1,0
59486,80,62432,80,allow,2633,1151,1482,10,32,6,4
47423,80,58553,80,allow,1056,682,374,10,15,6,4
40765,443,6306,443,allow,1093,662,431,10,41,6,4
41597,53,41597,53,allow,213,79,134,2,32,1,1
40766,443,50985,443,allow,1093,662,431,10,41,6,4
37661,53,37661,53,allow,237,91,146,2,32,1,1
46785,53,46785,53,allow,230,91,139,2,30,1,1
53615,867,16773,867,allow,70,70,0,2,7,2,0
65315,53,36671,53,allow,300,99,201,4,30,2,2
65315,53,56097,53,allow,216,110,106,2,30,1,1
62820,53,62820,53,allow,237,91,146,2,33,1,1
44823,53,0,0,allow,82,82,0,1,30,1,0
56351,53,9188,53,allow,190,97,93,2,30,1,1
60750,53,24428,53,allow,198,93,105,2,30,1,1
49751,53,48975,53,allow,232,92,140,2,30,1,1
64609,53,57916,53,allow,146,75,71,2,31,1,1
60039,53,37317,53,allow,312,82,230,2,31,1,1
38501,53,38501,53,allow,233,91,142,2,31,1,1
37330,53,37330,53,allow,237,91,146,2,31,1,1
53436,445,0,0,drop,70,70,0,1,0,1,0
53437,445,0,0,drop,70,70,0,1,0,1,0
58404,445,0,0,drop,70,70,0,1,0,1,0
53433,445,0,0,drop,70,70,0,1,0,1,0
58402,445,0,0,drop,70,70,0,1,0,1,0
58401,445,0,0,drop,70,70,0,1,0,1,0
58398,445,0,0,drop,70,70,0,1,0,1,0
53429,445,0,0,drop,70,70,0,1,0,1,0
53823,445,0,0,drop,66,66,0,1,0,1,0
53819,445,0,0,drop,66,66,0,1,0,1,0
53818,445,0,0,drop,66,66,0,1,0,1,0
53816,445,0,0,drop,66,66,0,1,0,1,0
49156,53,13189,53,allow,199,94,105,2,29,1,1
63996,53,49603,53,allow,252,102,150,2,30,1,1
47046,80,21371,80,allow,1114,534,580,12,15,7,5
41508,53,41508,53,allow,244,98,146,2,32,1,1
56351,53,4846,53,allow,195,102,93,2,32,1,1
57268,443,5467,443,allow,1617,1073,544,16,15,9,7
50386,443,59778,443,allow,1346,918,428,10,26,6,4
63463,53,56932,53,allow,199,86,113,2,29,1,1
49708,53,19621,53,allow,212,94,118,2,29,1,1
49340,53,43709,53,allow,94,94,0,1,30,1,0
60900,53,31593,53,allow,181,86,95,2,30,1,1
53788,53,27955,53,allow,213,78,135,2,30,1,1
38119,443,46487,443,allow,1820,1101,719,18,16,10,8
55826,53,63992,53,allow,168,86,82,2,30,1,1
64872,53,23783,53,allow,323,94,229,2,30,1,1
51573,53,28199,53,allow,212,86,126,2,30,1,1
58610,53,58610,53,allow,244,98,146,2,32,1,1
50017,80,11643,80,allow,827,687,140,6,32,4,2
36762,443,46444,443,allow,560,280,280,9,25,5,4
65043,53,7870,53,allow,213,94,119,2,29,1,1
57343,53,10133,53,allow,214,86,128,2,29,1,1
61879,53,34841,53,allow,207,86,121,2,29,1,1
65219,53,25255,53,allow,229,102,127,2,29,1,1
55826,53,27290,53,allow,86,86,0,2,34,2,0
65315,53,22076,53,allow,216,110,106,2,30,1,1
62705,443,33676,443,allow,178,118,60,2,15,1,1
56007,53,0,0,allow,86,86,0,1,30,1,0
65315,53,30606,53,allow,216,110,106,2,30,1,1
65394,53,54686,53,allow,230,94,136,2,30,1,1
44059,53,51061,53,allow,199,94,105,2,30,1,1
64755,53,11546,53,allow,339,134,205,2,30,1,1
55252,53,15058,53,allow,212,102,110,2,30,1,1
65157,53,24624,53,allow,209,102,107,2,31,1,1
56667,53,23608,53,allow,168,86,82,2,31,1,1
58415,443,33034,443,allow,560,280,280,9,30,5,4
56934,80,1586,80,allow,486,280,206,8,26,5,3
63963,53,44790,53,allow,212,102,110,2,30,1,1
53618,1025,19237,1025,allow,320,140,180,6,7,3,3
49923,53,15331,53,allow,199,94,105,2,30,1,1
53787,53,59844,53,allow,224,86,138,2,30,1,1
64255,53,2166,53,allow,332,102,230,2,30,1,1
56443,53,9982,53,allow,168,86,82,2,31,1,1
56933,80,47498,80,allow,486,280,206,8,26,5,3
65153,53,10346,53,allow,241,118,123,2,30,1,1
53813,445,0,0,drop,66,66,0,1,0,1,0
53814,445,0,0,drop,66,66,0,1,0,1,0
53811,445,0,0,drop,66,66,0,1,0,1,0
58397,445,0,0,drop,70,70,0,1,0,1,0
58393,445,0,0,drop,70,70,0,1,0,1,0
53809,445,0,0,drop,66,66,0,1,0,1,0
58389,445,0,0,drop,70,70,0,1,0,1,0
53806,445,0,0,drop,66,66,0,1,0,1,0
53804,445,0,0,drop,66,66,0,1,0,1,0
53803,445,0,0,drop,66,66,0,1,0,1,0
53800,445,0,0,drop,66,66,0,1,0,1,0
53415,445,0,0,drop,70,70,0,1,0,1,0
58382,445,0,0,drop,70,70,0,1,0,1,0
53409,445,0,0,drop,70,70,0,1,0,1,0
58376,445,0,0,drop,70,70,0,1,0,1,0
53790,445,0,0,drop,66,66,0,1,0,1,0
53782,445,0,0,drop,66,66,0,1,0,1,0
58361,445,0,0,drop,70,70,0,1,0,1,0
53779,445,0,0,drop,66,66,0,1,0,1,0
53773,445,0,0,drop,66,66,0,1,0,1,0
53768,445,0,0,drop,66,66,0,1,0,1,0
60196,53,0,0,deny,88,88,0,1,0,1,0
53385,445,0,0,drop,70,70,0,1,0,1,0
58350,445,0,0,drop,70,70,0,1,0,1,0
53754,445,0,0,drop,66,66,0,1,0,1,0
53757,445,0,0,drop,66,66,0,1,0,1,0
53755,445,0,0,drop,66,66,0,1,0,1,0
53756,445,0,0,drop,66,66,0,1,0,1,0
53753,445,0,0,drop,66,66,0,1,0,1,0
53751,445,0,0,drop,66,66,0,1,0,1,0
53752,445,0,0,drop,66,66,0,1,0,1,0
53749,445,0,0,drop,66,66,0,1,0,1,0
53382,445,0,0,drop,70,70,0,1,0,1,0
52973,23,0,0,deny,60,60,0,1,0,1,0
44121,23,0,0,deny,60,60,0,1,0,1,0
53377,445,0,0,drop,70,70,0,1,0,1,0
53376,445,0,0,drop,70,70,0,1,0,1,0
58348,445,0,0,drop,70,70,0,1,0,1,0
58339,445,0,0,drop,70,70,0,1,0,1,0
53374,445,0,0,drop,70,70,0,1,0,1,0
53737,445,0,0,drop,66,66,0,1,0,1,0
53736,445,0,0,drop,66,66,0,1,0,1,0
53734,445,0,0,drop,66,66,0,1,0,1,0
58330,445,0,0,drop,70,70,0,1,0,1,0
58328,445,0,0,drop,70,70,0,1,0,1,0
58321,445,0,0,drop,70,70,0,1,0,1,0
53367,445,0,0,drop,70,70,0,1,0,1,0
53365,445,0,0,drop,70,70,0,1,0,1,0
53364,445,0,0,drop,70,70,0,1,0,1,0
53363,445,0,0,drop,70,70,0,1,0,1,0
53362,445,0,0,drop,70,70,0,1,0,1,0
53357,445,0,0,drop,70,70,0,1,0,1,0
53356,445,0,0,drop,70,70,0,1,0,1,0
58312,445,0,0,drop,70,70,0,1,0,1,0
58307,445,0,0,drop,70,70,0,1,0,1,0
53344,445,0,0,drop,70,70,0,1,0,1,0
53341,445,0,0,drop,70,70,0,1,0,1,0
53334,445,0,0,drop,70,70,0,1,0,1,0
53333,445,0,0,drop,70,70,0,1,0,1,0
53714,445,0,0,drop,66,66,0,1,0,1,0
58298,445,0,0,drop,70,70,0,1,0,1,0
53322,445,0,0,drop,70,70,0,1,0,1,0
54501,80,17667,80,allow,254,128,126,5,16,3,2
56169,53,17161,53,allow,916,86,830,2,30,1,1
57236,53,14592,53,allow,748,95,653,2,30,1,1
53608,1024,52758,1024,allow,70,70,0,2,8,2,0
49629,53,19594,53,allow,916,86,830,2,30,1,1
60464,53,0,0,allow,180,82,98,2,30,1,1
42510,53,42510,53,allow,237,91,146,2,32,1,1
56805,1,17140,1,allow,70,70,0,1,5,1,0
50438,53,48155,53,allow,295,101,194,4,31,2,2
56443,53,2207,53,allow,168,86,82,2,30,1,1
56667,53,46013,53,allow,168,86,82,2,30,1,1
58993,443,16211,443,allow,1437,736,701,15,28,7,8
45204,53,45204,53,allow,237,91,146,2,33,1,1
52018,80,20950,80,allow,1660,791,869,11,32,6,5
56202,53,30224,53,allow,916,86,830,2,30,1,1
55736,53,0,0,allow,338,70,268,2,30,1,1
43473,53,43473,53,allow,220,100,120,2,30,1,1
55736,53,0,0,allow,623,70,553,2,30,1,1
64971,53,0,0,allow,229,85,144,2,31,1,1
53707,445,0,0,drop,66,66,0,1,0,1,0
53705,445,0,0,drop,66,66,0,1,0,1,0
63967,53,11149,53,allow,195,102,93,2,30,1,1
52415,443,32301,443,allow,2007,1152,855,14,15,8,6
49639,53,29692,53,allow,250,102,148,2,29,1,1
62888,53,62888,53,allow,240,98,142,2,29,1,1
56667,53,25410,53,allow,250,86,164,4,29,2,2
49447,53,25197,53,allow,248,102,146,2,29,1,1
64073,53,51133,53,allow,361,86,275,2,30,1,1
55158,53,42446,53,allow,239,102,137,2,30,1,1
56663,53,28501,53,allow,215,102,113,2,30,1,1
50097,53,57646,53,allow,199,94,105,2,30,1,1
56997,53,45686,53,allow,168,86,82,2,30,1,1
57427,53,45535,53,allow,363,94,269,2,30,1,1
53577,53,0,0,allow,82,82,0,2,40,2,0
52413,443,50762,443,allow,2114,1152,962,14,15,8,6
41385,53,41385,53,allow,244,98,146,2,34,1,1
58055,80,49869,80,allow,254,128,126,5,15,3,2
41542,23,41542,23,allow,66,66,0,1,5,1,0
56618,80,46340,80,allow,234,234,0,4,12,4,0
51580,53,9399,53,allow,199,94,105,2,30,1,1
56742,53,0,0,allow,82,82,0,2,40,2,0
56048,53,3715,53,allow,296,110,186,2,30,1,1
63777,80,2556,80,allow,314,192,122,6,15,4,2
59723,80,4011,80,allow,613,539,74,7,15,6,1
59165,53,3627,53,allow,320,94,226,2,30,1,1
64609,53,7201,53,allow,168,86,82,2,30,1,1
64609,53,19942,53,allow,168,86,82,2,30,1,1
64926,53,31198,53,allow,309,118,191,2,30,1,1
55284,53,61340,53,allow,193,102,91,2,30,1,1
49205,80,50738,80,allow,890,411,479,11,15,6,5
54957,80,50979,80,allow,416,210,206,7,15,4,3
57362,53,47817,53,allow,183,86,97,2,30,1,1
45648,80,30446,80,allow,130,70,60,2,15,1,1
59538,80,28530,80,allow,1895,755,1140,11,14,6,5
56997,53,24700,53,allow,337,107,230,4,34,2,2
55484,443,18380,443,allow,782,428,354,12,25,7,5
46414,80,41611,80,allow,1155,781,374,10,15,6,4
64005,53,59576,53,allow,402,125,277,4,37,2,2
64991,53,47067,53,allow,625,192,433,6,46,3,3
65364,53,50447,53,allow,226,110,116,2,29,1,1
64693,53,28781,53,allow,248,102,146,2,30,1,1
56443,53,48417,53,allow,250,86,164,4,29,2,2
56667,53,35767,53,allow,168,86,82,2,29,1,1
53786,53,10105,53,allow,260,86,174,2,30,1,1
56443,53,60191,53,allow,168,86,82,2,30,1,1
41631,123,31654,123,allow,184,94,90,2,30,1,1
57991,53,26816,53,allow,220,78,142,2,30,1,1
51176,53,44581,53,allow,236,86,150,2,30,1,1
46865,443,9898,443,allow,416,210,206,7,32,4,3
56800,1,6191,1,allow,70,70,0,2,8,2,0
43872,53,52878,53,allow,199,94,105,2,30,1,1
55072,53,52370,53,allow,168,86,82,2,30,1,1
64609,53,7620,53,allow,250,86,164,4,30,2,2
48458,53,30263,53,allow,168,78,90,2,31,1,1
64072,53,31241,53,allow,292,110,182,2,30,1,1
57304,53,22240,53,allow,292,110,182,2,30,1,1
49665,53,45405,53,allow,197,102,95,2,30,1,1
52508,53,51671,53,allow,168,78,90,2,30,1,1
50438,53,55322,53,allow,199,102,97,2,31,1,1
50452,80,41109,80,allow,318,192,126,6,29,4,2
64082,53,17005,53,allow,356,97,259,4,58,2,2
53318,445,0,0,drop,70,70,0,1,0,1,0
58286,445,0,0,drop,70,70,0,1,0,1,0
58287,445,0,0,drop,70,70,0,1,0,1,0
53702,445,0,0,drop,66,66,0,1,0,1,0
53309,445,0,0,drop,70,70,0,1,0,1,0
53308,445,0,0,drop,70,70,0,1,0,1,0
53305,445,0,0,drop,70,70,0,1,0,1,0
53303,445,0,0,drop,70,70,0,1,0,1,0
58278,445,0,0,drop,70,70,0,1,0,1,0
58273,445,0,0,drop,70,70,0,1,0,1,0
58270,445,0,0,drop,70,70,0,1,0,1,0
58269,445,0,0,drop,70,70,0,1,0,1,0
53696,445,0,0,drop,66,66,0,1,0,1,0
53692,445,0,0,drop,66,66,0,1,0,1,0
53691,445,0,0,drop,66,66,0,1,0,1,0
53687,445,0,0,drop,66,66,0,1,0,1,0
53686,445,0,0,drop,66,66,0,1,0,1,0
53685,445,0,0,drop,66,66,0,1,0,1,0
53683,445,0,0,drop,66,66,0,1,0,1,0
58268,445,0,0,drop,70,70,0,1,0,1,0
58265,445,0,0,drop,70,70,0,1,0,1,0
53682,445,0,0,drop,66,66,0,1,0,1,0
58260,445,0,0,drop,70,70,0,1,0,1,0
53677,445,0,0,drop,66,66,0,1,0,1,0
53286,445,0,0,drop,70,70,0,1,0,1,0
53676,445,0,0,drop,66,66,0,1,0,1,0
53675,445,0,0,drop,66,66,0,1,0,1,0
53673,445,0,0,drop,66,66,0,1,0,1,0
53280,445,0,0,drop,70,70,0,1,0,1,0
53278,445,0,0,drop,70,70,0,1,0,1,0
58253,445,0,0,drop,70,70,0,1,0,1,0
53274,445,0,0,drop,70,70,0,1,0,1,0
53664,445,0,0,drop,66,66,0,1,0,1,0
53273,445,0,0,drop,70,70,0,1,0,1,0
53654,445,0,0,drop,66,66,0,1,0,1,0
58234,445,0,0,drop,70,70,0,1,0,1,0
53268,445,0,0,drop,70,70,0,1,0,1,0
53652,445,0,0,drop,66,66,0,1,0,1,0
53645,445,0,0,drop,66,66,0,1,0,1,0
53639,445,0,0,drop,66,66,0,1,0,1,0
53255,445,0,0,drop,70,70,0,1,0,1,0
58224,445,0,0,drop,70,70,0,1,0,1,0
58220,445,0,0,drop,70,70,0,1,0,1,0
53628,445,0,0,drop,66,66,0,1,0,1,0
53629,445,0,0,drop,66,66,0,1,0,1,0
53626,445,0,0,drop,66,66,0,1,0,1,0
53623,445,0,0,drop,66,66,0,1,0,1,0
53625,445,0,0,drop,66,66,0,1,0,1,0
53627,445,0,0,drop,66,66,0,1,0,1,0
53624,445,0,0,drop,66,66,0,1,0,1,0
53621,445,0,0,drop,66,66,0,1,0,1,0
63716,23,0,0,deny,60,60,0,1,0,1,0
53246,445,0,0,drop,70,70,0,1,0,1,0
37587,443,50576,443,allow,499,425,74,4,0,3,1
37586,443,60521,443,allow,499,425,74,4,0,3,1
37584,443,21310,443,allow,499,425,74,4,0,3,1
37581,443,35670,443,allow,499,425,74,4,0,3,1
37582,443,52781,443,allow,499,425,74,4,0,3,1
37583,443,36088,443,allow,499,425,74,4,0,3,1
58217,445,0,0,drop,70,70,0,1,0,1,0
58213,445,0,0,drop,70,70,0,1,0,1,0
58209,445,0,0,drop,70,70,0,1,0,1,0
53609,445,0,0,drop,66,66,0,1,0,1,0
53608,445,0,0,drop,66,66,0,1,0,1,0
53606,445,0,0,drop,66,66,0,1,0,1,0
58202,445,0,0,drop,70,70,0,1,0,1,0
45082,17,0,0,deny,60,60,0,1,0,1,0
53237,445,0,0,drop,70,70,0,1,0,1,0
58200,445,0,0,drop,70,70,0,1,0,1,0
58196,445,0,0,drop,70,70,0,1,0,1,0
58198,445,0,0,drop,70,70,0,1,0,1,0
58191,445,0,0,drop,70,70,0,1,0,1,0
53235,445,0,0,drop,70,70,0,1,0,1,0
53234,445,0,0,drop,70,70,0,1,0,1,0
53232,445,0,0,drop,70,70,0,1,0,1,0
53229,445,0,0,drop,70,70,0,1,0,1,0
53212,445,0,0,drop,70,70,0,1,0,1,0
58182,445,0,0,drop,70,70,0,1,0,1,0
58177,445,0,0,drop,70,70,0,1,0,1,0
53209,445,0,0,drop,70,70,0,1,0,1,0
50230,80,20217,80,allow,2384,952,1432,15,75,8,7
55209,53,9446,53,allow,98,98,0,1,30,1,0
49835,53,4982,53,allow,146,75,71,2,30,1,1
53612,1032,47132,1032,allow,130,70,60,3,5,2,1
49485,80,52074,80,allow,1155,781,374,10,15,6,4
36907,53,36907,53,allow,237,91,146,2,33,1,1
49663,53,18877,53,allow,184,80,104,2,30,1,1
55404,53,28730,53,allow,711,87,624,2,30,1,1
57842,53,57842,53,allow,225,87,138,2,30,1,1
50227,80,3538,80,allow,1935,895,1040,15,75,8,7
49665,53,12263,53,allow,194,99,95,2,30,1,1
65384,53,58692,53,allow,194,99,95,2,30,1,1
48303,53,44805,53,allow,198,93,105,2,31,1,1
53585,445,0,0,drop,66,66,0,1,0,1,0
53192,445,0,0,drop,70,70,0,1,0,1,0
58175,445,0,0,drop,70,70,0,1,0,1,0
58167,445,0,0,drop,70,70,0,1,0,1,0
64505,53,38734,53,allow,373,126,247,2,30,1,1
62486,53,59489,53,allow,102,102,0,1,30,1,0
56771,53,26360,53,allow,193,102,91,2,31,1,1
49178,53,17300,53,allow,348,105,243,4,45,2,2
55284,53,36720,53,allow,193,102,91,2,29,1,1
65050,53,2914,53,allow,264,102,162,2,30,1,1
64849,53,57025,53,allow,340,110,230,2,29,1,1
50459,80,33223,80,allow,1328,917,411,10,28,6,4
64171,53,42919,53,allow,211,102,109,2,29,1,1
50451,80,26551,80,allow,378,192,186,7,28,4,3
49480,53,4215,53,allow,168,78,90,2,29,1,1
56760,53,34251,53,allow,216,102,114,2,30,1,1
55593,53,53460,53,allow,102,102,0,1,30,1,0
49291,53,26536,53,allow,277,110,167,2,30,1,1
65460,53,1825,53,allow,177,94,83,2,30,1,1
44443,80,37663,80,allow,1114,534,580,12,16,7,5
49395,53,16625,53,allow,315,90,225,4,32,2,2
49629,53,59085,53,allow,216,102,114,2,30,1,1
52385,53,0,0,allow,139,70,69,2,30,1,1
56417,53,7039,53,allow,389,126,263,2,30,1,1
65384,53,41711,53,allow,197,102,95,2,30,1,1
65276,53,64809,53,allow,195,86,109,2,30,1,1
37581,53,0,0,allow,86,86,0,1,30,1,0
50958,53,61318,53,allow,94,94,0,1,30,1,0
49835,53,4123,53,allow,250,86,164,4,30,2,2
50011,53,36525,53,allow,94,94,0,1,30,1,0
64477,53,1968,53,allow,272,94,178,2,30,1,1
62597,53,18771,53,allow,102,102,0,1,30,1,0
53482,53,51944,53,allow,168,78,90,2,30,1,1
57839,53,54040,53,allow,78,78,0,1,30,1,0
49844,53,62050,53,allow,368,118,250,2,30,1,1
64954,53,8799,53,allow,94,94,0,1,30,1,0
65136,53,1364,53,allow,86,86,0,1,30,1,0
64240,53,21453,53,allow,256,110,146,2,30,1,1
64122,53,64122,53,allow,220,90,130,2,30,1,1
49835,53,23738,53,allow,168,86,82,2,30,1,1
65515,53,35838,53,allow,718,94,624,2,30,1,1
64803,53,39873,53,allow,102,102,0,1,30,1,0
55721,53,4903,53,allow,212,94,118,2,30,1,1
50438,53,8831,53,allow,199,102,97,2,29,1,1
64884,53,48287,53,allow,239,110,129,2,30,1,1
65460,53,48122,53,allow,177,94,83,2,30,1,1
56568,53,34489,53,allow,102,102,0,1,30,1,0
64146,53,33411,53,allow,273,94,179,2,30,1,1
61580,53,48820,53,allow,275,94,181,2,29,1,1
50438,53,42985,53,allow,199,102,97,2,29,1,1
55209,53,7531,53,allow,196,102,94,2,33,1,1
49855,53,19600,53,allow,916,86,830,2,30,1,1
49706,53,34348,53,allow,258,110,148,2,30,1,1
57398,53,44535,53,allow,202,86,116,2,30,1,1
58472,53,5380,53,allow,86,86,0,1,30,1,0
56463,53,28170,53,allow,368,118,250,2,30,1,1
53986,53,15974,53,allow,102,102,0,1,30,1,0
65349,53,10010,53,allow,275,110,165,2,30,1,1
53707,443,35476,443,allow,350,210,140,6,25,4,2
65384,53,35279,53,allow,197,102,95,2,33,1,1
49835,53,35014,53,allow,168,86,82,2,30,1,1
49501,53,50538,53,allow,229,110,119,2,30,1,1
56192,53,60489,53,allow,177,94,83,2,31,1,1
60546,53,37684,53,allow,199,94,105,2,30,1,1
56448,53,42442,53,allow,177,94,83,2,30,1,1
55056,53,32343,53,allow,177,94,83,2,31,1,1
64380,53,9655,53,allow,196,102,94,2,33,1,1
53580,445,0,0,drop,66,66,0,1,0,1,0
53188,445,0,0,drop,70,70,0,1,0,1,0
53577,445,0,0,drop,66,66,0,1,0,1,0
58162,445,0,0,drop,70,70,0,1,0,1,0
58154,445,0,0,drop,70,70,0,1,0,1,0
58152,445,0,0,drop,70,70,0,1,0,1,0
58153,445,0,0,drop,70,70,0,1,0,1,0
53575,445,0,0,drop,66,66,0,1,0,1,0
53178,445,0,0,drop,70,70,0,1,0,1,0
53173,445,0,0,drop,70,70,0,1,0,1,0
53171,445,0,0,drop,70,70,0,1,0,1,0
58149,445,0,0,drop,70,70,0,1,0,1,0
58145,445,0,0,drop,70,70,0,1,0,1,0
58143,445,0,0,drop,70,70,0,1,0,1,0
58142,445,0,0,drop,70,70,0,1,0,1,0
53568,445,0,0,drop,66,66,0,1,0,1,0
53565,445,0,0,drop,66,66,0,1,0,1,0
53560,445,0,0,drop,66,66,0,1,0,1,0
53559,445,0,0,drop,66,66,0,1,0,1,0
53558,445,0,0,drop,66,66,0,1,0,1,0
53555,445,0,0,drop,66,66,0,1,0,1,0
53557,445,0,0,drop,66,66,0,1,0,1,0
58137,445,0,0,drop,70,70,0,1,0,1,0
58139,445,0,0,drop,70,70,0,1,0,1,0
58134,445,0,0,drop,70,70,0,1,0,1,0
53551,445,0,0,drop,66,66,0,1,0,1,0
58132,445,0,0,drop,70,70,0,1,0,1,0
53156,445,0,0,drop,70,70,0,1,0,1,0
53550,445,0,0,drop,66,66,0,1,0,1,0
53548,445,0,0,drop,66,66,0,1,0,1,0
53547,445,0,0,drop,66,66,0,1,0,1,0
53545,445,0,0,drop,66,66,0,1,0,1,0
53150,445,0,0,drop,70,70,0,1,0,1,0
53149,445,0,0,drop,70,70,0,1,0,1,0
58125,445,0,0,drop,70,70,0,1,0,1,0
58116,445,0,0,drop,70,70,0,1,0,1,0
53145,445,0,0,drop,70,70,0,1,0,1,0
53536,445,0,0,drop,66,66,0,1,0,1,0
53526,445,0,0,drop,66,66,0,1,0,1,0
53139,445,0,0,drop,70,70,0,1,0,1,0
58108,445,0,0,drop,70,70,0,1,0,1,0
53523,445,0,0,drop,66,66,0,1,0,1,0
53517,445,0,0,drop,66,66,0,1,0,1,0
53506,445,0,0,drop,66,66,0,1,0,1,0
53126,445,0,0,drop,70,70,0,1,0,1,0
58095,445,0,0,drop,70,70,0,1,0,1,0
58092,445,0,0,drop,70,70,0,1,0,1,0
58093,445,0,0,drop,70,70,0,1,0,1,0
53494,445,0,0,drop,66,66,0,1,0,1,0
53496,445,0,0,drop,66,66,0,1,0,1,0
53499,445,0,0,drop,66,66,0,1,0,1,0
53501,445,0,0,drop,66,66,0,1,0,1,0
53497,445,0,0,drop,66,66,0,1,0,1,0
53498,445,0,0,drop,66,66,0,1,0,1,0
53500,445,0,0,drop,66,66,0,1,0,1,0
53495,445,0,0,drop,66,66,0,1,0,1,0
53118,445,0,0,drop,70,70,0,1,0,1,0
53115,445,0,0,drop,70,70,0,1,0,1,0
58082,445,0,0,drop,70,70,0,1,0,1,0
53481,445,0,0,drop,66,66,0,1,0,1,0
53480,445,0,0,drop,66,66,0,1,0,1,0
53479,445,0,0,drop,66,66,0,1,0,1,0
58074,445,0,0,drop,70,70,0,1,0,1,0
53108,445,0,0,drop,70,70,0,1,0,1,0
58072,445,0,0,drop,70,70,0,1,0,1,0
58064,445,0,0,drop,70,70,0,1,0,1,0
58063,445,0,0,drop,70,70,0,1,0,1,0
58060,445,0,0,drop,70,70,0,1,0,1,0
56192,53,2949,53,allow,170,87,83,2,30,1,1
55056,53,8605,53,allow,170,87,83,2,30,1,1
41328,53,51462,53,allow,198,93,105,2,30,1,1
57205,53,27220,53,allow,711,87,624,2,30,1,1
41520,53,0,0,allow,82,82,0,1,30,1,0
37961,443,21395,443,allow,153,93,60,2,5,1,1
64380,53,44055,53,allow,98,98,0,1,30,1,0
58970,80,38149,80,allow,1521,967,554,10,75,6,4
54823,53,13813,53,allow,198,93,105,2,30,1,1
57162,53,0,0,allow,198,91,107,2,30,1,1
39328,80,62636,80,allow,234,234,0,4,12,4,0
53085,53,0,0,allow,82,82,0,1,30,1,0
37233,53,50033,53,allow,198,93,105,2,30,1,1
53597,53,0,0,allow,233,85,148,2,30,1,1
56750,53,56750,53,allow,217,87,130,2,30,1,1
53105,445,0,0,drop,70,70,0,1,0,1,0
53103,445,0,0,drop,70,70,0,1,0,1,0
53097,445,0,0,drop,70,70,0,1,0,1,0
53100,445,0,0,drop,70,70,0,1,0,1,0
42783,53,31772,53,allow,199,94,105,2,30,1,1
39834,53,46672,53,allow,199,94,105,2,30,1,1
41295,443,9928,443,allow,1482,988,494,12,26,7,5
53080,445,0,0,drop,70,70,0,1,0,1,0
53075,445,0,0,drop,70,70,0,1,0,1,0
58053,445,0,0,drop,70,70,0,1,0,1,0
58049,445,0,0,drop,70,70,0,1,0,1,0
53063,445,0,0,drop,70,70,0,1,0,1,0
53454,445,0,0,drop,66,66,0,1,0,1,0
37646,53,37646,53,allow,832,106,726,2,30,1,1
65118,53,14399,53,allow,539,91,448,4,43,2,2
63971,53,59567,53,allow,358,94,264,4,45,2,2
55889,53,31264,53,allow,177,94,83,2,29,1,1
56448,53,60650,53,allow,177,94,83,2,29,1,1
64540,53,44077,53,allow,352,107,245,4,37,2,2
56799,1,48991,1,allow,316,136,180,6,6,3,3
64407,53,18646,53,allow,232,110,122,2,29,1,1
65111,53,60409,53,allow,198,94,104,2,29,1,1
49360,53,44969,53,allow,263,102,161,2,29,1,1
49818,53,22415,53,allow,211,102,109,2,29,1,1
65064,53,64961,53,allow,197,94,103,2,30,1,1
64365,53,32131,53,allow,234,94,140,2,30,1,1
50648,80,8370,80,allow,62,62,0,1,5,1,0
55056,53,24229,53,allow,177,94,83,2,30,1,1
44498,53,11053,53,allow,168,78,90,2,30,1,1
63966,53,6914,53,allow,214,102,112,2,30,1,1
48165,53,17622,53,allow,199,94,105,2,30,1,1
50838,53,8440,53,allow,70,70,0,1,30,1,0
56266,53,6584,53,allow,245,102,143,2,30,1,1
59756,53,24009,53,allow,211,78,133,2,29,1,1
56970,80,14502,80,allow,1783,841,942,10,20,6,4
64481,53,22915,53,allow,386,106,280,4,51,2,2
55889,53,19175,53,allow,177,94,83,2,29,1,1
44389,53,44389,53,allow,235,90,145,2,32,1,1
56745,53,50042,53,allow,900,110,790,2,30,1,1
60469,53,22418,53,allow,78,78,0,1,30,1,0
51217,443,21771,443,allow,126,60,66,3,5,2,1
46262,123,34977,123,allow,184,94,90,2,30,1,1
49986,53,35150,53,allow,209,94,115,2,30,1,1
49798,53,59765,53,allow,365,97,268,4,40,2,2
42917,53,23421,53,allow,168,78,90,2,30,1,1
41476,53,41476,53,allow,235,90,145,2,33,1,1
56617,80,63909,80,allow,234,234,0,4,12,4,0
64415,53,14789,53,allow,228,102,126,2,30,1,1
56192,53,54480,53,allow,177,94,83,2,30,1,1
64678,53,21797,53,allow,229,110,119,2,30,1,1
56192,53,12282,53,allow,282,87,195,4,45,2,2
56140,53,23511,53,allow,195,86,109,2,30,1,1
64973,53,36407,53,allow,257,102,155,2,30,1,1
57096,53,51826,53,allow,177,94,83,2,30,1,1
49743,53,12081,53,allow,636,202,434,6,47,3,3
65511,53,22579,53,allow,545,136,409,4,56,2,2
56363,53,52930,53,allow,212,102,110,2,30,1,1
58043,445,0,0,drop,70,70,0,1,0,1,0
58787,23,0,0,deny,60,60,0,1,0,1,0
53059,445,0,0,drop,70,70,0,1,0,1,0
53449,445,0,0,drop,66,66,0,1,0,1,0
53448,445,0,0,drop,66,66,0,1,0,1,0
58036,445,0,0,drop,70,70,0,1,0,1,0
53049,445,0,0,drop,70,70,0,1,0,1,0
53050,445,0,0,drop,70,70,0,1,0,1,0
53044,445,0,0,drop,70,70,0,1,0,1,0
53045,445,0,0,drop,70,70,0,1,0,1,0
58030,445,0,0,drop,70,70,0,1,0,1,0
58027,445,0,0,drop,70,70,0,1,0,1,0
53043,445,0,0,drop,70,70,0,1,0,1,0
53447,445,0,0,drop,66,66,0,1,0,1,0
58020,445,0,0,drop,70,70,0,1,0,1,0
58017,445,0,0,drop,70,70,0,1,0,1,0
58015,445,0,0,drop,70,70,0,1,0,1,0
58013,445,0,0,drop,70,70,0,1,0,1,0
53439,445,0,0,drop,66,66,0,1,0,1,0
53037,445,0,0,drop,70,70,0,1,0,1,0
53433,445,0,0,drop,66,66,0,1,0,1,0
53432,445,0,0,drop,66,66,0,1,0,1,0
53431,445,0,0,drop,66,66,0,1,0,1,0
53427,445,0,0,drop,66,66,0,1,0,1,0
53428,445,0,0,drop,66,66,0,1,0,1,0
53429,445,0,0,drop,66,66,0,1,0,1,0
53029,445,0,0,drop,70,70,0,1,0,1,0
36930,22,36930,22,deny,293,126,167,4,0,2,2
53027,445,0,0,drop,70,70,0,1,0,1,0
58011,445,0,0,drop,70,70,0,1,0,1,0
58008,445,0,0,drop,70,70,0,1,0,1,0
53425,445,0,0,drop,66,66,0,1,0,1,0
58004,445,0,0,drop,70,70,0,1,0,1,0
53421,445,0,0,drop,66,66,0,1,0,1,0
53418,445,0,0,drop,66,66,0,1,0,1,0
53419,445,0,0,drop,66,66,0,1,0,1,0
53023,445,0,0,drop,70,70,0,1,0,1,0
53415,445,0,0,drop,66,66,0,1,0,1,0
53017,445,0,0,drop,70,70,0,1,0,1,0
57996,445,0,0,drop,70,70,0,1,0,1,0
57995,445,0,0,drop,70,70,0,1,0,1,0
53016,445,0,0,drop,70,70,0,1,0,1,0
53405,445,0,0,drop,66,66,0,1,0,1,0
53011,445,0,0,drop,70,70,0,1,0,1,0
53397,445,0,0,drop,66,66,0,1,0,1,0
53395,445,0,0,drop,66,66,0,1,0,1,0
53388,445,0,0,drop,66,66,0,1,0,1,0
52998,445,0,0,drop,70,70,0,1,0,1,0
53377,445,0,0,drop,66,66,0,1,0,1,0
52995,445,0,0,drop,70,70,0,1,0,1,0
57965,445,0,0,drop,70,70,0,1,0,1,0
53371,445,0,0,drop,66,66,0,1,0,1,0
53372,445,0,0,drop,66,66,0,1,0,1,0
53370,445,0,0,drop,66,66,0,1,0,1,0
53369,445,0,0,drop,66,66,0,1,0,1,0
53368,445,0,0,drop,66,66,0,1,0,1,0
53367,445,0,0,drop,66,66,0,1,0,1,0
53366,445,0,0,drop,66,66,0,1,0,1,0
53365,445,0,0,drop,66,66,0,1,0,1,0
52987,445,0,0,drop,70,70,0,1,0,1,0
53009,80,53009,80,allow,378,180,198,7,17,4,3
57140,53,16030,53,allow,170,87,83,2,30,1,1
55584,53,31260,53,allow,184,80,104,2,30,1,1
37444,53,37444,53,allow,213,79,134,2,32,1,1
60017,443,51690,443,allow,134,60,74,3,10,2,1
58259,53,21594,53,allow,578,286,292,9,15,5,4
55786,53,21732,53,allow,170,87,83,2,30,1,1
39611,443,2531,443,allow,78,78,0,1,5,1,0
56360,53,64885,53,allow,711,87,624,2,30,1,1
55800,53,53999,53,allow,711,87,624,2,30,1,1
63793,53,63793,53,allow,237,91,146,2,33,1,1
58994,443,24369,443,allow,204,70,134,4,25,2,2
41335,53,41335,53,allow,825,99,726,2,30,1,1
48720,53,0,0,allow,82,82,0,1,30,1,0
56472,53,0,0,allow,371,77,294,2,30,1,1
36986,53,36986,53,allow,234,93,141,2,31,1,1
55542,53,5269,53,allow,711,87,624,2,31,1,1
52151,53,52151,53,allow,198,89,109,2,31,1,1
52677,53,52677,53,allow,233,91,142,2,31,1,1
56282,53,56282,53,allow,194,87,107,2,31,1,1
55128,53,34503,53,allow,711,87,624,2,31,1,1
50038,53,0,0,allow,275,85,190,2,31,1,1
47063,53,47063,53,allow,221,89,132,2,31,1,1
58178,53,58178,53,allow,237,93,144,2,31,1,1
63755,53,63755,53,allow,223,92,131,2,31,1,1
59267,53,59267,53,allow,222,87,135,2,31,1,1
55072,53,31850,53,allow,168,86,82,2,31,1,1
57963,445,0,0,drop,70,70,0,1,0,1,0
57961,445,0,0,drop,70,70,0,1,0,1,0
53352,445,0,0,drop,66,66,0,1,0,1,0
53351,445,0,0,drop,66,66,0,1,0,1,0
53349,445,0,0,drop,66,66,0,1,0,1,0
52980,445,0,0,drop,70,70,0,1,0,1,0
57946,445,0,0,drop,70,70,0,1,0,1,0
55786,53,23026,53,allow,177,94,83,2,30,1,1
59984,443,19518,443,allow,1527,940,587,14,21,8,6
59982,443,1995,443,allow,1467,880,587,13,21,7,6
57944,445,0,0,drop,70,70,0,1,0,1,0
52975,445,0,0,drop,70,70,0,1,0,1,0
57943,445,0,0,drop,70,70,0,1,0,1,0
57934,445,0,0,drop,70,70,0,1,0,1,0
57936,445,0,0,drop,70,70,0,1,0,1,0
52971,445,0,0,drop,70,70,0,1,0,1,0
52970,445,0,0,drop,70,70,0,1,0,1,0
52957,445,0,0,drop,70,70,0,1,0,1,0
52956,445,0,0,drop,70,70,0,1,0,1,0
52953,445,0,0,drop,70,70,0,1,0,1,0
52945,445,0,0,drop,70,70,0,1,0,1,0
55056,53,38233,53,allow,177,94,83,2,29,1,1
49940,53,29743,53,allow,197,94,103,2,29,1,1
56646,53,30377,53,allow,177,94,83,2,30,1,1
55462,53,41879,53,allow,194,102,92,2,33,1,1
55417,53,62498,53,allow,198,102,96,2,32,1,1
56646,53,16936,53,allow,177,94,83,2,29,1,1
49752,53,64105,53,allow,193,102,91,2,30,1,1
52407,443,29892,443,allow,1043,556,487,10,16,6,4
55041,53,58764,53,allow,234,94,140,2,30,1,1
57140,53,49557,53,allow,177,94,83,2,30,1,1
50151,53,24855,53,allow,177,94,83,2,30,1,1
52408,443,37575,443,allow,1043,556,487,10,16,6,4
56569,53,52915,53,allow,94,94,0,1,30,1,0
64537,53,63183,53,allow,718,94,624,2,30,1,1
55836,53,41454,53,allow,181,94,87,2,33,1,1
49374,53,26610,53,allow,307,102,205,4,35,2,2
64779,53,46294,53,allow,497,102,395,4,40,2,2
64636,53,42647,53,allow,727,223,504,6,70,3,3
49284,53,32626,53,allow,245,102,143,2,29,1,1
57096,53,50734,53,allow,177,94,83,2,29,1,1
49844,53,30878,53,allow,755,102,653,2,30,1,1
55777,53,11730,53,allow,200,94,106,2,30,1,1
55699,53,21219,53,allow,211,102,109,2,29,1,1
49203,53,26385,53,allow,240,94,146,2,29,1,1
55669,53,15322,53,allow,94,94,0,1,29,1,0
55786,53,33325,53,allow,177,94,83,2,30,1,1
57397,53,56026,53,allow,177,94,83,2,31,1,1
65269,53,55640,53,allow,273,134,139,2,30,1,1
65291,53,62097,53,allow,247,118,129,2,30,1,1
49234,53,59585,53,allow,177,94,83,2,30,1,1
57004,53,12740,53,allow,195,78,117,2,30,1,1
56551,53,25599,53,allow,225,102,123,2,30,1,1
63967,53,22995,53,allow,195,102,93,2,33,1,1
57140,53,49322,53,allow,177,94,83,2,30,1,1
63972,53,28656,53,allow,325,94,231,2,30,1,1
50151,53,38506,53,allow,177,94,83,2,30,1,1
57397,53,60967,53,allow,177,94,83,2,30,1,1
55539,53,25818,53,allow,249,94,155,2,31,1,1
49919,53,2531,53,allow,225,102,123,2,30,1,1
49672,53,36807,53,allow,718,94,624,2,30,1,1
49509,53,2190,53,allow,339,110,229,2,30,1,1
49757,53,31813,53,allow,177,94,83,2,31,1,1
58969,80,39801,80,allow,1431,783,648,10,75,6,4
41210,443,59857,443,allow,78,78,0,1,5,1,0
55113,53,62810,53,allow,198,102,96,2,33,1,1
49665,53,6360,53,allow,779,298,481,8,67,4,4
57921,445,0,0,drop,70,70,0,1,0,1,0
41482,23,0,0,deny,60,60,0,1,0,1,0
52934,445,0,0,drop,70,70,0,1,0,1,0
53328,445,0,0,drop,66,66,0,1,0,1,0
57915,445,0,0,drop,70,70,0,1,0,1,0
62827,1,0,0,deny,66,66,0,1,0,1,0
52930,445,0,0,drop,70,70,0,1,0,1,0
53321,445,0,0,drop,66,66,0,1,0,1,0
52921,445,0,0,drop,70,70,0,1,0,1,0
52919,445,0,0,drop,70,70,0,1,0,1,0
37903,23,0,0,deny,60,60,0,1,0,1,0
52917,445,0,0,drop,70,70,0,1,0,1,0
53320,445,0,0,drop,66,66,0,1,0,1,0
57904,445,0,0,drop,70,70,0,1,0,1,0
52914,445,0,0,drop,70,70,0,1,0,1,0
57901,445,0,0,drop,70,70,0,1,0,1,0
57897,445,0,0,drop,70,70,0,1,0,1,0
53317,445,0,0,drop,66,66,0,1,0,1,0
54214,443,38557,443,allow,499,425,74,4,0,3,1
54215,443,45620,443,allow,499,425,74,4,0,3,1
53817,443,41947,443,allow,499,425,74,4,0,3,1
53816,443,52923,443,allow,499,425,74,4,0,3,1
57892,445,0,0,drop,70,70,0,1,0,1,0
57889,445,0,0,drop,70,70,0,1,0,1,0
57888,445,0,0,drop,70,70,0,1,0,1,0
57885,445,0,0,drop,70,70,0,1,0,1,0
53309,445,0,0,drop,66,66,0,1,0,1,0
53308,445,0,0,drop,66,66,0,1,0,1,0
53304,445,0,0,drop,66,66,0,1,0,1,0
53302,445,0,0,drop,66,66,0,1,0,1,0
53300,445,0,0,drop,66,66,0,1,0,1,0
53301,445,0,0,drop,66,66,0,1,0,1,0
53298,445,0,0,drop,66,66,0,1,0,1,0
52900,445,0,0,drop,70,70,0,1,0,1,0
52898,445,0,0,drop,70,70,0,1,0,1,0
57884,445,0,0,drop,70,70,0,1,0,1,0
57882,445,0,0,drop,70,70,0,1,0,1,0
57878,445,0,0,drop,70,70,0,1,0,1,0
53294,445,0,0,drop,66,66,0,1,0,1,0
52893,445,0,0,drop,70,70,0,1,0,1,0
53293,445,0,0,drop,66,66,0,1,0,1,0
52892,445,0,0,drop,70,70,0,1,0,1,0
53290,445,0,0,drop,66,66,0,1,0,1,0
53289,445,0,0,drop,66,66,0,1,0,1,0
53287,445,0,0,drop,66,66,0,1,0,1,0
52888,445,0,0,drop,70,70,0,1,0,1,0
57870,445,0,0,drop,70,70,0,1,0,1,0
52887,445,0,0,drop,70,70,0,1,0,1,0
57864,445,0,0,drop,70,70,0,1,0,1,0
53278,445,0,0,drop,66,66,0,1,0,1,0
52882,445,0,0,drop,70,70,0,1,0,1,0
53269,445,0,0,drop,66,66,0,1,0,1,0
57850,445,0,0,drop,70,70,0,1,0,1,0
53267,445,0,0,drop,66,66,0,1,0,1,0
53258,445,0,0,drop,66,66,0,1,0,1,0
53252,445,0,0,drop,66,66,0,1,0,1,0
56887,53,15975,53,allow,170,87,83,3,56,2,1
50693,443,1637,443,allow,306,120,186,6,23,3,3
36445,443,44215,443,allow,234,234,0,4,12,4,0
49913,443,65032,443,allow,976,589,387,10,76,6,4
55521,53,35090,53,allow,701,88,613,2,30,1,1
49234,53,38404,53,allow,170,87,83,2,30,1,1
36661,53,36661,53,allow,237,93,144,2,30,1,1
56997,53,44658,53,allow,168,86,82,2,30,1,1
64539,53,5433,53,allow,170,87,83,2,31,1,1
44546,53,44546,53,allow,204,92,112,2,30,1,1
63513,53,63513,53,allow,236,94,142,2,30,1,1
51202,53,51202,53,allow,221,89,132,2,30,1,1
39119,53,39119,53,allow,221,89,132,2,30,1,1
50107,53,50107,53,allow,216,89,127,2,30,1,1
56876,53,55574,53,allow,711,87,624,2,31,1,1
52862,445,0,0,drop,70,70,0,1,0,1,0
57837,445,0,0,drop,70,70,0,1,0,1,0
57836,445,0,0,drop,70,70,0,1,0,1,0
52860,445,0,0,drop,70,70,0,1,0,1,0
53239,445,0,0,drop,66,66,0,1,0,1,0
53241,445,0,0,drop,66,66,0,1,0,1,0
53240,445,0,0,drop,66,66,0,1,0,1,0
53244,445,0,0,drop,66,66,0,1,0,1,0
53243,445,0,0,drop,66,66,0,1,0,1,0
53238,445,0,0,drop,66,66,0,1,0,1,0
53237,445,0,0,drop,66,66,0,1,0,1,0
53236,445,0,0,drop,66,66,0,1,0,1,0
52858,445,0,0,drop,70,70,0,1,0,1,0
57827,445,0,0,drop,70,70,0,1,0,1,0
57825,445,0,0,drop,70,70,0,1,0,1,0
53223,445,0,0,drop,66,66,0,1,0,1,0
53224,445,0,0,drop,66,66,0,1,0,1,0
53221,445,0,0,drop,66,66,0,1,0,1,0
52848,445,0,0,drop,70,70,0,1,0,1,0
52847,445,0,0,drop,70,70,0,1,0,1,0
52846,445,0,0,drop,70,70,0,1,0,1,0
52843,445,0,0,drop,70,70,0,1,0,1,0
52842,445,0,0,drop,70,70,0,1,0,1,0
57816,445,0,0,drop,70,70,0,1,0,1,0
57810,445,0,0,drop,70,70,0,1,0,1,0
57808,445,0,0,drop,70,70,0,1,0,1,0
57804,445,0,0,drop,70,70,0,1,0,1,0
52828,445,0,0,drop,70,70,0,1,0,1,0
52817,445,0,0,drop,70,70,0,1,0,1,0
59754,53,11671,53,allow,260,86,174,2,30,1,1
56813,53,9920,53,allow,516,136,380,4,40,2,2
50692,443,32817,443,allow,180,60,120,4,15,2,2
65080,53,49569,53,allow,193,102,91,2,29,1,1
49281,53,58920,53,allow,345,110,235,2,29,1,1
50689,443,64099,443,allow,180,60,120,4,15,2,2
45935,25,35960,25,allow,511,191,320,9,60,4,5
57140,53,58402,53,allow,177,94,83,2,29,1,1
49632,53,31125,53,allow,288,94,194,2,30,1,1
55653,53,52726,53,allow,94,94,0,1,29,1,0
64212,53,41326,53,allow,215,102,113,2,30,1,1
49234,53,14008,53,allow,177,94,83,2,30,1,1
59755,53,7532,53,allow,211,78,133,2,30,1,1
49752,53,10768,53,allow,193,102,91,2,29,1,1
38194,53,38194,53,allow,210,98,112,2,29,1,1
65384,53,46519,53,allow,197,102,95,2,33,1,1
65378,53,49018,53,allow,212,102,110,2,30,1,1
56972,53,28054,53,allow,177,94,83,2,30,1,1
51004,53,15547,53,allow,194,94,100,2,30,1,1
65135,53,23354,53,allow,312,102,210,2,30,1,1
36225,443,18751,443,allow,638,350,288,10,26,6,4
56616,80,15252,80,allow,234,234,0,4,12,4,0
60196,80,43098,80,allow,70,70,0,2,8,2,0
65452,53,31972,53,allow,365,102,263,2,30,1,1
56972,53,24503,53,allow,177,94,83,2,30,1,1
57272,53,3406,53,allow,373,107,266,4,45,2,2
56997,53,62280,53,allow,86,86,0,1,30,1,0
54167,53,54167,53,allow,242,98,144,2,30,1,1
49891,53,6545,53,allow,375,126,249,2,30,1,1
55072,53,38583,53,allow,86,86,0,1,30,1,0
49757,53,9163,53,allow,177,94,83,2,30,1,1
49234,53,56023,53,allow,177,94,83,2,30,1,1
49647,53,18676,53,allow,361,102,259,2,30,1,1
56227,53,50602,53,allow,278,102,176,2,30,1,1
56887,53,8046,53,allow,250,87,163,4,57,2,2
49211,53,35833,53,allow,484,100,384,4,56,2,2
57425,443,33540,443,allow,130,70,60,2,15,1,1
64448,53,46885,53,allow,353,92,261,4,38,2,2
52881,443,3297,443,allow,130,70,60,2,15,1,1
55462,53,36387,53,allow,579,88,491,4,35,2,2
49650,53,14821,53,allow,821,102,719,2,29,1,1
55786,53,63117,53,allow,177,94,83,2,29,1,1
65080,53,41733,53,allow,193,102,91,2,29,1,1
64374,53,64374,53,allow,240,98,142,2,30,1,1
64204,53,27061,53,allow,264,102,162,2,31,1,1
54262,53,54262,53,allow,216,82,134,2,33,1,1
40340,53,40340,53,allow,217,90,127,2,30,1,1
56887,53,51812,53,allow,177,94,83,2,30,1,1
55072,53,58133,53,allow,168,86,82,2,30,1,1
51687,80,38806,80,allow,1517,481,1036,11,15,6,5
65195,53,58646,53,allow,249,94,155,2,30,1,1
56794,1,30345,1,allow,70,70,0,1,5,1,0
49907,53,31143,53,allow,363,98,265,4,54,2,2
56880,53,14600,53,allow,216,102,114,2,30,1,1
49626,53,57027,53,allow,226,110,116,2,30,1,1
65489,53,22228,53,allow,242,102,140,2,30,1,1
45852,53,58364,53,allow,164,78,86,2,30,1,1
64539,53,12093,53,allow,177,94,83,2,30,1,1
55232,53,4973,53,allow,177,94,83,2,30,1,1
49901,53,27916,53,allow,349,108,241,4,35,2,2
40729,123,44305,123,allow,184,94,90,2,30,1,1
57794,445,0,0,drop,70,70,0,1,0,1,0
53201,445,0,0,drop,66,66,0,1,0,1,0
57791,445,0,0,drop,70,70,0,1,0,1,0
57788,445,0,0,drop,70,70,0,1,0,1,0
52802,445,0,0,drop,70,70,0,1,0,1,0
52793,445,0,0,drop,70,70,0,1,0,1,0
52792,445,0,0,drop,70,70,0,1,0,1,0
53815,443,57260,443,allow,499,425,74,4,0,3,1
53799,443,27170,443,allow,499,425,74,4,0,3,1
53814,443,6695,443,allow,499,425,74,4,0,3,1
52789,445,0,0,drop,70,70,0,1,0,1,0
53196,445,0,0,drop,66,66,0,1,0,1,0
52785,445,0,0,drop,70,70,0,1,0,1,0
53192,445,0,0,drop,66,66,0,1,0,1,0
57776,445,0,0,drop,70,70,0,1,0,1,0
57774,445,0,0,drop,70,70,0,1,0,1,0
57772,445,0,0,drop,70,70,0,1,0,1,0
57767,445,0,0,drop,70,70,0,1,0,1,0
53189,445,0,0,drop,66,66,0,1,0,1,0
57763,445,0,0,drop,70,70,0,1,0,1,0
57761,445,0,0,drop,70,70,0,1,0,1,0
57758,445,0,0,drop,70,70,0,1,0,1,0
57757,445,0,0,drop,70,70,0,1,0,1,0
53183,445,0,0,drop,66,66,0,1,0,1,0
53176,445,0,0,drop,66,66,0,1,0,1,0
53179,445,0,0,drop,66,66,0,1,0,1,0
53175,445,0,0,drop,66,66,0,1,0,1,0
53173,445,0,0,drop,66,66,0,1,0,1,0
53172,445,0,0,drop,66,66,0,1,0,1,0
53171,445,0,0,drop,66,66,0,1,0,1,0
52769,445,0,0,drop,70,70,0,1,0,1,0
57755,445,0,0,drop,70,70,0,1,0,1,0
57753,445,0,0,drop,70,70,0,1,0,1,0
52765,445,0,0,drop,70,70,0,1,0,1,0
53169,445,0,0,drop,66,66,0,1,0,1,0
52764,445,0,0,drop,70,70,0,1,0,1,0
57748,445,0,0,drop,70,70,0,1,0,1,0
53807,443,54173,443,allow,499,425,74,4,0,3,1
53796,443,58960,443,allow,499,425,74,4,0,3,1
53804,443,53478,443,allow,499,425,74,4,0,3,1
53802,443,44070,443,allow,499,425,74,4,0,3,1
53812,443,19260,443,allow,499,425,74,4,0,3,1
53805,443,64828,443,allow,499,425,74,4,0,3,1
53801,443,63448,443,allow,499,425,74,4,0,3,1
53810,443,43179,443,allow,499,425,74,4,0,3,1
53813,443,59809,443,allow,499,425,74,4,0,3,1
53806,443,13248,443,allow,499,425,74,4,0,3,1
53809,443,5069,443,allow,499,425,74,4,0,3,1
53798,443,32162,443,allow,499,425,74,4,0,3,1
53811,443,28685,443,allow,499,425,74,4,0,3,1
53800,443,21628,443,allow,499,425,74,4,0,3,1
53797,443,48154,443,allow,499,425,74,4,0,3,1
53808,443,30751,443,allow,499,425,74,4,0,3,1
53795,443,29582,443,allow,499,425,74,4,0,3,1
53791,443,9232,443,allow,499,425,74,4,0,3,1
53803,443,59546,443,allow,499,425,74,4,0,3,1
53794,443,48669,443,allow,499,425,74,4,0,3,1
53793,443,25367,443,allow,499,425,74,4,0,3,1
53790,443,36167,443,allow,499,425,74,4,0,3,1
53789,443,10563,443,allow,499,425,74,4,0,3,1
53792,443,8707,443,allow,499,425,74,4,0,3,1
53164,445,0,0,drop,66,66,0,1,0,1,0
53163,445,0,0,drop,66,66,0,1,0,1,0
53161,445,0,0,drop,66,66,0,1,0,1,0
53159,445,0,0,drop,66,66,0,1,0,1,0
52760,445,0,0,drop,70,70,0,1,0,1,0
52758,445,0,0,drop,70,70,0,1,0,1,0
52754,445,0,0,drop,70,70,0,1,0,1,0
53151,445,0,0,drop,66,66,0,1,0,1,0
53141,445,0,0,drop,66,66,0,1,0,1,0
57720,445,0,0,drop,70,70,0,1,0,1,0
55232,53,45264,53,allow,170,87,83,2,30,1,1
50122,443,28442,443,allow,130,70,60,2,15,1,1
44695,53,44695,53,allow,198,89,109,2,30,1,1
64979,53,23009,53,allow,188,96,92,2,31,1,1
55917,53,56529,53,allow,170,87,83,2,31,1,1
59343,53,0,0,allow,627,72,555,2,30,1,1
52375,80,50220,80,allow,234,234,0,4,12,4,0
38329,80,52994,80,allow,350,210,140,6,16,4,2
59270,53,59270,53,allow,825,99,726,2,30,1,1
56813,53,39428,53,allow,711,87,624,2,30,1,1
55106,53,55106,53,allow,200,90,110,2,30,1,1
56366,53,46809,53,allow,754,94,660,2,31,1,1
59487,80,24242,80,allow,350,210,140,6,26,4,2
57312,53,57312,53,allow,208,94,114,2,30,1,1
49591,53,51142,53,allow,168,86,82,2,30,1,1
56775,53,34626,53,allow,763,101,662,2,30,1,1
50328,53,20316,53,allow,783,96,687,2,30,1,1
56268,53,11800,53,allow,711,87,624,2,31,1,1
49353,53,30816,53,allow,738,86,652,2,31,1,1
49597,53,33201,53,allow,168,86,82,2,31,1,1
55836,53,32275,53,allow,178,91,87,2,31,1,1
65366,53,60695,53,allow,198,101,97,2,31,1,1
55040,53,40859,53,allow,762,98,664,2,31,1,1
56620,53,33976,53,allow,216,110,106,2,31,1,1
49883,53,18157,53,allow,170,87,83,2,30,1,1
55011,53,15618,53,allow,760,96,664,2,31,1,1
56373,53,29361,53,allow,200,102,98,2,31,1,1
65153,53,43651,53,allow,168,86,82,2,31,1,1
65177,53,32886,53,allow,256,93,163,2,31,1,1
56091,53,32743,53,allow,738,86,652,2,31,1,1
50475,53,26369,53,allow,772,100,672,2,31,1,1
55698,53,13157,53,allow,742,88,654,2,31,1,1
55656,53,48878,53,allow,212,108,104,2,31,1,1
57397,53,42342,53,allow,256,93,163,2,31,1,1
64980,53,5647,53,allow,200,102,98,2,31,1,1
53139,445,0,0,drop,66,66,0,1,0,1,0
52741,445,0,0,drop,70,70,0,1,0,1,0
64841,53,24677,53,allow,165,86,79,2,30,1,1
55386,53,14835,53,allow,199,102,97,2,30,1,1
52738,445,0,0,drop,70,70,0,1,0,1,0
53132,445,0,0,drop,66,66,0,1,0,1,0
53123,445,0,0,drop,66,66,0,1,0,1,0
52732,445,0,0,drop,70,70,0,1,0,1,0
44258,25,0,0,deny,74,74,0,1,0,1,0
57708,445,0,0,drop,70,70,0,1,0,1,0
57709,445,0,0,drop,70,70,0,1,0,1,0
52728,445,0,0,drop,70,70,0,1,0,1,0
53113,445,0,0,drop,66,66,0,1,0,1,0
53114,445,0,0,drop,66,66,0,1,0,1,0
53108,445,0,0,drop,66,66,0,1,0,1,0
53115,445,0,0,drop,66,66,0,1,0,1,0
53112,445,0,0,drop,66,66,0,1,0,1,0
53110,445,0,0,drop,66,66,0,1,0,1,0
53111,445,0,0,drop,66,66,0,1,0,1,0
53109,445,0,0,drop,66,66,0,1,0,1,0
52721,445,0,0,drop,70,70,0,1,0,1,0
57694,445,0,0,drop,70,70,0,1,0,1,0
53096,445,0,0,drop,66,66,0,1,0,1,0
53094,445,0,0,drop,66,66,0,1,0,1,0
53093,445,0,0,drop,66,66,0,1,0,1,0
52717,445,0,0,drop,70,70,0,1,0,1,0
52716,445,0,0,drop,70,70,0,1,0,1,0
57691,445,0,0,drop,70,70,0,1,0,1,0
52714,445,0,0,drop,70,70,0,1,0,1,0
64539,53,18826,53,allow,177,94,83,2,29,1,1
64380,53,30464,53,allow,196,102,94,2,32,1,1
51651,53,58120,53,allow,237,86,151,2,29,1,1
64586,53,31352,53,allow,257,102,155,2,30,1,1
55383,53,13927,53,allow,177,94,83,2,30,1,1
64716,53,5161,53,allow,718,94,624,2,30,1,1
55232,53,8300,53,allow,177,94,83,2,30,1,1
65492,53,43623,53,allow,199,102,97,2,30,1,1
51986,80,3605,80,allow,1274,694,580,13,16,6,7
55386,53,64239,53,allow,822,102,720,2,30,1,1
56828,53,33245,53,allow,211,102,109,2,30,1,1
50375,80,22563,80,allow,350,210,140,6,15,4,2
51403,443,43951,443,allow,334,70,264,5,17,1,4
49603,53,64849,53,allow,733,94,639,2,30,1,1
65294,53,43260,53,allow,173,94,79,2,30,1,1
65236,53,21854,53,allow,177,94,83,2,30,1,1
65507,53,17701,53,allow,211,102,109,2,30,1,1
65294,53,10566,53,allow,165,86,79,2,30,1,1
65236,53,45022,53,allow,177,94,83,2,30,1,1
51580,80,9107,80,allow,1752,786,966,16,17,9,7
49432,53,25699,53,allow,309,94,215,4,32,2,2
58904,123,61821,123,allow,184,94,90,2,30,1,1
50864,53,14255,53,allow,199,94,105,2,30,1,1
65309,53,31055,53,allow,764,102,662,2,30,1,1
55005,53,64586,53,allow,211,102,109,2,30,1,1
64967,53,21374,53,allow,389,134,255,2,30,1,1
65492,53,44506,53,allow,822,102,720,2,30,1,1
64113,53,6414,53,allow,216,102,114,2,30,1,1
56887,53,53946,53,allow,250,87,163,4,60,2,2
55232,53,12562,53,allow,177,94,83,2,29,1,1
49591,53,21458,53,allow,86,86,0,1,29,1,0
40604,443,31639,443,allow,130,70,60,3,5,2,1
38968,80,48567,80,allow,1280,586,694,10,15,5,5
36535,443,10367,443,allow,416,210,206,7,27,4,3
40511,80,1880,80,allow,1680,950,730,12,15,6,6
55383,53,49153,53,allow,177,94,83,2,29,1,1
57351,53,48992,53,allow,177,94,83,2,30,1,1
64642,53,40634,53,allow,265,94,171,2,30,1,1
55917,53,40255,53,allow,177,94,83,2,30,1,1
49883,53,14693,53,allow,177,94,83,2,30,1,1
63617,53,24659,53,allow,299,102,197,2,30,1,1
65220,53,42472,53,allow,245,94,151,2,30,1,1
59534,53,0,0,allow,627,72,555,2,30,1,1
65396,53,32966,53,allow,178,94,84,2,30,1,1
55917,53,22277,53,allow,177,94,83,2,30,1,1
49597,53,40368,53,allow,86,86,0,1,30,1,0
57351,53,50583,53,allow,177,94,83,2,30,1,1
49890,53,63142,53,allow,767,102,665,2,30,1,1
57152,53,41610,53,allow,733,94,639,2,30,1,1
49591,53,36017,53,allow,168,86,82,2,31,1,1
56229,53,12969,53,allow,165,86,79,2,30,1,1
63766,80,33525,80,allow,314,192,122,6,15,4,2
64404,53,48455,53,allow,224,94,130,2,30,1,1
64557,53,9245,53,allow,766,102,664,2,30,1,1
57095,53,7010,53,allow,177,94,83,2,30,1,1
56355,53,52899,53,allow,184,94,90,2,31,1,1
64052,53,64052,53,allow,198,90,108,2,30,1,1
59534,53,0,0,allow,216,72,144,2,30,1,1
64841,53,21377,53,allow,173,94,79,2,30,1,1
49883,53,42017,53,allow,177,94,83,2,30,1,1
50233,53,42089,53,allow,748,94,654,2,30,1,1
56196,53,24743,53,allow,498,204,294,6,31,3,3
64979,53,4667,53,allow,194,102,92,2,31,1,1
54967,53,43919,53,allow,178,94,84,2,31,1,1
55617,53,37518,53,allow,194,102,92,2,31,1,1
51075,80,51075,80,allow,450,246,204,8,26,5,3
55089,53,1796,53,allow,199,102,97,2,30,1,1
64308,53,43760,53,allow,181,86,95,2,30,1,1
55089,53,56950,53,allow,199,102,97,2,30,1,1
64599,53,12199,53,allow,767,102,665,2,30,1,1
57095,53,10011,53,allow,177,94,83,2,30,1,1
36255,53,36255,53,allow,197,90,107,2,30,1,1
55346,53,62620,53,allow,177,94,83,2,31,1,1
52710,445,0,0,drop,70,70,0,1,0,1,0
43890,123,0,0,deny,234,234,0,1,0,1,0
57679,445,0,0,drop,70,70,0,1,0,1,0
57680,445,0,0,drop,70,70,0,1,0,1,0
57678,445,0,0,drop,70,70,0,1,0,1,0
52698,445,0,0,drop,70,70,0,1,0,1,0
52697,445,0,0,drop,70,70,0,1,0,1,0
52693,445,0,0,drop,70,70,0,1,0,1,0
52687,445,0,0,drop,70,70,0,1,0,1,0
52688,445,0,0,drop,70,70,0,1,0,1,0
57671,445,0,0,drop,70,70,0,1,0,1,0
57664,445,0,0,drop,70,70,0,1,0,1,0
52676,445,0,0,drop,70,70,0,1,0,1,0
44933,23,0,0,deny,60,60,0,1,0,1,0
52671,445,0,0,drop,70,70,0,1,0,1,0
53072,445,0,0,drop,66,66,0,1,0,1,0
57661,445,0,0,drop,70,70,0,1,0,1,0
52663,445,0,0,drop,70,70,0,1,0,1,0
52658,445,0,0,drop,70,70,0,1,0,1,0
52657,445,0,0,drop,70,70,0,1,0,1,0
53065,445,0,0,drop,66,66,0,1,0,1,0
53064,445,0,0,drop,66,66,0,1,0,1,0
57645,445,0,0,drop,70,70,0,1,0,1,0
57644,445,0,0,drop,70,70,0,1,0,1,0
57639,445,0,0,drop,70,70,0,1,0,1,0
53062,445,0,0,drop,66,66,0,1,0,1,0
52649,445,0,0,drop,70,70,0,1,0,1,0
57636,445,0,0,drop,70,70,0,1,0,1,0
57633,445,0,0,drop,70,70,0,1,0,1,0
57632,445,0,0,drop,70,70,0,1,0,1,0
57629,445,0,0,drop,70,70,0,1,0,1,0
53055,445,0,0,drop,66,66,0,1,0,1,0
52642,445,0,0,drop,70,70,0,1,0,1,0
53047,445,0,0,drop,66,66,0,1,0,1,0
53048,445,0,0,drop,66,66,0,1,0,1,0
53046,445,0,0,drop,66,66,0,1,0,1,0
53045,445,0,0,drop,66,66,0,1,0,1,0
53043,445,0,0,drop,66,66,0,1,0,1,0
53042,445,0,0,drop,66,66,0,1,0,1,0
52635,445,0,0,drop,70,70,0,1,0,1,0
52634,445,0,0,drop,70,70,0,1,0,1,0
57628,445,0,0,drop,70,70,0,1,0,1,0
57625,445,0,0,drop,70,70,0,1,0,1,0
53038,445,0,0,drop,66,66,0,1,0,1,0
57620,445,0,0,drop,70,70,0,1,0,1,0
53037,445,0,0,drop,66,66,0,1,0,1,0
53033,445,0,0,drop,66,66,0,1,0,1,0
53035,445,0,0,drop,66,66,0,1,0,1,0
53031,445,0,0,drop,66,66,0,1,0,1,0
52629,445,0,0,drop,70,70,0,1,0,1,0
63615,23,0,0,deny,60,60,0,1,0,1,0
57614,445,0,0,drop,70,70,0,1,0,1,0
50431,80,44826,80,allow,318,192,126,6,27,4,2
50435,80,28947,80,allow,318,192,126,6,27,4,2
50446,80,5062,80,allow,318,192,126,6,27,4,2
55089,53,42866,53,allow,198,101,97,2,30,1,1
57257,53,11711,53,allow,764,99,665,2,30,1,1
55735,53,17069,53,allow,772,100,672,2,30,1,1
50432,80,29144,80,allow,318,192,126,6,27,4,2
57115,53,57910,53,allow,788,108,680,2,30,1,1
57095,53,44244,53,allow,170,87,83,2,30,1,1
56741,53,9430,53,allow,814,110,704,2,30,1,1
50181,80,60161,80,allow,2149,1165,984,15,77,8,7
56357,53,52220,53,allow,172,88,84,2,30,1,1
50427,80,43709,80,allow,312,192,120,6,27,4,2
64633,53,4250,53,allow,762,98,664,2,30,1,1
55552,53,38672,53,allow,767,102,665,2,30,1,1
55462,53,13103,53,allow,188,96,92,2,30,1,1
56567,53,56060,53,allow,188,96,92,2,31,1,1
56771,53,7291,53,allow,270,95,175,4,60,2,2
50755,80,50755,80,allow,450,246,204,8,25,5,3
58054,25,23956,25,allow,1370,496,874,16,16,8,8
50948,80,50948,80,allow,520,246,274,9,25,5,4
58509,80,60586,80,allow,1666,1130,536,12,16,7,5
50428,80,50756,80,allow,312,192,120,6,27,4,2
50445,80,48799,80,allow,318,192,126,6,27,4,2
63525,53,0,0,allow,174,77,97,2,30,1,1
55417,53,30758,53,allow,196,100,96,2,30,1,1
56620,53,51991,53,allow,322,110,212,4,30,2,2
65192,53,4438,53,allow,172,88,84,2,30,1,1
55514,53,44502,53,allow,783,96,687,2,30,1,1
55113,53,29716,53,allow,196,100,96,2,31,1,1
56355,53,30971,53,allow,184,94,90,2,31,1,1
56724,53,15012,53,allow,749,89,660,2,31,1,1
55336,53,13699,53,allow,295,101,194,4,31,2,2
56569,53,65375,53,allow,91,91,0,1,31,1,0
55990,53,40258,53,allow,182,93,89,2,30,1,1
56386,53,13942,53,allow,170,87,83,2,31,1,1
57040,53,4133,53,allow,810,108,702,2,31,1,1
55282,53,18223,53,allow,771,101,670,2,31,1,1
65188,53,51573,53,allow,731,91,640,2,31,1,1
49432,53,56971,53,allow,170,87,83,2,31,1,1
55582,53,11114,53,allow,778,103,675,2,31,1,1
57350,53,19217,53,allow,771,101,670,2,31,1,1
55826,53,30050,53,allow,86,86,0,1,31,1,0
63978,53,11123,53,allow,212,108,104,2,31,1,1
56220,53,22417,53,allow,772,103,669,2,31,1,1
64637,53,20905,53,allow,810,108,702,2,30,1,1
50584,53,43253,53,allow,174,89,85,2,31,1,1
65149,53,43485,53,allow,760,97,663,2,31,1,1
56743,53,42878,53,allow,816,97,719,2,30,1,1
55746,53,61389,53,allow,216,110,106,2,31,1,1
56995,53,58865,53,allow,168,86,82,2,31,1,1
55809,53,62877,53,allow,731,85,646,2,31,1,1
55735,53,65479,53,allow,184,94,90,2,31,1,1
49263,53,10892,53,allow,731,85,646,2,31,1,1
56935,53,37247,53,allow,174,89,85,2,31,1,1
55454,53,60200,53,allow,202,103,99,2,31,1,1
55081,53,2837,53,allow,711,87,624,2,31,1,1
56186,53,1999,53,allow,196,100,96,2,31,1,1
55273,53,51928,53,allow,166,85,81,2,31,1,1
56282,53,64449,53,allow,751,95,656,2,31,1,1
56072,53,60907,53,allow,198,101,97,2,31,1,1
57094,53,64941,53,allow,192,98,94,2,31,1,1
57608,445,0,0,drop,70,70,0,1,0,1,0
52624,445,0,0,drop,70,70,0,1,0,1,0
53023,445,0,0,drop,66,66,0,1,0,1,0
64847,53,37930,53,allow,211,102,109,2,30,1,1
55990,53,28837,53,allow,183,94,89,2,30,1,1
50448,443,40818,443,allow,1119,595,524,12,26,6,6
53013,445,0,0,drop,66,66,0,1,0,1,0
57594,445,0,0,drop,70,70,0,1,0,1,0
48430,22,0,0,deny,60,60,0,1,0,1,0
52611,445,0,0,drop,70,70,0,1,0,1,0
53010,445,0,0,drop,66,66,0,1,0,1,0
52608,445,0,0,drop,70,70,0,1,0,1,0
50307,53,50594,53,allow,1370,89,1281,4,33,2,2
56620,53,31427,53,allow,216,110,106,2,30,1,1
64979,53,10691,53,allow,194,102,92,2,30,1,1
50280,53,42526,53,allow,794,102,692,2,30,1,1
56546,443,24280,443,allow,134,60,74,3,5,2,1
64776,53,33019,53,allow,935,334,601,8,62,4,4
49202,53,22068,53,allow,498,204,294,6,29,3,3
65357,53,38110,53,allow,194,102,92,2,29,1,1
49229,53,54866,53,allow,178,94,84,2,29,1,1
49320,53,59903,53,allow,177,94,83,2,30,1,1
55417,53,60973,53,allow,198,102,96,2,30,1,1
57201,53,46716,53,allow,214,110,104,2,30,1,1
56229,53,1556,53,allow,173,94,79,2,30,1,1
51009,80,51009,80,allow,450,246,204,8,25,5,3
49449,80,49449,80,allow,416,198,218,7,29,4,3
65357,53,40859,53,allow,194,102,92,2,29,1,1
59343,53,0,0,allow,178,72,106,2,29,1,1
50689,80,50689,80,allow,450,246,204,8,25,5,3
50362,53,58174,53,allow,214,110,104,2,29,1,1
49883,53,5470,53,allow,177,94,83,2,29,1,1
65396,53,55502,53,allow,186,102,84,2,29,1,1
55080,53,11951,53,allow,173,94,79,2,29,1,1
40923,53,40923,53,allow,200,90,110,2,29,1,1
55089,53,6638,53,allow,199,102,97,2,30,1,1
55346,53,65324,53,allow,177,94,83,2,29,1,1
65192,53,33207,53,allow,178,94,84,2,30,1,1
63630,53,44818,53,allow,278,94,184,2,30,1,1
50437,80,64833,80,allow,314,192,122,6,26,4,2
64730,53,5756,53,allow,261,94,167,2,30,1,1
64836,53,53586,53,allow,241,94,147,2,30,1,1
50440,53,45707,53,allow,216,110,106,2,30,1,1
49597,53,32706,53,allow,168,86,82,2,31,1,1
65030,53,52927,53,allow,785,110,675,2,30,1,1
55836,53,17150,53,allow,181,94,87,2,33,1,1
50438,80,13874,80,allow,314,192,122,6,26,4,2
57095,53,33152,53,allow,177,94,83,2,30,1,1
55735,53,28047,53,allow,184,94,90,2,30,1,1
55101,53,47277,53,allow,197,102,95,2,30,1,1
56719,53,59269,53,allow,185,102,83,2,30,1,1
56719,53,51859,53,allow,185,102,83,2,30,1,1
50440,53,39485,53,allow,216,110,106,2,30,1,1
56567,53,21156,53,allow,194,102,92,2,30,1,1
56373,53,9472,53,allow,200,102,98,2,30,1,1
49422,53,52820,53,allow,719,208,511,6,32,3,3
49353,53,9997,53,allow,237,94,143,2,30,1,1
55746,53,40664,53,allow,216,110,106,2,30,1,1
56386,53,3694,53,allow,177,94,83,2,30,1,1
49432,53,51069,53,allow,177,94,83,2,30,1,1
64980,53,3433,53,allow,200,102,98,2,30,1,1
55990,53,30769,53,allow,183,94,89,2,30,1,1
49564,53,7876,53,allow,168,78,90,2,30,1,1
56995,53,18611,53,allow,168,86,82,2,30,1,1
64840,53,24107,53,allow,356,118,238,2,30,1,1
55077,53,19465,53,allow,277,90,187,4,32,2,2
50439,80,32782,80,allow,318,192,126,6,26,4,2
65291,53,53725,53,allow,889,404,485,10,30,5,5
52704,53,49844,53,allow,168,78,90,2,30,1,1
50434,80,31890,80,allow,318,192,126,6,26,4,2
65496,53,6299,53,allow,210,86,124,2,30,1,1
56620,53,63507,53,allow,216,110,106,2,30,1,1
60760,53,0,0,allow,86,86,0,1,30,1,0
56658,53,12429,53,allow,229,94,135,2,30,1,1
49971,53,55758,53,allow,198,102,96,2,30,1,1
57090,53,28237,53,allow,198,102,96,2,30,1,1
53372,443,36591,443,allow,214,140,74,4,20,3,1
55417,53,34497,53,allow,198,102,96,2,33,1,1
53575,1025,61617,1025,allow,70,70,0,1,4,1,0
50441,80,60802,80,allow,318,192,126,6,26,4,2
50433,80,24726,80,allow,318,192,126,6,26,4,2
49623,53,34250,53,allow,790,110,680,2,29,1,1
53070,53,0,0,allow,168,74,94,2,29,1,1
55080,53,13972,53,allow,165,86,79,2,29,1,1
57201,53,40982,53,allow,214,110,104,2,29,1,1
50362,53,33305,53,allow,214,110,104,2,29,1,1
59321,53,33396,53,allow,209,70,139,2,30,1,1
49320,53,28326,53,allow,185,102,83,2,30,1,1
65130,53,25428,53,allow,646,200,446,6,62,3,3
63942,53,65464,53,allow,214,102,112,2,30,1,1
49405,53,14474,53,allow,94,94,0,1,30,1,0
50106,53,61175,53,allow,209,110,99,2,30,1,1
60375,53,25105,53,allow,226,94,132,2,31,1,1
56386,53,9835,53,allow,177,94,83,2,31,1,1
55439,53,52898,53,allow,209,110,99,2,30,1,1
55776,53,52683,53,allow,216,110,106,2,30,1,1
56567,53,28811,53,allow,194,102,92,2,31,1,1
36157,53,43020,53,allow,164,78,86,2,31,1,1
65366,53,59432,53,allow,199,102,97,2,31,1,1
56186,53,13478,53,allow,198,102,96,2,31,1,1
57094,53,10369,53,allow,196,102,94,2,30,1,1
49591,53,7578,53,allow,168,86,82,2,32,1,1
55462,53,6708,53,allow,194,102,92,2,30,1,1
65366,53,11375,53,allow,199,102,97,2,30,1,1
55107,53,52328,53,allow,214,102,112,2,30,1,1
56373,53,63287,53,allow,200,102,98,2,30,1,1
50613,53,60735,53,allow,814,110,704,2,30,1,1
56373,53,59936,53,allow,200,102,98,2,30,1,1
41886,53,43611,53,allow,168,78,90,2,30,1,1
50440,53,43767,53,allow,216,110,106,2,30,1,1
49971,53,63730,53,allow,198,102,96,2,30,1,1
49433,53,38840,53,allow,167,86,81,2,30,1,1
50440,80,41548,80,allow,318,192,126,6,26,4,2
50429,80,32057,80,allow,318,192,126,6,26,4,2
50430,80,29932,80,allow,318,192,126,6,26,4,2
55836,53,27528,53,allow,181,94,87,2,30,1,1
55656,53,37585,53,allow,214,110,104,2,30,1,1
55656,53,7470,53,allow,214,110,104,2,30,1,1
54967,53,27983,53,allow,178,94,84,2,30,1,1
55617,53,59978,53,allow,194,102,92,2,30,1,1
37637,53,37222,53,allow,168,78,90,2,30,1,1
52221,53,10859,53,allow,177,86,91,2,30,1,1
40507,53,2072,53,allow,86,86,0,1,30,1,0
38523,53,38523,53,allow,214,82,132,2,32,1,1
50436,80,19701,80,allow,314,192,122,6,26,4,2
55990,53,6469,53,allow,183,94,89,2,30,1,1
55735,53,52965,53,allow,184,94,90,2,30,1,1
56771,53,2287,53,allow,270,95,175,4,60,2,2
65153,53,29688,53,allow,168,86,82,2,30,1,1
50106,53,26028,53,allow,209,110,99,2,30,1,1
63978,53,60357,53,allow,214,110,104,2,30,1,1
64980,53,54616,53,allow,200,102,98,2,30,1,1
50584,53,20103,53,allow,179,94,85,2,30,1,1
63978,53,35344,53,allow,214,110,104,2,30,1,1
55336,53,26759,53,allow,199,102,97,2,31,1,1
50103,53,41648,53,allow,168,86,82,2,31,1,1
56809,53,41798,53,allow,178,94,84,2,31,1,1
55746,53,54887,53,allow,216,110,106,2,30,1,1
64001,53,4323,53,allow,183,94,89,2,30,1,1
65036,53,40667,53,allow,214,110,104,2,30,1,1
50105,53,29739,53,allow,969,86,883,2,30,1,1
57090,53,19646,53,allow,198,102,96,2,30,1,1
55656,53,44214,53,allow,214,110,104,2,30,1,1
64001,53,1260,53,allow,183,94,89,2,30,1,1
65036,53,28927,53,allow,214,110,104,2,30,1,1
65366,53,12473,53,allow,199,102,97,2,30,1,1
56355,53,13355,53,allow,184,94,90,2,30,1,1
55454,53,12071,53,allow,209,110,99,2,31,1,1
40942,123,62465,123,allow,184,94,90,2,30,1,1
56386,53,21142,53,allow,177,94,83,2,30,1,1
49543,53,11834,53,allow,779,110,669,2,30,1,1
56357,53,34112,53,allow,178,94,84,2,30,1,1
64995,53,33043,53,allow,199,102,97,2,30,1,1
57259,53,43312,53,allow,199,102,97,2,31,1,1
50103,53,21620,53,allow,168,86,82,2,30,1,1
54956,53,56541,53,allow,194,102,92,2,30,1,1
64995,53,32093,53,allow,199,102,97,2,30,1,1
55372,53,55372,53,allow,216,90,126,2,30,1,1
56501,53,9977,53,allow,216,94,122,2,31,1,1
57094,53,18443,53,allow,196,102,94,2,31,1,1
55364,53,26181,53,allow,168,86,82,2,31,1,1
65300,53,9182,53,allow,195,102,93,2,31,1,1
56355,53,43280,53,allow,184,94,90,2,31,1,1
55101,53,52227,53,allow,197,102,95,2,31,1,1
49608,53,63046,53,allow,198,110,88,2,31,1,1
49432,53,5253,53,allow,177,94,83,2,31,1,1
56072,53,35892,53,allow,199,102,97,2,31,1,1
38535,443,55811,443,allow,910,358,552,14,47,6,8
54956,53,60675,53,allow,194,102,92,2,31,1,1
65338,53,10255,53,allow,314,88,226,4,44,2,2
51509,443,60240,443,allow,1307,688,619,14,37,8,6
53004,445,0,0,drop,66,66,0,1,0,1,0
53000,445,0,0,drop,66,66,0,1,0,1,0
52604,445,0,0,drop,70,70,0,1,0,1,0
52602,445,0,0,drop,70,70,0,1,0,1,0
52600,445,0,0,drop,70,70,0,1,0,1,0
57581,445,0,0,drop,70,70,0,1,0,1,0
52980,445,0,0,drop,66,66,0,1,0,1,0
52986,445,0,0,drop,66,66,0,1,0,1,0
52983,445,0,0,drop,66,66,0,1,0,1,0
52981,445,0,0,drop,66,66,0,1,0,1,0
52987,445,0,0,drop,66,66,0,1,0,1,0
52988,445,0,0,drop,66,66,0,1,0,1,0
52985,445,0,0,drop,66,66,0,1,0,1,0
52984,445,0,0,drop,66,66,0,1,0,1,0
52591,445,0,0,drop,70,70,0,1,0,1,0
57579,445,0,0,drop,70,70,0,1,0,1,0
57569,445,0,0,drop,70,70,0,1,0,1,0
57566,445,0,0,drop,70,70,0,1,0,1,0
52589,445,0,0,drop,70,70,0,1,0,1,0
52588,445,0,0,drop,70,70,0,1,0,1,0
52968,445,0,0,drop,66,66,0,1,0,1,0
52966,445,0,0,drop,66,66,0,1,0,1,0
52965,445,0,0,drop,66,66,0,1,0,1,0
52586,445,0,0,drop,70,70,0,1,0,1,0
52583,445,0,0,drop,70,70,0,1,0,1,0
57562,445,0,0,drop,70,70,0,1,0,1,0
57560,445,0,0,drop,70,70,0,1,0,1,0
52570,445,0,0,drop,70,70,0,1,0,1,0
57552,445,0,0,drop,70,70,0,1,0,1,0
57550,445,0,0,drop,70,70,0,1,0,1,0
52559,445,0,0,drop,70,70,0,1,0,1,0
52560,445,0,0,drop,70,70,0,1,0,1,0
52548,445,0,0,drop,70,70,0,1,0,1,0
57540,445,0,0,drop,70,70,0,1,0,1,0
57537,445,0,0,drop,70,70,0,1,0,1,0
52544,445,0,0,drop,70,70,0,1,0,1,0
52944,445,0,0,drop,66,66,0,1,0,1,0
57533,445,0,0,drop,70,70,0,1,0,1,0
57534,445,0,0,drop,70,70,0,1,0,1,0
52533,445,0,0,drop,70,70,0,1,0,1,0
52535,445,0,0,drop,70,70,0,1,0,1,0
52532,445,0,0,drop,70,70,0,1,0,1,0
52531,445,0,0,drop,70,70,0,1,0,1,0
52527,445,0,0,drop,70,70,0,1,0,1,0
52940,445,0,0,drop,66,66,0,1,0,1,0
52936,445,0,0,drop,66,66,0,1,0,1,0
57523,445,0,0,drop,70,70,0,1,0,1,0
57511,445,0,0,drop,70,70,0,1,0,1,0
52933,445,0,0,drop,66,66,0,1,0,1,0
57508,445,0,0,drop,70,70,0,1,0,1,0
52514,445,0,0,drop,70,70,0,1,0,1,0
52511,445,0,0,drop,70,70,0,1,0,1,0
57505,445,0,0,drop,70,70,0,1,0,1,0
57504,445,0,0,drop,70,70,0,1,0,1,0
57501,445,0,0,drop,70,70,0,1,0,1,0
52926,445,0,0,drop,66,66,0,1,0,1,0
52920,445,0,0,drop,66,66,0,1,0,1,0
52923,445,0,0,drop,66,66,0,1,0,1,0
52919,445,0,0,drop,66,66,0,1,0,1,0
52916,445,0,0,drop,66,66,0,1,0,1,0
52917,445,0,0,drop,66,66,0,1,0,1,0
52915,445,0,0,drop,66,66,0,1,0,1,0
52508,445,0,0,drop,70,70,0,1,0,1,0
57498,445,0,0,drop,70,70,0,1,0,1,0
57499,445,0,0,drop,70,70,0,1,0,1,0
52910,445,0,0,drop,66,66,0,1,0,1,0
64516,53,13798,53,allow,216,110,106,2,30,1,1
59819,443,17243,443,allow,1401,864,537,12,29,6,6
55943,53,5113,53,allow,1415,94,1321,4,31,2,2
49217,53,12085,53,allow,202,103,99,2,31,1,1
49374,53,54400,53,allow,186,95,91,2,31,1,1
55101,53,27553,53,allow,194,99,95,2,30,1,1
65300,53,37068,53,allow,190,97,93,2,31,1,1
59823,443,61551,443,allow,306,180,126,6,29,4,2
56809,53,64424,53,allow,172,88,84,2,31,1,1
55364,53,1221,53,allow,168,86,82,2,31,1,1
64680,53,32256,53,allow,768,99,669,2,30,1,1
44913,443,18458,443,allow,414,140,274,7,27,3,4
59817,443,40958,443,allow,1401,864,537,12,29,6,6
59836,443,19606,443,allow,1587,924,663,15,27,7,8
55655,53,48004,53,allow,304,110,194,4,35,2,2
49888,53,54251,53,allow,196,100,96,2,30,1,1
53246,443,15204,443,allow,134,60,74,3,11,2,1
50376,53,65518,53,allow,164,84,80,2,31,1,1
64417,53,46438,53,allow,184,94,90,2,31,1,1
55675,53,52778,53,allow,764,99,665,2,31,1,1
54956,53,34992,53,allow,188,96,92,2,31,1,1
45273,53,45273,53,allow,213,79,134,2,32,1,1
39207,80,25613,80,allow,78,78,0,1,5,1,0
59818,443,31542,443,allow,1401,864,537,12,29,6,6
65411,53,35148,53,allow,771,101,670,2,30,1,1
49841,53,53641,53,allow,751,95,656,2,30,1,1
64815,53,23371,53,allow,755,94,661,2,30,1,1
56601,53,60579,53,allow,168,78,90,2,30,1,1
64001,53,5288,53,allow,182,93,89,2,30,1,1
56391,53,63935,53,allow,758,93,665,2,31,1,1
55171,53,26173,53,allow,762,97,665,2,31,1,1
64595,53,64819,53,allow,166,85,81,2,31,1,1
55147,53,27402,53,allow,184,94,90,2,31,1,1
64903,53,49771,53,allow,777,87,690,2,31,1,1
56919,53,19863,53,allow,186,95,91,2,31,1,1
56557,53,31623,53,allow,212,108,104,2,31,1,1
56312,53,44683,53,allow,756,95,661,2,31,1,1
55077,53,1629,53,allow,174,89,85,2,31,1,1
64287,53,20763,53,allow,178,91,87,2,31,1,1
55217,53,15991,53,allow,744,89,655,2,31,1,1
57252,53,46137,53,allow,182,93,89,2,31,1,1
56926,53,49989,53,allow,747,93,654,2,31,1,1
54993,53,53914,53,allow,751,95,656,2,31,1,1
64924,53,58224,53,allow,747,93,654,2,31,1,1
56227,53,18236,53,allow,174,89,85,2,31,1,1
64715,53,60812,53,allow,202,103,99,2,31,1,1
65246,53,4675,53,allow,182,93,89,2,31,1,1
65246,53,34223,53,allow,182,93,89,2,31,1,1
49901,53,35015,53,allow,186,95,91,2,31,1,1
55604,53,44456,53,allow,758,93,665,2,31,1,1
57492,445,0,0,drop,70,70,0,1,0,1,0
52909,445,0,0,drop,66,66,0,1,0,1,0
52905,445,0,0,drop,66,66,0,1,0,1,0
52907,445,0,0,drop,66,66,0,1,0,1,0
52501,445,0,0,drop,70,70,0,1,0,1,0
52903,445,0,0,drop,66,66,0,1,0,1,0
57484,445,0,0,drop,70,70,0,1,0,1,0
56609,53,42819,53,allow,199,102,97,2,31,1,1
49573,53,10183,53,allow,770,102,668,2,30,1,1
57482,445,0,0,drop,70,70,0,1,0,1,0
57477,445,0,0,drop,70,70,0,1,0,1,0
52895,445,0,0,drop,66,66,0,1,0,1,0
52885,445,0,0,drop,66,66,0,1,0,1,0
56344,53,55607,53,allow,167,86,81,2,30,1,1
56430,53,61403,53,allow,193,102,91,2,30,1,1
62880,53,59831,53,allow,248,78,170,2,30,1,1
55336,53,49932,53,allow,199,102,97,2,30,1,1
55273,53,29396,53,allow,167,86,81,2,30,1,1
56082,53,4620,53,allow,182,94,88,2,30,1,1
64945,53,44242,53,allow,243,94,149,2,30,1,1
51342,53,21697,53,allow,199,94,105,2,30,1,1
56609,53,65200,53,allow,199,102,97,2,30,1,1
55113,53,62881,53,allow,198,102,96,2,33,1,1
49176,53,50257,53,allow,528,178,350,6,43,3,3
49433,53,5828,53,allow,167,86,81,2,29,1,1
55776,53,11863,53,allow,216,110,106,2,29,1,1
65138,53,38637,53,allow,765,102,663,2,30,1,1
61363,80,43167,80,allow,1931,752,1179,15,16,8,7
52212,80,6091,80,allow,366,246,120,6,34,4,2
56615,80,9225,80,allow,234,234,0,4,11,4,0
64551,53,37333,53,allow,495,127,368,4,33,2,2
50604,443,64927,443,allow,1385,783,602,14,23,8,6
55615,53,40819,53,allow,225,110,115,2,30,1,1
57257,53,4922,53,allow,173,94,79,2,30,1,1
65285,53,31109,53,allow,294,102,192,2,30,1,1
49456,443,44613,443,allow,939,547,392,11,27,5,6
50022,443,50896,443,allow,70,70,0,2,5,2,0
53028,80,62533,80,allow,70,70,0,1,5,1,0
50459,53,40007,53,allow,811,94,717,2,30,1,1
49993,53,48809,53,allow,212,102,110,2,30,1,1
55293,53,0,0,allow,166,73,93,2,30,1,1
56186,53,36968,53,allow,198,102,96,2,30,1,1
56809,53,35484,53,allow,178,94,84,2,30,1,1
65246,53,13640,53,allow,767,102,665,2,30,1,1
59828,443,44871,443,allow,306,180,126,6,29,4,2
49851,53,2859,53,allow,306,88,218,4,32,2,2
55480,53,36431,53,allow,378,97,281,4,33,2,2
56344,53,18094,53,allow,167,86,81,2,30,1,1
62034,53,62034,53,allow,216,90,126,2,30,1,1
57259,53,43508,53,allow,199,102,97,2,30,1,1
59832,443,5609,443,allow,302,120,182,6,28,3,3
55336,53,7329,53,allow,199,102,97,2,30,1,1
65484,53,31170,53,allow,195,102,93,2,30,1,1
55655,53,10525,53,allow,304,110,194,4,34,2,2
57186,53,41154,53,allow,177,94,83,2,30,1,1
56962,53,9664,53,allow,177,94,83,2,30,1,1
55600,80,5814,80,allow,70,70,0,1,5,1,0
65484,53,32858,53,allow,195,102,93,2,30,1,1
55240,53,36394,53,allow,816,102,714,2,30,1,1
64936,53,3056,53,allow,193,102,91,2,30,1,1
49217,53,36290,53,allow,209,110,99,2,30,1,1
55454,53,25468,53,allow,209,110,99,2,30,1,1
55273,53,29948,53,allow,167,86,81,2,30,1,1
57186,53,42967,53,allow,177,94,83,2,30,1,1
64516,53,8350,53,allow,216,110,106,2,30,1,1
64652,53,53769,53,allow,198,94,104,2,30,1,1
55077,53,42307,53,allow,179,94,85,2,30,1,1
56569,53,5839,53,allow,181,94,87,2,32,1,1
49449,443,30580,443,allow,1574,921,653,14,15,7,7
55375,53,8307,53,allow,214,110,104,2,30,1,1
55375,53,30516,53,allow,214,110,104,2,30,1,1
36405,53,36515,53,allow,199,94,105,2,30,1,1
49888,53,39344,53,allow,198,102,96,2,30,1,1
55240,53,47282,53,allow,193,102,91,2,30,1,1
50039,53,19771,53,allow,261,110,151,2,30,1,1
64595,53,62622,53,allow,167,86,81,2,30,1,1
56557,53,41528,53,allow,214,110,104,2,30,1,1
64002,53,17468,53,allow,796,105,691,4,59,2,2
55273,53,49246,53,allow,317,85,232,4,60,2,2
49374,53,36144,53,allow,193,102,91,2,30,1,1
52188,443,37924,443,allow,1768,1034,734,16,65,8,8
51516,443,35060,443,allow,1195,634,561,12,21,7,5
51498,443,13741,443,allow,134,60,74,3,4,2,1
55655,53,55322,53,allow,304,110,194,4,34,2,2
58027,80,53632,80,allow,1225,711,514,11,15,5,6
55113,53,41095,53,allow,198,102,96,2,29,1,1
55981,53,55529,53,allow,168,78,90,2,30,1,1
64980,53,10354,53,allow,200,102,98,2,29,1,1
56935,53,38764,53,allow,179,94,85,2,30,1,1
55375,53,47639,53,allow,214,110,104,2,30,1,1
57464,80,36285,80,allow,234,234,0,4,11,4,0
55776,53,40395,53,allow,216,110,106,2,29,1,1
50023,443,17571,443,allow,70,70,0,2,5,2,0
56186,53,3994,53,allow,198,102,96,2,29,1,1
64001,53,52493,53,allow,183,94,89,2,29,1,1
64936,53,55896,53,allow,816,102,714,2,30,1,1
65036,53,38858,53,allow,214,110,104,2,29,1,1
49608,53,63386,53,allow,198,110,88,2,29,1,1
64309,53,10386,53,allow,308,94,214,2,30,1,1
55439,53,53595,53,allow,209,110,99,2,29,1,1
64516,53,41634,53,allow,216,110,106,2,30,1,1
63978,53,35845,53,allow,214,110,104,2,30,1,1
56919,53,23336,53,allow,193,102,91,2,30,1,1
55826,53,22161,53,allow,168,86,82,2,30,1,1
55735,53,20718,53,allow,184,94,90,2,30,1,1
64714,53,62163,53,allow,289,134,155,2,30,1,1
58754,53,0,0,allow,258,80,178,2,30,1,1
50458,53,16491,53,allow,458,188,270,6,30,3,3
51543,53,3333,53,allow,78,78,0,1,30,1,0
64839,53,30697,53,allow,443,182,261,6,30,3,3
49259,53,28989,53,allow,168,86,82,2,30,1,1
56246,53,33774,53,allow,209,110,99,2,30,1,1
50121,53,5203,53,allow,152,78,74,2,30,1,1
64287,53,8601,53,allow,181,94,87,2,31,1,1
65420,53,28650,53,allow,166,86,80,2,31,1,1
64085,53,10076,53,allow,351,102,249,4,43,2,2
49448,443,34233,443,allow,1574,921,653,14,15,7,7
56430,53,37979,53,allow,193,102,91,2,30,1,1
65429,53,14191,53,allow,200,94,106,2,30,1,1
65265,53,37973,53,allow,821,102,719,2,30,1,1
56072,53,56771,53,allow,199,102,97,2,30,1,1
65192,53,25403,53,allow,249,102,147,2,30,1,1
55364,53,12032,53,allow,168,86,82,2,30,1,1
56962,53,9303,53,allow,177,94,83,2,30,1,1
55918,53,38281,53,allow,184,94,90,2,31,1,1
39921,80,15019,80,allow,1151,711,440,10,15,5,5
50076,80,31297,80,allow,1052,612,440,10,15,5,5
56072,53,61103,53,allow,199,102,97,2,30,1,1
43735,53,12080,53,allow,168,78,90,2,30,1,1
58754,53,0,0,allow,627,80,547,2,30,1,1
56082,53,27828,53,allow,182,94,88,2,30,1,1
64417,53,4241,53,allow,184,94,90,2,30,1,1
59237,53,43242,53,allow,164,78,86,2,30,1,1
49246,53,24337,53,allow,779,86,693,2,30,1,1
55101,53,1606,53,allow,197,102,95,2,30,1,1
49439,53,56004,53,allow,197,102,95,2,31,1,1
49972,53,23300,53,allow,184,94,90,2,30,1,1
55100,53,1559,53,allow,178,94,84,2,30,1,1
56246,53,1913,53,allow,209,110,99,2,30,1,1
49217,53,2129,53,allow,209,110,99,2,31,1,1
54956,53,14576,53,allow,194,102,92,2,31,1,1
49597,53,63650,53,allow,168,86,82,2,31,1,1
56765,53,27082,53,allow,194,102,92,2,31,1,1
49667,53,65196,53,allow,183,94,89,2,30,1,1
49374,53,45816,53,allow,193,102,91,2,30,1,1
41002,53,33121,53,allow,164,78,86,2,30,1,1
49365,53,39023,53,allow,195,102,93,2,30,1,1
64041,53,58555,53,allow,200,102,98,2,31,1,1
49794,53,12589,53,allow,197,102,95,2,30,1,1
56026,53,4908,53,allow,183,94,89,2,31,1,1
50376,53,23494,53,allow,166,86,80,2,31,1,1
55100,53,26652,53,allow,178,94,84,2,31,1,1
65300,53,18303,53,allow,195,102,93,2,31,1,1
48894,53,34771,53,allow,164,78,86,2,31,1,1
50121,53,43532,53,allow,152,78,74,2,31,1,1
56223,53,58545,53,allow,185,102,83,2,31,1,1
64323,53,30451,53,allow,195,102,93,2,31,1,1
64417,53,37642,53,allow,184,94,90,2,31,1,1
60016,443,40510,443,allow,134,60,74,3,6,2,1
64732,53,52596,53,allow,189,102,87,2,30,1,1
57015,53,61760,53,allow,279,94,185,2,30,1,1
51090,53,42988,53,allow,164,78,86,2,30,1,1
57094,53,61596,53,allow,196,102,94,2,30,1,1
55364,53,21776,53,allow,168,86,82,2,31,1,1
56962,53,40705,53,allow,177,94,83,2,31,1,1
59816,443,30172,443,allow,622,310,312,11,29,6,5
60194,80,35341,80,allow,70,70,0,2,8,2,0
49794,53,1835,53,allow,197,102,95,2,30,1,1
64516,53,9042,53,allow,216,110,106,2,30,1,1
49259,53,59958,53,allow,184,102,82,2,30,1,1
49183,53,24061,53,allow,209,110,99,2,31,1,1
57466,445,0,0,drop,70,70,0,1,0,1,0
52483,445,0,0,drop,70,70,0,1,0,1,0
52883,445,0,0,drop,66,66,0,1,0,1,0
52876,445,0,0,drop,66,66,0,1,0,1,0
52870,445,0,0,drop,66,66,0,1,0,1,0
52475,445,0,0,drop,70,70,0,1,0,1,0
52472,445,0,0,drop,70,70,0,1,0,1,0
57452,445,0,0,drop,70,70,0,1,0,1,0
57453,445,0,0,drop,70,70,0,1,0,1,0
52854,445,0,0,drop,66,66,0,1,0,1,0
52860,445,0,0,drop,66,66,0,1,0,1,0
52855,445,0,0,drop,66,66,0,1,0,1,0
52856,445,0,0,drop,66,66,0,1,0,1,0
52857,445,0,0,drop,66,66,0,1,0,1,0
52859,445,0,0,drop,66,66,0,1,0,1,0
52852,445,0,0,drop,66,66,0,1,0,1,0
52853,445,0,0,drop,66,66,0,1,0,1,0
52465,445,0,0,drop,70,70,0,1,0,1,0
52463,445,0,0,drop,70,70,0,1,0,1,0
48180,143,0,0,deny,60,60,0,1,0,1,0
53783,443,19626,443,allow,499,425,74,4,0,3,1
53782,443,62733,443,allow,499,425,74,4,0,3,1
57447,445,0,0,drop,70,70,0,1,0,1,0
57442,445,0,0,drop,70,70,0,1,0,1,0
57441,445,0,0,drop,70,70,0,1,0,1,0
52457,445,0,0,drop,70,70,0,1,0,1,0
52838,445,0,0,drop,66,66,0,1,0,1,0
52840,445,0,0,drop,66,66,0,1,0,1,0
52837,445,0,0,drop,66,66,0,1,0,1,0
57434,445,0,0,drop,70,70,0,1,0,1,0
52442,445,0,0,drop,70,70,0,1,0,1,0
52441,445,0,0,drop,70,70,0,1,0,1,0
52439,445,0,0,drop,70,70,0,1,0,1,0
52432,445,0,0,drop,70,70,0,1,0,1,0
52431,445,0,0,drop,70,70,0,1,0,1,0
57432,445,0,0,drop,70,70,0,1,0,1,0
57427,445,0,0,drop,70,70,0,1,0,1,0
57426,445,0,0,drop,70,70,0,1,0,1,0
57421,445,0,0,drop,70,70,0,1,0,1,0
47413,23,0,0,deny,60,60,0,1,0,1,0
57413,445,0,0,drop,70,70,0,1,0,1,0
57409,445,0,0,drop,70,70,0,1,0,1,0
52416,445,0,0,drop,70,70,0,1,0,1,0
52407,445,0,0,drop,70,70,0,1,0,1,0
52405,445,0,0,drop,70,70,0,1,0,1,0
52401,445,0,0,drop,70,70,0,1,0,1,0
52402,445,0,0,drop,70,70,0,1,0,1,0
52816,445,0,0,drop,66,66,0,1,0,1,0
57407,445,0,0,drop,70,70,0,1,0,1,0
57404,445,0,0,drop,70,70,0,1,0,1,0
52399,445,0,0,drop,70,70,0,1,0,1,0
52812,445,0,0,drop,66,66,0,1,0,1,0
52808,445,0,0,drop,66,66,0,1,0,1,0
52394,445,0,0,drop,70,70,0,1,0,1,0
57393,445,0,0,drop,70,70,0,1,0,1,0
57390,445,0,0,drop,70,70,0,1,0,1,0
57387,445,0,0,drop,70,70,0,1,0,1,0
57383,445,0,0,drop,70,70,0,1,0,1,0
52807,445,0,0,drop,66,66,0,1,0,1,0
52385,445,0,0,drop,70,70,0,1,0,1,0
55072,53,57853,53,allow,701,88,613,2,30,1,1
56246,53,65270,53,allow,202,103,99,2,30,1,1
50319,53,28862,53,allow,756,95,661,2,30,1,1
55974,53,19851,53,allow,762,98,664,2,30,1,1
55605,53,8941,53,allow,711,87,624,2,30,1,1
49445,53,33858,53,allow,770,101,669,2,30,1,1
64311,53,1855,53,allow,198,101,97,2,31,1,1
56406,53,47759,53,allow,749,89,660,2,30,1,1
55427,53,28517,53,allow,772,103,669,2,30,1,1
65359,53,29324,53,allow,186,95,91,2,30,1,1
65060,53,36666,53,allow,761,100,661,2,30,1,1
56609,53,56720,53,allow,198,101,97,2,30,1,1
55918,53,15697,53,allow,184,94,90,2,31,1,1
55117,53,60693,53,allow,756,95,661,2,31,1,1
49851,53,28608,53,allow,164,84,80,2,30,1,1
65283,53,18469,53,allow,732,89,643,2,30,1,1
64831,53,59275,53,allow,216,110,106,2,30,1,1
49439,53,62852,53,allow,194,99,95,2,31,1,1
49197,53,27457,53,allow,751,95,656,2,30,1,1
50422,443,13716,443,allow,1389,868,521,12,25,6,6
62185,53,27701,53,allow,578,286,292,9,15,5,4
64323,53,38959,53,allow,190,97,93,2,31,1,1
49537,53,46669,53,allow,269,96,173,4,59,2,2
50347,53,8937,53,allow,756,95,661,2,30,1,1
56818,53,44106,53,allow,755,94,661,2,30,1,1
64900,53,55374,53,allow,778,103,675,2,30,1,1
56962,53,51903,53,allow,170,87,83,2,30,1,1
50240,53,16161,53,allow,733,93,640,2,30,1,1
55008,53,25566,53,allow,762,98,664,2,30,1,1
49972,53,21304,53,allow,184,94,90,2,30,1,1
64618,53,46697,53,allow,196,100,96,2,31,1,1
64653,53,37901,53,allow,755,93,662,2,31,1,1
64041,53,17809,53,allow,200,102,98,2,30,1,1
49687,53,24599,53,allow,775,103,672,2,31,1,1
49978,53,47119,53,allow,774,101,673,2,31,1,1
64438,53,41293,53,allow,184,94,90,2,31,1,1
49670,53,15548,53,allow,168,86,82,2,31,1,1
49539,53,44717,53,allow,170,87,83,2,31,1,1
65131,53,39663,53,allow,168,86,82,2,31,1,1
65514,53,6429,53,allow,212,108,104,2,31,1,1
57306,53,11858,53,allow,170,87,83,2,31,1,1
55049,53,52659,53,allow,733,86,647,2,31,1,1
56987,53,30832,53,allow,192,98,94,2,31,1,1
65380,53,11853,53,allow,176,90,86,2,31,1,1
49997,53,52835,53,allow,418,75,343,2,31,1,1
49290,53,15607,53,allow,760,97,663,2,31,1,1
49429,53,19123,53,allow,204,104,100,2,31,1,1
49361,53,45475,53,allow,184,94,90,2,31,1,1
56111,53,53180,53,allow,174,89,85,2,31,1,1
56765,53,13979,53,allow,188,96,92,2,31,1,1
56104,53,20610,53,allow,194,99,95,2,31,1,1
65014,53,3896,53,allow,186,95,91,2,31,1,1
65516,53,26116,53,allow,202,103,99,2,31,1,1
50460,53,61853,53,allow,753,96,657,2,31,1,1
56878,53,21554,53,allow,168,86,82,2,31,1,1
64913,53,27699,53,allow,182,93,89,2,31,1,1
57258,53,12137,53,allow,757,98,659,2,31,1,1
65063,53,62698,53,allow,176,90,86,2,31,1,1
49384,53,31275,53,allow,178,91,87,2,31,1,1
55594,53,11300,53,allow,753,96,657,2,31,1,1
65336,53,13952,53,allow,782,105,677,2,31,1,1
56332,53,13726,53,allow,202,103,99,2,31,1,1
56494,53,64995,53,allow,793,101,692,2,31,1,1
49861,53,49122,53,allow,196,100,96,2,31,1,1
55517,53,21431,53,allow,174,89,85,2,31,1,1
49785,53,38466,53,allow,206,105,101,2,31,1,1
56071,53,41864,53,allow,186,95,91,2,31,1,1
56552,53,11395,53,allow,190,97,93,2,31,1,1
57251,53,30748,53,allow,780,104,676,2,31,1,1
56477,53,34733,53,allow,198,101,97,2,31,1,1
57377,445,0,0,drop,70,70,0,1,0,1,0
57375,445,0,0,drop,70,70,0,1,0,1,0
57373,445,0,0,drop,70,70,0,1,0,1,0
52799,445,0,0,drop,66,66,0,1,0,1,0
52795,445,0,0,drop,66,66,0,1,0,1,0
52791,445,0,0,drop,66,66,0,1,0,1,0
52790,445,0,0,drop,66,66,0,1,0,1,0
52379,445,0,0,drop,70,70,0,1,0,1,0
52789,445,0,0,drop,66,66,0,1,0,1,0
52788,445,0,0,drop,66,66,0,1,0,1,0
52786,445,0,0,drop,66,66,0,1,0,1,0
56100,53,41303,53,allow,177,94,83,2,30,1,1
56705,53,17593,53,allow,168,78,90,2,30,1,1
57370,445,0,0,drop,70,70,0,1,0,1,0
57371,445,0,0,drop,70,70,0,1,0,1,0
52782,445,0,0,drop,66,66,0,1,0,1,0
57364,445,0,0,drop,70,70,0,1,0,1,0
52781,445,0,0,drop,66,66,0,1,0,1,0
52779,445,0,0,drop,66,66,0,1,0,1,0
52777,445,0,0,drop,66,66,0,1,0,1,0
52775,445,0,0,drop,66,66,0,1,0,1,0
52368,445,0,0,drop,70,70,0,1,0,1,0
64771,53,10938,53,allow,228,110,118,2,30,1,1
55147,53,9806,53,allow,184,94,90,2,30,1,1
64243,53,24679,53,allow,244,94,150,2,30,1,1
55147,53,22954,53,allow,184,94,90,2,30,1,1
49266,53,16843,53,allow,199,102,97,2,30,1,1
55599,80,22870,80,allow,1165,473,692,10,14,5,5
50393,53,2809,53,allow,759,94,665,2,29,1,1
49667,53,34670,53,allow,183,94,89,2,29,1,1
56883,53,10133,53,allow,184,94,90,2,30,1,1
49424,53,45939,53,allow,198,102,96,2,32,1,1
64613,53,15938,53,allow,179,94,85,2,30,1,1
56765,53,64406,53,allow,194,102,92,2,29,1,1
57257,53,41032,53,allow,173,94,79,2,29,1,1
49888,53,1710,53,allow,198,102,96,2,29,1,1
55077,53,32952,53,allow,179,94,85,2,29,1,1
49872,53,49872,53,allow,218,90,128,2,29,1,1
55739,53,37345,53,allow,458,188,270,6,29,3,3
55429,53,62139,53,allow,182,102,80,2,30,1,1
49817,53,35154,53,allow,286,110,176,2,30,1,1
56100,53,9631,53,allow,177,94,83,2,30,1,1
65211,53,54701,53,allow,183,94,89,2,30,1,1
64685,53,15480,53,allow,199,102,97,2,30,1,1
56335,53,48756,53,allow,816,102,714,2,30,1,1
49972,53,40776,53,allow,184,94,90,2,30,1,1
56987,53,21347,53,allow,196,102,94,2,30,1,1
64093,53,8656,53,allow,225,110,115,2,30,1,1
64715,53,47413,53,allow,209,110,99,2,30,1,1
57252,53,53751,53,allow,183,94,89,2,30,1,1
49539,53,50465,53,allow,177,94,83,2,30,1,1
49167,53,55909,53,allow,193,102,91,2,30,1,1
64643,53,40117,53,allow,177,94,83,2,30,1,1
50575,53,5901,53,allow,766,102,664,2,30,1,1
65246,53,37552,53,allow,183,94,89,2,30,1,1
56456,53,8981,53,allow,195,102,93,2,30,1,1
56456,53,17169,53,allow,195,102,93,2,30,1,1
64685,53,31549,53,allow,199,102,97,2,30,1,1
64585,53,51194,53,allow,210,110,100,2,30,1,1
64874,53,28911,53,allow,808,110,698,2,30,1,1
49433,53,41471,53,allow,165,86,79,2,30,1,1
55918,53,24727,53,allow,184,94,90,2,30,1,1
56223,53,26337,53,allow,177,94,83,2,30,1,1
65249,53,5221,53,allow,166,86,80,2,30,1,1
55429,53,31053,53,allow,182,102,80,2,30,1,1
64585,53,55669,53,allow,210,110,100,2,30,1,1
64417,53,47310,53,allow,369,94,275,4,49,2,2
49968,53,46436,53,allow,285,94,191,2,30,1,1
64715,53,35107,53,allow,209,110,99,2,30,1,1
64831,53,56461,53,allow,216,110,106,2,30,1,1
56335,53,52497,53,allow,193,102,91,2,30,1,1
49622,53,47185,53,allow,185,102,83,2,30,1,1
49537,53,59309,53,allow,269,96,173,4,59,2,2
50648,80,55586,80,allow,132,132,0,2,8,2,0
49851,53,3240,53,allow,166,86,80,2,30,1,1
56649,53,35726,53,allow,152,78,74,2,30,1,1
42358,80,63133,80,allow,1081,641,440,9,14,4,5
56919,53,23059,53,allow,423,95,328,4,34,2,2
64700,53,51210,53,allow,458,188,270,6,29,3,3
64595,53,24899,53,allow,167,86,81,2,29,1,1
64732,53,44138,53,allow,189,102,87,2,29,1,1
49888,53,17695,53,allow,198,102,96,2,29,1,1
49217,53,20500,53,allow,209,110,99,2,29,1,1
56919,53,16423,53,allow,193,102,91,2,29,1,1
64936,53,18480,53,allow,749,94,655,2,29,1,1
49365,53,27288,53,allow,195,102,93,2,29,1,1
55147,53,48564,53,allow,184,94,90,2,30,1,1
64552,53,41507,53,allow,754,94,660,2,30,1,1
49530,53,54763,53,allow,265,102,163,2,30,1,1
49622,53,45379,53,allow,185,102,83,2,30,1,1
56557,53,49880,53,allow,214,110,104,2,29,1,1
49399,53,15486,53,allow,775,102,673,2,30,1,1
65211,53,44478,53,allow,183,94,89,2,30,1,1
49901,53,39046,53,allow,193,102,91,2,29,1,1
64595,53,55733,53,allow,167,86,81,2,30,1,1
64311,53,39516,53,allow,199,102,97,2,30,1,1
56111,53,49193,53,allow,179,94,85,2,31,1,1
64403,53,2532,53,allow,199,102,97,2,31,1,1
56552,53,3851,53,allow,195,102,93,2,31,1,1
49167,53,5532,53,allow,816,102,714,2,30,1,1
56121,53,17284,53,allow,207,86,121,2,30,1,1
56552,53,34046,53,allow,195,102,93,2,30,1,1
55461,53,35895,53,allow,198,110,88,2,30,1,1
49917,53,18720,53,allow,209,110,99,2,30,1,1
55918,53,15262,53,allow,184,94,90,2,31,1,1
56026,53,28063,53,allow,183,94,89,2,30,1,1
57252,53,53666,53,allow,183,94,89,2,30,1,1
49433,53,27774,53,allow,173,94,79,2,30,1,1
56104,53,22926,53,allow,197,102,95,2,30,1,1
49860,53,63227,53,allow,184,102,82,2,30,1,1
64026,53,1792,53,allow,211,102,109,2,30,1,1
43693,53,25103,53,allow,164,78,86,2,30,1,1
56649,53,31076,53,allow,168,94,74,2,30,1,1
57252,53,37679,53,allow,183,94,89,2,30,1,1
55512,53,3521,53,allow,458,188,270,6,30,3,3
56809,53,37761,53,allow,178,94,84,2,30,1,1
64311,53,19538,53,allow,199,102,97,2,30,1,1
64585,53,40349,53,allow,210,110,100,2,30,1,1
56246,53,30677,53,allow,209,110,99,2,30,1,1
65359,53,28420,53,allow,193,102,91,2,30,1,1
65249,53,21680,53,allow,182,102,80,2,30,1,1
65529,53,50654,53,allow,821,102,719,2,30,1,1
64715,53,61600,53,allow,209,110,99,2,30,1,1
56227,53,28291,53,allow,179,94,85,2,30,1,1
64913,53,27503,53,allow,183,94,89,2,30,1,1
49183,53,29477,53,allow,209,110,99,2,30,1,1
65420,53,11720,53,allow,166,86,80,2,30,1,1
64643,53,62127,53,allow,177,94,83,2,30,1,1
56557,53,47692,53,allow,214,110,104,2,30,1,1
64287,53,53632,53,allow,181,94,87,2,30,1,1
56004,53,34719,53,allow,177,94,83,2,30,1,1
57152,53,2032,53,allow,183,94,89,2,30,1,1
56126,53,43934,53,allow,183,94,89,2,30,1,1
56126,53,32815,53,allow,183,94,89,2,30,1,1
49696,53,30519,53,allow,178,94,84,2,30,1,1
56609,53,37814,53,allow,199,102,97,2,30,1,1
56987,53,59227,53,allow,196,102,94,2,30,1,1
65516,53,16518,53,allow,209,110,99,2,31,1,1
57306,53,15056,53,allow,177,94,83,2,31,1,1
55688,53,48185,53,allow,183,94,89,2,31,1,1
57007,53,19153,53,allow,183,94,89,2,31,1,1
64618,53,21647,53,allow,198,102,96,2,30,1,1
56104,53,63968,53,allow,197,102,95,2,30,1,1
64438,53,59049,53,allow,184,94,90,2,30,1,1
56111,53,45505,53,allow,179,94,85,2,30,1,1
55467,53,34377,53,allow,193,102,91,2,30,1,1
56883,53,20999,53,allow,184,94,90,2,30,1,1
56071,53,13568,53,allow,193,102,91,2,30,1,1
49361,53,51044,53,allow,184,94,90,2,31,1,1
55517,53,14797,53,allow,179,94,85,2,31,1,1
56332,53,1947,53,allow,209,110,99,2,31,1,1
65469,53,29881,53,allow,195,102,93,2,31,1,1
54990,53,46533,53,allow,166,86,80,2,31,1,1
64618,53,55916,53,allow,198,102,96,2,31,1,1
57172,53,10868,53,allow,196,102,94,2,31,1,1
49174,53,1263,53,allow,166,86,80,2,31,1,1
64041,53,11407,53,allow,200,102,98,2,31,1,1
56071,53,32735,53,allow,193,102,91,2,31,1,1
56601,53,16656,53,allow,239,94,145,2,31,1,1
56033,53,58148,53,allow,213,102,111,2,31,1,1
49861,53,27236,53,allow,198,102,96,2,31,1,1
50326,53,27014,53,allow,720,94,626,2,31,1,1
65359,53,19133,53,allow,193,102,91,2,31,1,1
55461,53,48907,53,allow,198,110,88,2,31,1,1
49384,53,17338,53,allow,181,94,87,2,31,1,1
55857,53,56112,53,allow,199,102,97,2,31,1,1
49901,53,59612,53,allow,193,102,91,2,31,1,1
56783,53,24430,53,allow,199,102,97,2,31,1,1
64831,53,30238,53,allow,216,110,106,2,31,1,1
49860,53,48565,53,allow,168,86,82,2,31,1,1
57172,53,34011,53,allow,196,102,94,2,31,1,1
49972,53,6023,53,allow,314,94,220,4,31,2,2
55688,53,29682,53,allow,183,94,89,2,31,1,1
53237,443,53237,443,allow,1210,637,573,14,34,7,7
46167,80,10521,80,allow,78,78,0,1,5,1,0
57007,53,36349,53,allow,183,94,89,2,31,1,1
64403,53,9122,53,allow,199,102,97,2,31,1,1
49537,53,25046,53,allow,269,96,173,4,59,2,2
43357,443,59688,443,allow,1053,566,487,10,15,6,4
53236,443,53236,443,allow,1210,637,573,14,34,7,7
65131,53,4831,53,allow,168,86,82,2,30,1,1
57353,445,0,0,drop,70,70,0,1,0,1,0
57349,445,0,0,drop,70,70,0,1,0,1,0
52766,445,0,0,drop,66,66,0,1,0,1,0
52355,445,0,0,drop,70,70,0,1,0,1,0
52757,445,0,0,drop,66,66,0,1,0,1,0
57336,445,0,0,drop,70,70,0,1,0,1,0
52755,445,0,0,drop,66,66,0,1,0,1,0
52747,445,0,0,drop,66,66,0,1,0,1,0
52346,445,0,0,drop,70,70,0,1,0,1,0
52740,445,0,0,drop,66,66,0,1,0,1,0
52344,445,0,0,drop,70,70,0,1,0,1,0
53777,443,29327,443,allow,495,421,74,4,0,3,1
53769,443,28627,443,allow,499,425,74,4,0,3,1
57329,445,0,0,drop,70,70,0,1,0,1,0
52732,445,0,0,drop,66,66,0,1,0,1,0
52731,445,0,0,drop,66,66,0,1,0,1,0
52730,445,0,0,drop,66,66,0,1,0,1,0
52726,445,0,0,drop,66,66,0,1,0,1,0
52724,445,0,0,drop,66,66,0,1,0,1,0
52729,445,0,0,drop,66,66,0,1,0,1,0
52725,445,0,0,drop,66,66,0,1,0,1,0
52727,445,0,0,drop,66,66,0,1,0,1,0
52337,445,0,0,drop,70,70,0,1,0,1,0
52335,445,0,0,drop,70,70,0,1,0,1,0
52333,445,0,0,drop,70,70,0,1,0,1,0
52330,445,0,0,drop,70,70,0,1,0,1,0
52328,445,0,0,drop,70,70,0,1,0,1,0
57321,445,0,0,drop,70,70,0,1,0,1,0
57319,445,0,0,drop,70,70,0,1,0,1,0
57317,445,0,0,drop,70,70,0,1,0,1,0
52709,445,0,0,drop,66,66,0,1,0,1,0
52710,445,0,0,drop,66,66,0,1,0,1,0
52712,445,0,0,drop,66,66,0,1,0,1,0
52314,445,0,0,drop,70,70,0,1,0,1,0
52309,445,0,0,drop,70,70,0,1,0,1,0
57306,445,0,0,drop,70,70,0,1,0,1,0
52303,445,0,0,drop,70,70,0,1,0,1,0
52304,445,0,0,drop,70,70,0,1,0,1,0
57304,445,0,0,drop,70,70,0,1,0,1,0
57301,445,0,0,drop,70,70,0,1,0,1,0
57294,445,0,0,drop,70,70,0,1,0,1,0
57293,445,0,0,drop,70,70,0,1,0,1,0
43235,23,0,0,deny,60,60,0,1,0,1,0
57284,445,0,0,drop,70,70,0,1,0,1,0
57281,445,0,0,drop,70,70,0,1,0,1,0
52288,445,0,0,drop,70,70,0,1,0,1,0
52277,445,0,0,drop,70,70,0,1,0,1,0
52275,445,0,0,drop,70,70,0,1,0,1,0
52273,445,0,0,drop,70,70,0,1,0,1,0
52271,445,0,0,drop,70,70,0,1,0,1,0
52690,445,0,0,drop,66,66,0,1,0,1,0
57278,445,0,0,drop,70,70,0,1,0,1,0
52683,445,0,0,drop,66,66,0,1,0,1,0
64252,53,36702,53,allow,198,101,97,2,31,1,1
49696,53,54642,53,allow,172,88,84,2,30,1,1
64403,53,60359,53,allow,198,101,97,2,30,1,1
50930,443,54294,443,allow,134,60,74,3,10,2,1
49945,53,48312,53,allow,281,97,184,4,58,2,2
56750,53,47077,53,allow,711,87,624,2,30,1,1
49175,53,59846,53,allow,186,95,91,2,30,1,1
65469,53,59478,53,allow,190,97,93,2,30,1,1
65498,53,36093,53,allow,202,103,99,2,31,1,1
57010,53,20752,53,allow,198,101,97,2,30,1,1
55353,53,50744,53,allow,168,86,82,2,30,1,1
53229,443,53229,443,allow,1402,856,546,12,34,6,6
53232,443,53232,443,allow,1270,697,573,15,33,8,7
40103,443,24820,443,allow,161,101,60,2,5,1,1
55467,53,15072,53,allow,186,95,91,2,30,1,1
55670,53,52397,53,allow,774,101,673,2,30,1,1
65357,53,15221,53,allow,176,90,86,2,30,1,1
65231,53,23789,53,allow,200,102,98,2,31,1,1
57007,53,22184,53,allow,182,93,89,2,31,1,1
53234,443,53234,443,allow,1276,703,573,15,33,8,7
65258,53,4624,53,allow,186,95,91,2,31,1,1
56918,53,41255,53,allow,778,103,675,2,30,1,1
65131,53,35643,53,allow,168,86,82,2,30,1,1
56883,53,62227,53,allow,184,94,90,2,30,1,1
49676,53,36174,53,allow,733,86,647,2,30,1,1
56425,53,17413,53,allow,760,97,663,2,30,1,1
55688,53,32958,53,allow,182,93,89,2,30,1,1
49229,53,8820,53,allow,88,88,0,1,31,1,0
57416,53,62592,53,allow,186,95,91,2,31,1,1
49486,53,33759,53,allow,170,87,83,2,31,1,1
65040,53,62726,53,allow,176,90,86,2,31,1,1
50604,53,2592,53,allow,752,93,659,2,31,1,1
64885,53,64870,53,allow,753,93,660,2,31,1,1
65048,53,26939,53,allow,188,96,92,2,31,1,1
55634,53,60487,53,allow,204,104,100,2,31,1,1
64216,53,11505,53,allow,182,93,89,2,30,1,1
57172,53,55364,53,allow,192,98,94,2,31,1,1
55796,53,45006,53,allow,192,98,94,2,31,1,1
49777,53,59395,53,allow,164,84,80,2,31,1,1
64986,53,47302,53,allow,176,90,86,2,31,1,1
55705,53,57706,53,allow,202,103,99,2,31,1,1
56802,53,9464,53,allow,753,93,660,2,31,1,1
49917,53,47966,53,allow,752,93,659,2,31,1,1
49369,53,3787,53,allow,182,93,89,2,31,1,1
65179,53,5745,53,allow,184,94,90,2,31,1,1
56901,53,23977,53,allow,710,89,621,2,31,1,1
56167,53,36482,53,allow,172,88,84,2,31,1,1
57139,53,1323,53,allow,164,84,80,2,31,1,1
49983,53,22293,53,allow,206,105,101,2,31,1,1
65424,53,25204,53,allow,204,104,100,2,31,1,1
55743,53,6640,53,allow,748,106,642,2,31,1,1
64949,53,23952,53,allow,208,106,102,2,31,1,1
52680,445,0,0,drop,66,66,0,1,0,1,0
57266,445,0,0,drop,70,70,0,1,0,1,0
57262,445,0,0,drop,70,70,0,1,0,1,0
57255,445,0,0,drop,70,70,0,1,0,1,0
50166,53,40117,53,allow,211,78,133,2,30,1,1
50583,53,37919,53,allow,819,102,717,2,30,1,1
56878,53,41614,53,allow,168,86,82,2,30,1,1
49429,53,36318,53,allow,210,110,100,2,30,1,1
56445,53,29245,53,allow,199,102,97,2,30,1,1
56354,53,51631,53,allow,200,94,106,2,30,1,1
53230,443,53230,443,allow,1462,916,546,13,34,7,6
53235,443,53235,443,allow,1270,697,573,15,33,8,7
37109,80,41807,80,allow,763,434,329,8,14,5,3
51413,443,36557,443,allow,202,70,132,3,11,1,2
65529,53,6825,53,allow,198,102,96,2,29,1,1
49670,53,58566,53,allow,168,86,82,2,29,1,1
59882,53,29947,53,allow,244,86,158,2,29,1,1
65131,53,1840,53,allow,168,86,82,2,29,1,1
57152,53,61515,53,allow,183,94,89,2,29,1,1
57306,53,25248,53,allow,177,94,83,2,29,1,1
52957,53,50377,53,allow,168,78,90,2,29,1,1
55215,53,18031,53,allow,315,126,189,2,29,1,1
56441,53,35817,53,allow,209,110,99,2,29,1,1
64041,53,24835,53,allow,200,102,98,2,29,1,1
44603,53,44603,53,allow,229,98,131,2,29,1,1
55688,53,38445,53,allow,183,94,89,2,29,1,1
49266,53,6643,53,allow,199,102,97,2,29,1,1
49917,53,29420,53,allow,209,110,99,2,29,1,1
65488,53,4906,53,allow,232,110,122,2,29,1,1
56004,53,27325,53,allow,177,94,83,2,29,1,1
55857,53,40207,53,allow,199,102,97,2,29,1,1
49439,53,40925,53,allow,197,102,95,2,30,1,1
64011,53,63004,53,allow,228,110,118,2,29,1,1
55346,53,11251,53,allow,396,102,294,2,30,1,1
49945,53,50921,53,allow,281,97,184,4,58,2,2
58053,25,49850,25,allow,1316,442,874,15,16,7,8
65504,53,33205,53,allow,193,102,91,2,30,1,1
56332,53,27865,53,allow,209,110,99,2,30,1,1
49730,53,24529,53,allow,211,110,101,2,30,1,1
50238,53,50499,53,allow,438,180,258,6,30,3,3
56987,53,64863,53,allow,196,102,94,2,30,1,1
65063,53,50094,53,allow,180,94,86,2,30,1,1
57077,53,61276,53,allow,166,86,80,2,30,1,1
57010,53,26340,53,allow,199,102,97,2,30,1,1
57306,53,20608,53,allow,573,186,387,6,71,3,3
56477,53,13759,53,allow,199,102,97,2,30,1,1
65380,53,10002,53,allow,180,94,86,2,30,1,1
56144,53,15210,53,allow,177,94,83,2,30,1,1
49539,53,64502,53,allow,340,87,253,4,50,2,2
56783,53,42766,53,allow,199,102,97,2,30,1,1
65357,53,23805,53,allow,180,94,86,2,30,1,1
49968,53,43611,53,allow,751,94,657,2,30,1,1
37889,53,32762,53,allow,199,94,105,2,30,1,1
57331,53,38724,53,allow,166,86,80,2,30,1,1
50583,53,45479,53,allow,196,102,94,2,30,1,1
55502,53,15110,53,allow,194,102,92,2,30,1,1
65014,53,57511,53,allow,193,102,91,2,30,1,1
65380,53,23186,53,allow,180,94,86,2,30,1,1
57010,53,46777,53,allow,199,102,97,2,30,1,1
56357,53,47293,53,allow,196,102,94,2,30,1,1
65516,53,21286,53,allow,209,110,99,2,30,1,1
65063,53,22032,53,allow,180,94,86,2,30,1,1
49486,53,9984,53,allow,177,94,83,2,30,1,1
42936,53,47625,53,allow,199,94,105,2,30,1,1
56006,53,47168,53,allow,210,102,108,2,30,1,1
55353,53,65240,53,allow,168,86,82,2,30,1,1
55705,53,14171,53,allow,209,110,99,2,30,1,1
56477,53,54398,53,allow,199,102,97,2,30,1,1
49384,53,27649,53,allow,181,94,87,2,30,1,1
51411,443,11555,443,allow,202,70,132,3,11,1,2
64913,53,26175,53,allow,555,195,360,6,62,3,3
57010,53,64390,53,allow,199,102,97,2,30,1,1
65417,53,53892,53,allow,183,94,89,2,30,1,1
54984,53,62420,53,allow,994,86,908,2,30,1,1
49439,53,11369,53,allow,197,102,95,2,30,1,1
59614,53,24145,53,allow,417,78,339,2,30,1,1
56899,53,4081,53,allow,258,102,156,2,30,1,1
56375,53,53548,53,allow,184,102,82,2,30,1,1
55057,53,28179,53,allow,889,404,485,10,30,5,5
65231,53,56850,53,allow,200,102,98,2,30,1,1
49478,53,32475,53,allow,551,114,437,4,37,2,2
65295,53,41511,53,allow,944,205,739,6,45,3,3
49730,53,46996,53,allow,211,110,101,2,30,1,1
55722,53,19688,53,allow,226,110,116,2,30,1,1
41780,53,0,0,allow,86,86,0,1,30,1,0
65131,53,31647,53,allow,168,86,82,2,30,1,1
49183,53,46145,53,allow,817,102,715,2,30,1,1
55502,53,12440,53,allow,817,102,715,2,30,1,1
64913,53,45899,53,allow,183,94,89,2,30,1,1
49885,53,57862,53,allow,786,110,676,2,30,1,1
57416,53,21354,53,allow,193,102,91,2,30,1,1
55706,53,9851,53,allow,258,102,156,2,30,1,1
49638,53,6600,53,allow,210,110,100,2,30,1,1
49638,53,20349,53,allow,210,110,100,2,30,1,1
65014,53,36571,53,allow,193,102,91,2,30,1,1
50017,53,65009,53,allow,741,94,647,2,30,1,1
35866,80,8550,80,allow,1114,534,580,12,15,7,5
56614,80,65163,80,allow,234,234,0,4,11,4,0
53231,443,53231,443,allow,1402,856,546,12,34,6,6
64287,53,8913,53,allow,280,91,189,4,33,2,2
55467,53,6293,53,allow,320,95,225,4,41,2,2
64618,53,41913,53,allow,305,100,205,4,54,2,2
49235,53,43539,53,allow,164,78,86,2,29,1,1
56441,53,4935,53,allow,209,110,99,2,29,1,1
56883,53,30894,53,allow,184,94,90,2,29,1,1
50006,53,41506,53,allow,994,86,908,2,29,1,1
64323,53,18965,53,allow,195,102,93,2,30,1,1
55467,53,17631,53,allow,193,102,91,2,29,1,1
65514,53,14703,53,allow,214,110,104,2,29,1,1
65056,53,34239,53,allow,199,102,97,2,29,1,1
55517,53,26427,53,allow,179,94,85,2,29,1,1
54990,53,62190,53,allow,166,86,80,2,29,1,1
65056,53,26315,53,allow,199,102,97,2,29,1,1
49429,53,17254,53,allow,210,110,100,2,29,1,1
64311,53,4229,53,allow,199,102,97,2,29,1,1
49539,53,25645,53,allow,177,94,83,2,30,1,1
65131,53,44924,53,allow,168,86,82,2,30,1,1
49851,53,9637,53,allow,166,86,80,2,29,1,1
49183,53,53469,53,allow,194,102,92,2,30,1,1
55634,53,8065,53,allow,210,110,100,2,30,1,1
42151,53,3505,53,allow,168,78,90,2,30,1,1
49341,53,47990,53,allow,199,102,97,2,31,1,1
56375,53,4600,53,allow,184,102,82,2,30,1,1
49785,53,52317,53,allow,211,110,101,2,30,1,1
65380,53,28417,53,allow,180,94,86,2,30,1,1
56963,53,26493,53,allow,210,110,100,2,30,1,1
55796,53,36094,53,allow,196,102,94,2,30,1,1
56111,53,5335,53,allow,179,94,85,2,30,1,1
65258,53,48935,53,allow,193,102,91,2,30,1,1
54031,53,23447,53,allow,168,78,90,2,30,1,1
64739,53,35789,53,allow,164,86,78,2,31,1,1
56477,53,18413,53,allow,386,101,285,4,31,2,2
64831,53,42481,53,allow,216,110,106,2,30,1,1
64403,53,16361,53,allow,783,197,586,6,70,3,3
65014,53,29342,53,allow,193,102,91,2,30,1,1
65063,53,52560,53,allow,180,94,86,2,30,1,1
49785,53,47696,53,allow,211,110,101,2,30,1,1
65359,53,55689,53,allow,193,102,91,2,30,1,1
56104,53,24374,53,allow,197,102,95,2,30,1,1
64216,53,1409,53,allow,183,94,89,2,30,1,1
49229,53,18433,53,allow,178,94,84,2,31,1,1
49361,53,25462,53,allow,184,94,90,2,30,1,1
49812,53,36103,53,allow,1411,98,1313,4,52,2,2
65504,53,23026,53,allow,193,102,91,2,30,1,1
65417,53,31307,53,allow,183,94,89,2,30,1,1
60601,53,19741,53,allow,451,86,365,2,30,1,1
56144,53,34369,53,allow,177,94,83,2,30,1,1
64121,53,21027,53,allow,365,102,263,2,31,1,1
49361,53,49782,53,allow,166,86,80,2,30,1,1
64323,53,64062,53,allow,195,102,93,2,30,1,1
56357,53,43441,53,allow,819,102,717,2,30,1,1
49175,53,18016,53,allow,193,102,91,2,30,1,1
59645,53,23128,53,allow,263,94,169,2,30,1,1
64438,53,4120,53,allow,184,94,90,2,30,1,1
56332,53,16709,53,allow,209,110,99,2,30,1,1
65514,53,43311,53,allow,214,110,104,2,30,1,1
64216,53,16244,53,allow,183,94,89,2,30,1,1
55353,53,1525,53,allow,168,86,82,2,30,1,1
56605,53,38242,53,allow,341,110,231,2,30,1,1
64252,53,2072,53,allow,199,102,97,2,30,1,1
65258,53,25267,53,allow,193,102,91,2,30,1,1
65469,53,49560,53,allow,195,102,93,2,30,1,1
64235,53,40648,53,allow,197,102,95,2,30,1,1
56963,53,63248,53,allow,210,110,100,2,30,1,1
49983,53,2734,53,allow,211,110,101,2,30,1,1
65448,53,6069,53,allow,264,110,154,2,30,1,1
65498,53,57439,53,allow,209,110,99,2,30,1,1
64216,53,45002,53,allow,295,93,202,4,30,2,2
65040,53,10817,53,allow,180,94,86,2,31,1,1
56326,53,47935,53,allow,177,94,83,2,31,1,1
49670,53,59914,53,allow,168,86,82,2,31,1,1
49732,53,17684,53,allow,178,94,84,2,30,1,1
64986,53,8227,53,allow,180,94,86,2,30,1,1
55958,53,25725,53,allow,209,102,107,2,30,1,1
56765,53,52447,53,allow,194,102,92,2,30,1,1
64254,53,19864,53,allow,197,94,103,2,30,1,1
65498,53,39980,53,allow,209,110,99,2,30,1,1
65424,53,39053,53,allow,210,110,100,2,31,1,1
56953,53,15670,53,allow,421,78,343,2,31,1,1
49486,53,40876,53,allow,177,94,83,2,31,1,1
65514,53,32610,53,allow,214,110,104,2,31,1,1
57172,53,27478,53,allow,196,102,94,2,31,1,1
65498,53,26410,53,allow,209,110,99,2,30,1,1
49785,53,63638,53,allow,211,110,101,2,30,1,1
49777,53,14014,53,allow,166,86,80,2,30,1,1
49429,53,19279,53,allow,210,110,100,2,30,1,1
55796,53,53720,53,allow,196,102,94,2,30,1,1
55975,53,28209,53,allow,195,102,93,2,30,1,1
57007,53,62995,53,allow,183,94,89,2,31,1,1
49670,53,37029,53,allow,168,86,82,2,30,1,1
64420,53,18764,53,allow,386,102,284,2,30,1,1
49831,53,24463,53,allow,364,102,262,2,30,1,1
65024,53,10602,53,allow,196,94,102,2,30,1,1
49696,53,9591,53,allow,178,94,84,2,30,1,1
49862,53,52956,53,allow,715,94,621,2,31,1,1
49861,53,56690,53,allow,198,102,96,2,31,1,1
55975,53,44915,53,allow,195,102,93,2,31,1,1
64677,53,13173,53,allow,195,102,93,2,31,1,1
49175,53,45258,53,allow,193,102,91,2,31,1,1
55286,53,22334,53,allow,194,102,92,2,31,1,1
64517,53,18639,53,allow,194,102,92,2,31,1,1
65231,53,37315,53,allow,200,102,98,2,31,1,1
49696,53,25941,53,allow,178,94,84,2,31,1,1
49478,53,58294,53,allow,164,86,78,2,31,1,1
56445,53,26251,53,allow,199,102,97,2,30,1,1
49861,53,42147,53,allow,198,102,96,2,30,1,1
49486,53,16915,53,allow,177,94,83,2,30,1,1
49369,53,54778,53,allow,183,94,89,2,30,1,1
64531,53,60188,53,allow,183,94,89,2,30,1,1
49983,53,17295,53,allow,211,110,101,2,31,1,1
65258,53,31384,53,allow,193,102,91,2,31,1,1
55796,53,15761,53,allow,196,102,94,2,31,1,1
64873,53,31946,53,allow,195,94,101,2,31,1,1
50022,53,5739,53,allow,179,94,85,2,31,1,1
49777,53,45833,53,allow,166,86,80,2,31,1,1
64408,53,9592,53,allow,257,126,131,2,31,1,1
64949,53,48447,53,allow,212,110,102,2,31,1,1
55353,53,50896,53,allow,311,86,225,4,55,2,2
57267,443,26309,443,allow,126,60,66,3,6,2,1
52678,445,0,0,drop,66,66,0,1,0,1,0
52258,445,0,0,drop,70,70,0,1,0,1,0
52257,445,0,0,drop,70,70,0,1,0,1,0
57249,445,0,0,drop,70,70,0,1,0,1,0
57248,445,0,0,drop,70,70,0,1,0,1,0
57246,445,0,0,drop,70,70,0,1,0,1,0
52251,445,0,0,drop,70,70,0,1,0,1,0
52671,445,0,0,drop,66,66,0,1,0,1,0
52250,445,0,0,drop,70,70,0,1,0,1,0
52665,445,0,0,drop,66,66,0,1,0,1,0
52666,445,0,0,drop,66,66,0,1,0,1,0
52664,445,0,0,drop,66,66,0,1,0,1,0
52660,445,0,0,drop,66,66,0,1,0,1,0
52661,445,0,0,drop,66,66,0,1,0,1,0
52658,445,0,0,drop,66,66,0,1,0,1,0
52246,445,0,0,drop,70,70,0,1,0,1,0
52245,445,0,0,drop,70,70,0,1,0,1,0
57244,445,0,0,drop,70,70,0,1,0,1,0
57241,445,0,0,drop,70,70,0,1,0,1,0
57240,445,0,0,drop,70,70,0,1,0,1,0
52657,445,0,0,drop,66,66,0,1,0,1,0
57236,445,0,0,drop,70,70,0,1,0,1,0
52652,445,0,0,drop,66,66,0,1,0,1,0
52651,445,0,0,drop,66,66,0,1,0,1,0
53772,443,49684,443,allow,499,425,74,4,0,3,1
53770,443,15341,443,allow,499,425,74,4,0,3,1
53768,443,3588,443,allow,499,425,74,4,0,3,1
53755,443,8268,443,allow,499,425,74,4,0,3,1
53771,443,40823,443,allow,499,425,74,4,0,3,1
53760,443,44529,443,allow,499,425,74,4,0,3,1
53765,443,33408,443,allow,499,425,74,4,0,3,1
53759,443,57982,443,allow,499,425,74,4,0,3,1
53763,443,53593,443,allow,499,425,74,4,0,3,1
53773,443,19967,443,allow,499,425,74,4,0,3,1
53766,443,46858,443,allow,499,425,74,4,0,3,1
53774,443,4137,443,allow,499,425,74,4,0,3,1
53761,443,39818,443,allow,499,425,74,4,0,3,1
53762,443,60750,443,allow,499,425,74,4,0,3,1
53750,443,4212,443,allow,499,425,74,4,0,3,1
53757,443,15611,443,allow,499,425,74,4,0,3,1
53767,443,6984,443,allow,499,425,74,4,0,3,1
53764,443,56074,443,allow,499,425,74,4,0,3,1
53752,443,21616,443,allow,499,425,74,4,0,3,1
53753,443,5988,443,allow,499,425,74,4,0,3,1
53758,443,30147,443,allow,499,425,74,4,0,3,1
53754,443,24588,443,allow,499,425,74,4,0,3,1
53756,443,48419,443,allow,499,425,74,4,0,3,1
53751,443,44095,443,allow,499,425,74,4,0,3,1
52649,445,0,0,drop,66,66,0,1,0,1,0
52647,445,0,0,drop,66,66,0,1,0,1,0
57232,445,0,0,drop,70,70,0,1,0,1,0
57225,445,0,0,drop,70,70,0,1,0,1,0
57224,445,0,0,drop,70,70,0,1,0,1,0
52638,445,0,0,drop,66,66,0,1,0,1,0
52227,445,0,0,drop,70,70,0,1,0,1,0
52224,445,0,0,drop,70,70,0,1,0,1,0
52629,445,0,0,drop,66,66,0,1,0,1,0
57210,445,0,0,drop,70,70,0,1,0,1,0
52626,445,0,0,drop,66,66,0,1,0,1,0
52218,445,0,0,drop,70,70,0,1,0,1,0
52618,445,0,0,drop,66,66,0,1,0,1,0
52216,445,0,0,drop,70,70,0,1,0,1,0
52615,445,0,0,drop,66,66,0,1,0,1,0
52209,445,0,0,drop,70,70,0,1,0,1,0
57199,445,0,0,drop,70,70,0,1,0,1,0
52596,445,0,0,drop,66,66,0,1,0,1,0
52600,445,0,0,drop,66,66,0,1,0,1,0
52603,445,0,0,drop,66,66,0,1,0,1,0
52602,445,0,0,drop,66,66,0,1,0,1,0
52598,445,0,0,drop,66,66,0,1,0,1,0
52601,445,0,0,drop,66,66,0,1,0,1,0
52604,445,0,0,drop,66,66,0,1,0,1,0
52599,445,0,0,drop,66,66,0,1,0,1,0
52207,445,0,0,drop,70,70,0,1,0,1,0
52205,445,0,0,drop,70,70,0,1,0,1,0
52200,445,0,0,drop,70,70,0,1,0,1,0
52201,445,0,0,drop,70,70,0,1,0,1,0
57194,445,0,0,drop,70,70,0,1,0,1,0
57189,445,0,0,drop,70,70,0,1,0,1,0
57181,445,0,0,drop,70,70,0,1,0,1,0
52186,445,0,0,drop,70,70,0,1,0,1,0
52185,445,0,0,drop,70,70,0,1,0,1,0
52583,445,0,0,drop,66,66,0,1,0,1,0
52584,445,0,0,drop,66,66,0,1,0,1,0
52582,445,0,0,drop,66,66,0,1,0,1,0
52175,445,0,0,drop,70,70,0,1,0,1,0
57179,445,0,0,drop,70,70,0,1,0,1,0
57176,445,0,0,drop,70,70,0,1,0,1,0
57164,445,0,0,drop,70,70,0,1,0,1,0
57168,445,0,0,drop,70,70,0,1,0,1,0
57167,445,0,0,drop,70,70,0,1,0,1,0
57156,445,0,0,drop,70,70,0,1,0,1,0
57153,445,0,0,drop,70,70,0,1,0,1,0
52160,445,0,0,drop,70,70,0,1,0,1,0
52150,445,0,0,drop,70,70,0,1,0,1,0
52151,445,0,0,drop,70,70,0,1,0,1,0
52146,445,0,0,drop,70,70,0,1,0,1,0
52147,445,0,0,drop,70,70,0,1,0,1,0
52144,445,0,0,drop,70,70,0,1,0,1,0
56445,53,52720,53,allow,198,101,97,2,30,1,1
49341,53,42621,53,allow,198,101,97,2,30,1,1
50022,53,39220,53,allow,174,89,85,2,30,1,1
49332,53,40502,53,allow,281,98,183,4,57,2,2
55046,80,55074,80,allow,1056,682,374,10,16,6,4
65115,53,24765,53,allow,186,95,91,2,30,1,1
55975,53,65159,53,allow,190,97,93,2,30,1,1
56326,53,54656,53,allow,170,87,83,2,30,1,1
56830,53,35063,53,allow,752,93,659,2,30,1,1
49699,53,40136,53,allow,266,89,177,4,58,2,2
49643,443,30041,443,allow,1640,1089,551,14,15,8,6
55286,53,55062,53,allow,188,96,92,2,30,1,1
64235,53,36798,53,allow,194,99,95,2,30,1,1
64850,53,42650,53,allow,192,98,94,2,31,1,1
59829,443,18743,443,allow,182,60,122,4,26,2,2
56773,53,6473,53,allow,735,88,647,2,30,1,1
56868,53,63238,53,allow,752,93,659,2,30,1,1
64531,53,46731,53,allow,182,93,89,2,30,1,1
63943,53,51755,53,allow,274,90,184,4,56,2,2
50069,53,5416,53,allow,174,89,85,2,30,1,1
65451,53,43825,53,allow,172,88,84,2,31,1,1
64997,53,9569,53,allow,164,84,80,2,31,1,1
64517,53,41007,53,allow,188,96,92,2,31,1,1
64677,53,35002,53,allow,190,97,93,2,31,1,1
56744,53,44320,53,allow,740,93,647,2,31,1,1
56066,53,46856,53,allow,208,106,102,2,30,1,1
49635,53,55370,53,allow,204,104,100,2,30,1,1
54998,53,35657,53,allow,174,89,85,2,31,1,1
49297,53,13905,53,allow,182,93,89,2,31,1,1
64914,53,32177,53,allow,168,86,82,2,31,1,1
56320,53,39261,53,allow,182,93,89,2,31,1,1
64546,53,12738,53,allow,182,93,89,2,31,1,1
64608,53,13914,53,allow,208,106,102,2,31,1,1
57102,53,62083,53,allow,761,100,661,2,31,1,1
64689,53,18910,53,allow,182,93,89,2,31,1,1
64982,53,19403,53,allow,190,97,93,2,31,1,1
65098,53,21613,53,allow,740,93,647,2,31,1,1
65371,53,39965,53,allow,198,101,97,2,31,1,1
64726,53,62108,53,allow,172,88,84,2,31,1,1
65513,53,35186,53,allow,190,97,93,2,31,1,1
52560,445,0,0,drop,66,66,0,1,0,1,0
51172,443,45149,443,allow,1472,965,507,13,20,7,6
49332,53,38516,53,allow,281,98,183,4,57,2,2
57150,445,0,0,drop,70,70,0,1,0,1,0
57149,445,0,0,drop,70,70,0,1,0,1,0
52137,445,0,0,drop,70,70,0,1,0,1,0
52555,445,0,0,drop,66,66,0,1,0,1,0
64158,53,28086,53,allow,211,102,109,2,30,1,1
55705,53,50083,53,allow,209,110,99,2,30,1,1
54998,53,11974,53,allow,179,94,85,2,30,1,1
49635,53,17449,53,allow,210,110,100,2,30,1,1
49260,53,30297,53,allow,791,85,706,4,57,2,2
65266,53,28016,53,allow,536,113,423,4,56,2,2
51177,443,18641,443,allow,154,94,60,2,4,1,1
64252,53,63394,53,allow,381,101,280,4,43,2,2
65040,53,46633,53,allow,180,94,86,2,29,1,1
64999,53,64999,53,allow,230,90,140,2,30,1,1
49175,53,11847,53,allow,193,102,91,2,29,1,1
64711,53,52164,53,allow,178,94,84,2,29,1,1
57139,53,34151,53,allow,166,86,80,2,29,1,1
55747,53,57229,53,allow,215,102,113,2,29,1,1
65040,53,64566,53,allow,180,94,86,2,29,1,1
65469,53,34501,53,allow,195,102,93,2,29,1,1
64956,53,13763,53,allow,565,92,473,4,38,2,2
55705,53,38579,53,allow,209,110,99,2,29,1,1
55634,53,37153,53,allow,210,110,100,2,30,1,1
55286,53,58993,53,allow,194,102,92,2,29,1,1
57139,53,51563,53,allow,166,86,80,2,30,1,1
55517,53,64032,53,allow,179,94,85,2,29,1,1
49341,53,19411,53,allow,199,102,97,2,29,1,1
36074,80,23733,80,allow,1158,792,366,10,17,6,4
64079,53,36707,53,allow,232,94,138,2,30,1,1
49332,53,50877,53,allow,281,98,183,4,57,2,2
57127,53,41259,53,allow,195,102,93,2,30,1,1
51171,443,60392,443,allow,1532,965,567,14,20,7,7
49367,53,7025,53,allow,548,112,436,4,36,2,2
64986,53,27800,53,allow,180,94,86,2,30,1,1
56167,53,17314,53,allow,178,94,84,2,30,1,1
64739,53,12107,53,allow,172,94,78,2,30,1,1
57416,53,2716,53,allow,193,102,91,2,30,1,1
65048,53,32798,53,allow,194,102,92,2,30,1,1
63998,53,51868,53,allow,263,126,137,2,30,1,1
64531,53,41084,53,allow,183,94,89,2,30,1,1
49983,53,57759,53,allow,211,110,101,2,30,1,1
64388,53,48927,53,allow,248,102,146,2,30,1,1
49820,53,40891,53,allow,211,102,109,2,30,1,1
64126,53,25754,53,allow,255,102,153,2,30,1,1
43120,80,4226,80,allow,1151,711,440,10,15,5,5
63943,53,16297,53,allow,258,90,168,4,56,2,2
49777,53,60241,53,allow,272,84,188,4,60,2,2
50069,53,27415,53,allow,179,94,85,2,30,1,1
49369,53,21146,53,allow,183,94,89,2,30,1,1
49297,53,2852,53,allow,183,94,89,2,30,1,1
57139,53,32218,53,allow,166,86,80,2,30,1,1
54998,53,33990,53,allow,179,94,85,2,30,1,1
55563,53,20716,53,allow,290,118,172,2,30,1,1
65140,53,14760,53,allow,752,110,642,2,30,1,1
56167,53,49116,53,allow,178,94,84,2,30,1,1
45633,80,23400,80,allow,1573,702,871,12,45,7,5
49699,53,32857,53,allow,266,89,177,4,58,2,2
56552,53,47161,53,allow,195,102,93,2,29,1,1
50016,80,57935,80,allow,827,687,140,6,32,4,2
56071,53,60998,53,allow,193,102,91,2,29,1,1
64986,53,30082,53,allow,180,94,86,2,30,1,1
53447,80,56181,80,allow,1517,481,1036,11,15,6,5
57134,53,48452,53,allow,178,94,84,2,30,1,1
65179,53,52575,53,allow,184,94,90,2,30,1,1
49341,53,41507,53,allow,199,102,97,2,30,1,1
65115,53,52563,53,allow,193,102,91,2,30,1,1
64213,53,34758,53,allow,342,105,237,4,53,2,2
55286,53,38062,53,allow,194,102,92,2,29,1,1
63747,80,64940,80,allow,314,192,122,6,15,4,2
49384,53,28172,53,allow,181,94,87,2,29,1,1
64252,53,2109,53,allow,199,102,97,2,29,1,1
49699,53,7442,53,allow,266,89,177,4,58,2,2
64438,53,9645,53,allow,184,94,90,2,29,1,1
65185,53,26657,53,allow,453,186,267,6,30,3,3
49361,53,37385,53,allow,184,94,90,2,29,1,1
56402,53,29838,53,allow,322,134,188,2,30,1,1
57416,53,8404,53,allow,193,102,91,2,29,1,1
55955,53,39332,53,allow,164,86,78,2,30,1,1
64997,53,31899,53,allow,166,86,80,2,30,1,1
65179,53,63378,53,allow,184,94,90,2,31,1,1
50022,53,26770,53,allow,179,94,85,2,31,1,1
65179,53,56146,53,allow,184,94,90,2,30,1,1
55664,53,37409,53,allow,195,102,93,2,30,1,1
64546,53,39505,53,allow,183,94,89,2,31,1,1
49945,53,3434,53,allow,281,97,184,4,57,2,2
64124,80,34060,80,allow,1517,481,1036,11,15,6,5
59814,443,30492,443,allow,1560,977,583,15,30,8,7
36811,80,46728,80,allow,1475,837,638,10,15,5,5
49369,53,36980,53,allow,183,94,89,2,30,1,1
56641,53,52292,53,allow,453,186,267,6,30,3,3
40926,53,16373,53,allow,168,78,90,2,30,1,1
57127,53,41835,53,allow,195,102,93,2,30,1,1
64783,53,41526,53,allow,561,99,462,4,38,2,2
56759,53,42507,53,allow,338,118,220,2,30,1,1
55937,53,58356,53,allow,179,94,85,2,30,1,1
57268,53,42841,53,allow,205,94,111,2,30,1,1
56167,53,4828,53,allow,178,94,84,2,30,1,1
64850,53,49939,53,allow,196,102,94,2,30,1,1
55955,53,59392,53,allow,164,86,78,2,30,1,1
65522,53,17756,53,allow,1281,94,1187,2,30,1,1
57323,53,57323,53,allow,216,98,118,2,30,1,1
64859,53,0,0,allow,220,81,139,2,30,1,1
56932,53,30512,53,allow,172,94,78,2,30,1,1
55975,53,39571,53,allow,195,102,93,2,30,1,1
60195,80,59592,80,allow,70,70,0,1,5,1,0
52194,80,42397,80,allow,1151,711,440,10,15,5,5
57134,53,29907,53,allow,178,94,84,2,30,1,1
49229,53,43907,53,allow,178,94,84,2,30,1,1
56326,53,34552,53,allow,177,94,83,2,30,1,1
55634,53,10243,53,allow,210,110,100,2,30,1,1
64303,53,3497,53,allow,212,102,110,2,30,1,1
49478,53,25544,53,allow,172,94,78,2,30,1,1
51459,53,51459,53,allow,256,114,142,2,30,1,1
42758,123,49346,123,allow,184,94,90,2,30,1,1
64235,53,18011,53,allow,197,102,95,2,30,1,1
65231,53,2677,53,allow,200,102,98,2,30,1,1
52088,53,34492,53,allow,168,78,90,2,30,1,1
59475,53,33895,53,allow,179,86,93,2,30,1,1
65451,53,9414,53,allow,178,94,84,2,30,1,1
49635,53,59666,53,allow,210,110,100,2,30,1,1
50022,53,51786,53,allow,179,94,85,2,30,1,1
55664,53,32292,53,allow,195,102,93,2,30,1,1
65371,53,1608,53,allow,199,102,97,2,30,1,1
65424,53,5090,53,allow,210,110,100,2,31,1,1
65513,53,29862,53,allow,195,102,93,2,31,1,1
65048,53,7806,53,allow,194,102,92,2,30,1,1
56066,53,20182,53,allow,212,110,102,2,30,1,1
56418,53,19002,53,allow,183,94,89,2,30,1,1
49442,53,40025,53,allow,198,94,104,2,31,1,1
64850,53,36878,53,allow,196,102,94,2,31,1,1
64677,53,46523,53,allow,195,102,93,2,31,1,1
65451,53,7550,53,allow,178,94,84,2,31,1,1
56288,53,49732,53,allow,183,94,89,2,31,1,1
56418,53,28996,53,allow,183,94,89,2,31,1,1
65115,53,25677,53,allow,368,95,273,4,61,2,2
58190,53,48181,53,allow,648,86,562,4,51,2,2
60538,80,60538,80,allow,318,120,198,6,26,3,3
54998,53,29340,53,allow,438,89,349,4,60,2,2
49424,53,11040,53,allow,198,102,96,2,33,1,1
60539,80,60539,80,allow,318,120,198,6,26,3,3
64055,53,48031,53,allow,501,94,407,4,52,2,2
56656,53,3129,53,allow,255,88,167,4,53,2,2
52552,445,0,0,drop,66,66,0,1,0,1,0
52128,445,0,0,drop,70,70,0,1,0,1,0
57132,445,0,0,drop,70,70,0,1,0,1,0
57130,445,0,0,drop,70,70,0,1,0,1,0
52126,445,0,0,drop,70,70,0,1,0,1,0
52549,445,0,0,drop,66,66,0,1,0,1,0
52121,445,0,0,drop,70,70,0,1,0,1,0
52120,445,0,0,drop,70,70,0,1,0,1,0
57121,445,0,0,drop,70,70,0,1,0,1,0
57119,445,0,0,drop,70,70,0,1,0,1,0
57117,445,0,0,drop,70,70,0,1,0,1,0
52543,445,0,0,drop,66,66,0,1,0,1,0
52537,445,0,0,drop,66,66,0,1,0,1,0
52536,445,0,0,drop,66,66,0,1,0,1,0
52534,445,0,0,drop,66,66,0,1,0,1,0
52116,445,0,0,drop,70,70,0,1,0,1,0
52531,445,0,0,drop,66,66,0,1,0,1,0
52533,445,0,0,drop,66,66,0,1,0,1,0
52532,445,0,0,drop,66,66,0,1,0,1,0
52115,445,0,0,drop,70,70,0,1,0,1,0
37577,443,55436,443,allow,499,425,74,4,0,3,1
37580,443,1520,443,allow,499,425,74,4,0,3,1
37578,443,38222,443,allow,499,425,74,4,0,3,1
37579,443,43995,443,allow,499,425,74,4,0,3,1
37576,443,42873,443,allow,499,425,74,4,0,3,1
37575,443,28180,443,allow,499,425,74,4,0,3,1
57116,445,0,0,drop,70,70,0,1,0,1,0
57114,445,0,0,drop,70,70,0,1,0,1,0
52528,445,0,0,drop,66,66,0,1,0,1,0
57108,445,0,0,drop,70,70,0,1,0,1,0
52524,445,0,0,drop,66,66,0,1,0,1,0
52521,445,0,0,drop,66,66,0,1,0,1,0
52522,445,0,0,drop,66,66,0,1,0,1,0
52519,445,0,0,drop,66,66,0,1,0,1,0
57097,445,0,0,drop,70,70,0,1,0,1,0
57094,445,0,0,drop,70,70,0,1,0,1,0
52508,445,0,0,drop,66,66,0,1,0,1,0
52097,445,0,0,drop,70,70,0,1,0,1,0
51196,53,0,0,allow,206,83,123,2,0,1,1
49424,53,32316,53,allow,100,100,0,1,0,1,0
52094,445,0,0,drop,70,70,0,1,0,1,0
52501,445,0,0,drop,66,66,0,1,0,1,0
57080,445,0,0,drop,70,70,0,1,0,1,0
52498,445,0,0,drop,66,66,0,1,0,1,0
52089,445,0,0,drop,70,70,0,1,0,1,0
52088,445,0,0,drop,70,70,0,1,0,1,0
42572,995,0,0,deny,60,60,0,1,0,1,0
39941,995,0,0,deny,60,60,0,1,0,1,0
52086,445,0,0,drop,70,70,0,1,0,1,0
52492,445,0,0,drop,66,66,0,1,0,1,0
52486,445,0,0,drop,66,66,0,1,0,1,0
52079,445,0,0,drop,70,70,0,1,0,1,0
52077,445,0,0,drop,70,70,0,1,0,1,0
57071,445,0,0,drop,70,70,0,1,0,1,0
57070,445,0,0,drop,70,70,0,1,0,1,0
52475,445,0,0,drop,66,66,0,1,0,1,0
52476,445,0,0,drop,66,66,0,1,0,1,0
52474,445,0,0,drop,66,66,0,1,0,1,0
52469,445,0,0,drop,66,66,0,1,0,1,0
52470,445,0,0,drop,66,66,0,1,0,1,0
52473,445,0,0,drop,66,66,0,1,0,1,0
52472,445,0,0,drop,66,66,0,1,0,1,0
52471,445,0,0,drop,66,66,0,1,0,1,0
52075,445,0,0,drop,70,70,0,1,0,1,0
52074,445,0,0,drop,70,70,0,1,0,1,0
52068,445,0,0,drop,70,70,0,1,0,1,0
52055,445,0,0,drop,70,70,0,1,0,1,0
52054,445,0,0,drop,70,70,0,1,0,1,0
52049,445,0,0,drop,70,70,0,1,0,1,0
57063,445,0,0,drop,70,70,0,1,0,1,0
57057,445,0,0,drop,70,70,0,1,0,1,0
57056,445,0,0,drop,70,70,0,1,0,1,0
52044,445,0,0,drop,70,70,0,1,0,1,0
52456,445,0,0,drop,66,66,0,1,0,1,0
52455,445,0,0,drop,66,66,0,1,0,1,0
52453,445,0,0,drop,66,66,0,1,0,1,0
57050,445,0,0,drop,70,70,0,1,0,1,0
57048,445,0,0,drop,70,70,0,1,0,1,0
57043,445,0,0,drop,70,70,0,1,0,1,0
57038,445,0,0,drop,70,70,0,1,0,1,0
57039,445,0,0,drop,70,70,0,1,0,1,0
52033,445,0,0,drop,70,70,0,1,0,1,0
55045,53,38947,53,allow,747,92,655,2,30,1,1
49897,80,15304,80,allow,188,128,60,3,15,2,1
56418,53,62864,53,allow,182,93,89,2,30,1,1
55337,53,11833,53,allow,294,106,188,4,56,2,2
55540,53,5728,53,allow,757,98,659,2,31,1,1
50128,53,3916,53,allow,757,98,659,2,30,1,1
56376,53,45759,53,allow,196,100,96,2,30,1,1
56656,53,54597,53,allow,255,88,167,4,53,2,2
60537,80,60537,80,allow,318,120,198,6,25,3,3
56288,53,56709,53,allow,182,93,89,2,31,1,1
64327,53,64327,53,allow,243,100,143,2,30,1,1
57342,80,40590,80,allow,1056,682,374,10,15,6,4
39611,443,31755,443,allow,234,234,0,4,12,4,0
55394,53,55394,53,allow,197,76,121,2,30,1,1
65159,53,15273,53,allow,286,103,183,4,52,2,2
64811,53,2888,53,allow,186,95,91,2,30,1,1
64706,53,4952,53,allow,174,89,85,2,30,1,1
55664,53,44957,53,allow,190,97,93,2,30,1,1
49672,53,36267,53,allow,761,100,661,2,30,1,1
65372,53,1041,53,allow,196,100,96,2,31,1,1
46844,53,0,0,allow,82,82,0,1,31,1,0
56727,53,26195,53,allow,762,101,661,2,31,1,1
56458,53,36864,53,allow,192,98,94,2,31,1,1
64840,53,31006,53,allow,186,95,91,2,31,1,1
56924,53,30417,53,allow,216,110,106,2,31,1,1
52029,445,0,0,drop,70,70,0,1,0,1,0
57028,445,0,0,drop,70,70,0,1,0,1,0
57024,445,0,0,drop,70,70,0,1,0,1,0
52019,445,0,0,drop,70,70,0,1,0,1,0
52020,445,0,0,drop,70,70,0,1,0,1,0
52016,445,0,0,drop,70,70,0,1,0,1,0
52015,445,0,0,drop,70,70,0,1,0,1,0
52433,445,0,0,drop,66,66,0,1,0,1,0
57022,445,0,0,drop,70,70,0,1,0,1,0
57021,445,0,0,drop,70,70,0,1,0,1,0
52427,445,0,0,drop,66,66,0,1,0,1,0
51999,445,0,0,drop,70,70,0,1,0,1,0
52424,445,0,0,drop,66,66,0,1,0,1,0
57004,445,0,0,drop,70,70,0,1,0,1,0
57002,445,0,0,drop,70,70,0,1,0,1,0
56380,80,20906,80,allow,1466,729,737,12,16,7,5
64914,53,27750,53,allow,168,86,82,2,30,1,1
56320,53,53678,53,allow,183,94,89,2,30,1,1
51103,53,0,0,allow,174,77,97,2,30,1,1
49332,53,28193,53,allow,281,98,183,4,56,2,2
64235,53,30515,53,allow,321,99,222,4,52,2,2
60536,80,60536,80,allow,318,120,198,6,25,3,3
55337,53,8346,53,allow,294,106,188,4,56,2,2
56656,53,41327,53,allow,255,88,167,4,52,2,2
55337,53,22307,53,allow,294,106,188,4,55,2,2
63943,53,24441,53,allow,509,176,333,6,56,3,3
60004,443,3185,443,allow,134,60,74,3,4,2,1
49699,53,17835,53,allow,266,89,177,4,58,2,2
65424,53,57166,53,allow,210,110,100,2,29,1,1
60535,80,60535,80,allow,318,120,198,6,25,3,3
64546,53,11850,53,allow,183,94,89,2,29,1,1
64914,53,63909,53,allow,86,86,0,1,29,1,0
56656,53,40908,53,allow,255,88,167,4,53,2,2
64982,53,7068,53,allow,321,97,224,4,57,2,2
65159,53,20643,53,allow,286,103,183,4,51,2,2
64939,53,4454,53,allow,199,94,105,2,29,1,1
64531,53,56972,53,allow,183,94,89,2,29,1,1
55931,53,41701,53,allow,294,118,176,2,29,1,1
61041,53,61041,53,allow,214,90,124,2,29,1,1
65532,53,19828,53,allow,819,102,717,2,30,1,1
64689,53,34039,53,allow,183,94,89,2,30,1,1
55372,53,7739,53,allow,448,184,264,6,30,3,3
55013,53,33517,53,allow,821,102,719,2,30,1,1
65168,53,45025,53,allow,749,94,655,2,30,1,1
64982,53,35426,53,allow,195,102,93,2,30,1,1
50165,53,36668,53,allow,211,78,133,2,30,1,1
55013,53,27966,53,allow,198,102,96,2,30,1,1
64823,53,7121,53,allow,199,102,97,2,31,1,1
64982,53,7315,53,allow,195,102,93,2,30,1,1
64689,53,48296,53,allow,183,94,89,2,30,1,1
49748,53,20050,53,allow,763,102,661,2,30,1,1
64608,53,12446,53,allow,212,110,102,2,30,1,1
50367,53,23115,53,allow,198,102,96,2,30,1,1
56339,53,35770,53,allow,280,78,202,2,30,1,1
56320,53,14969,53,allow,183,94,89,2,30,1,1
56288,53,30293,53,allow,183,94,89,2,30,1,1
64677,53,6467,53,allow,195,102,93,2,30,1,1
50291,53,32259,53,allow,86,86,0,1,30,1,0
56023,53,4937,53,allow,338,106,232,4,37,2,2
47400,80,1203,80,allow,1052,612,440,10,15,5,5
49297,53,48060,53,allow,183,94,89,2,30,1,1
64703,53,15968,53,allow,314,92,222,4,31,2,2
49346,53,23031,53,allow,228,110,118,2,30,1,1
64608,53,62804,53,allow,212,110,102,2,30,1,1
64726,53,39418,53,allow,178,94,84,2,30,1,1
56376,53,65133,53,allow,198,102,96,2,30,1,1
55337,53,17571,53,allow,294,106,188,4,56,2,2
65067,53,43932,53,allow,411,115,296,4,38,2,2
53521,443,50004,443,allow,130,70,60,2,15,1,1
56609,80,38761,80,allow,234,234,0,4,12,4,0
65048,53,15306,53,allow,297,96,201,4,42,2,2
56932,53,43209,53,allow,172,94,78,2,29,1,1
64811,53,37013,53,allow,193,102,91,2,29,1,1
49635,53,38499,53,allow,210,110,100,2,29,1,1
55664,53,1350,53,allow,195,102,93,2,30,1,1
65159,53,25271,53,allow,286,103,183,4,52,2,2
56326,53,1837,53,allow,177,94,83,2,29,1,1
65115,53,24571,53,allow,193,102,91,2,29,1,1
49945,53,14331,53,allow,281,97,184,4,56,2,2
64706,53,11232,53,allow,179,94,85,2,29,1,1
49099,53,46349,53,allow,238,94,144,2,30,1,1
49297,53,44299,53,allow,183,94,89,2,30,1,1
49589,53,21247,53,allow,198,94,104,2,30,1,1
64726,53,24139,53,allow,178,94,84,2,30,1,1
49378,53,33691,53,allow,179,86,93,2,30,1,1
50791,53,50791,53,allow,231,90,141,2,30,1,1
57338,80,37762,80,allow,1420,715,705,12,16,7,5
50367,53,53044,53,allow,821,102,719,2,30,1,1
64914,53,55728,53,allow,168,86,82,2,30,1,1
64546,53,29110,53,allow,183,94,89,2,30,1,1
64706,53,5159,53,allow,179,94,85,2,30,1,1
59848,53,28215,53,allow,239,102,137,2,30,1,1
56320,53,53146,53,allow,183,94,89,2,30,1,1
64689,53,60672,53,allow,183,94,89,2,30,1,1
64811,53,21833,53,allow,193,102,91,2,30,1,1
65451,53,45725,53,allow,178,94,84,2,30,1,1
64726,53,25224,53,allow,178,94,84,2,30,1,1
64706,53,6789,53,allow,179,94,85,2,30,1,1
64850,53,16958,53,allow,196,102,94,2,30,1,1
64823,53,51719,53,allow,199,102,97,2,30,1,1
56376,53,35947,53,allow,198,102,96,2,30,1,1
64608,53,18292,53,allow,212,110,102,2,30,1,1
49667,53,65184,53,allow,448,184,264,6,30,3,3
65126,53,60546,53,allow,718,94,624,2,30,1,1
58873,53,50618,53,allow,168,78,90,2,30,1,1
65513,53,15039,53,allow,195,102,93,2,31,1,1
58499,123,31733,123,allow,184,94,90,2,30,1,1
48040,53,11212,53,allow,168,78,90,2,30,1,1
64322,53,52794,53,allow,250,94,156,2,30,1,1
56376,53,49970,53,allow,198,102,96,2,31,1,1
56458,53,9119,53,allow,196,102,94,2,31,1,1
64517,53,39078,53,allow,194,102,92,2,31,1,1
64997,53,57263,53,allow,166,86,80,2,31,1,1
65532,53,33764,53,allow,196,102,94,2,30,1,1
49566,53,59606,53,allow,200,94,106,2,30,1,1
46013,80,29418,80,allow,134,60,74,3,6,2,1
64139,53,9779,53,allow,498,93,405,4,47,2,2
65011,53,37444,53,allow,183,94,89,2,31,1,1
53575,1025,56604,1025,allow,70,70,0,2,8,2,0
50334,53,13800,53,allow,216,110,106,2,30,1,1
65371,53,53875,53,allow,356,101,255,4,55,2,2
55730,53,15730,53,allow,196,102,94,2,30,1,1
64619,53,62516,53,allow,229,94,135,2,30,1,1
65371,53,17018,53,allow,199,102,97,2,30,1,1
52420,445,0,0,drop,66,66,0,1,0,1,0
51992,445,0,0,drop,70,70,0,1,0,1,0
51991,445,0,0,drop,70,70,0,1,0,1,0
56996,445,0,0,drop,70,70,0,1,0,1,0
56993,445,0,0,drop,70,70,0,1,0,1,0
56990,445,0,0,drop,70,70,0,1,0,1,0
56991,445,0,0,drop,70,70,0,1,0,1,0
52415,445,0,0,drop,66,66,0,1,0,1,0
51987,445,0,0,drop,70,70,0,1,0,1,0
52407,445,0,0,drop,66,66,0,1,0,1,0
52412,445,0,0,drop,66,66,0,1,0,1,0
52406,445,0,0,drop,66,66,0,1,0,1,0
52403,445,0,0,drop,66,66,0,1,0,1,0
52405,445,0,0,drop,66,66,0,1,0,1,0
52404,445,0,0,drop,66,66,0,1,0,1,0
56987,445,0,0,drop,70,70,0,1,0,1,0
56986,445,0,0,drop,70,70,0,1,0,1,0
56984,445,0,0,drop,70,70,0,1,0,1,0
52399,445,0,0,drop,66,66,0,1,0,1,0
56980,445,0,0,drop,70,70,0,1,0,1,0
55074,53,55407,53,allow,770,101,669,2,0,1,1
52397,445,0,0,drop,66,66,0,1,0,1,0
52395,445,0,0,drop,66,66,0,1,0,1,0
52393,445,0,0,drop,66,66,0,1,0,1,0
52391,445,0,0,drop,66,66,0,1,0,1,0
56968,445,0,0,drop,70,70,0,1,0,1,0
56965,445,0,0,drop,70,70,0,1,0,1,0
52383,445,0,0,drop,66,66,0,1,0,1,0
52373,445,0,0,drop,66,66,0,1,0,1,0
56952,445,0,0,drop,70,70,0,1,0,1,0
51961,445,0,0,drop,70,70,0,1,0,1,0
51959,445,0,0,drop,70,70,0,1,0,1,0
52370,445,0,0,drop,66,66,0,1,0,1,0
51957,445,0,0,drop,70,70,0,1,0,1,0
52364,445,0,0,drop,66,66,0,1,0,1,0
52361,445,0,0,drop,66,66,0,1,0,1,0
55937,53,29379,53,allow,174,89,85,2,0,1,1
51950,445,0,0,drop,70,70,0,1,0,1,0
56945,445,0,0,drop,70,70,0,1,0,1,0
51947,445,0,0,drop,70,70,0,1,0,1,0
52347,445,0,0,drop,66,66,0,1,0,1,0
52346,445,0,0,drop,66,66,0,1,0,1,0
52345,445,0,0,drop,66,66,0,1,0,1,0
52342,445,0,0,drop,66,66,0,1,0,1,0
52341,445,0,0,drop,66,66,0,1,0,1,0
52344,445,0,0,drop,66,66,0,1,0,1,0
52348,445,0,0,drop,66,66,0,1,0,1,0
52340,445,0,0,drop,66,66,0,1,0,1,0
51941,445,0,0,drop,70,70,0,1,0,1,0
51939,445,0,0,drop,70,70,0,1,0,1,0
51926,445,0,0,drop,70,70,0,1,0,1,0
51923,445,0,0,drop,70,70,0,1,0,1,0
51914,445,0,0,drop,70,70,0,1,0,1,0
51913,445,0,0,drop,70,70,0,1,0,1,0
65011,53,38944,53,allow,182,93,89,2,30,1,1
49768,80,40790,80,allow,254,128,126,5,15,3,2
56628,53,54812,53,allow,789,110,679,2,30,1,1
49580,53,21716,53,allow,192,98,94,2,30,1,1
64613,53,26326,53,allow,89,89,0,1,30,1,0
52458,53,52458,53,allow,231,88,143,2,33,1,1
42105,53,20788,53,allow,168,78,90,2,30,1,1
56857,53,30246,53,allow,711,87,624,2,30,1,1
59340,53,59340,53,allow,215,90,125,2,30,1,1
49996,53,3392,53,allow,182,93,89,2,31,1,1
55577,53,64711,53,allow,198,101,97,2,31,1,1
65312,53,47796,53,allow,180,92,88,2,30,1,1
55088,53,2549,53,allow,186,95,91,2,31,1,1
40893,123,36091,123,allow,184,94,90,2,31,1,1
54316,53,0,0,allow,325,77,248,2,31,1,1
56939,445,0,0,drop,70,70,0,1,0,1,0
56937,445,0,0,drop,70,70,0,1,0,1,0
56926,445,0,0,drop,70,70,0,1,0,1,0
52326,445,0,0,drop,66,66,0,1,0,1,0
52328,445,0,0,drop,66,66,0,1,0,1,0
52327,445,0,0,drop,66,66,0,1,0,1,0
56922,445,0,0,drop,70,70,0,1,0,1,0
65463,53,50986,53,allow,177,94,83,2,30,1,1
56920,445,0,0,drop,70,70,0,1,0,1,0
51902,445,0,0,drop,70,70,0,1,0,1,0
39165,23,0,0,deny,60,60,0,1,0,1,0
56911,445,0,0,drop,70,70,0,1,0,1,0
56912,445,0,0,drop,70,70,0,1,0,1,0
56908,445,0,0,drop,70,70,0,1,0,1,0
51895,445,0,0,drop,70,70,0,1,0,1,0
38980,17,0,0,deny,60,60,0,1,0,1,0
56458,53,38538,53,allow,196,102,94,2,30,1,1
64997,53,25843,53,allow,166,86,80,2,30,1,1
38604,53,38604,53,allow,203,82,121,2,30,1,1
49216,53,31679,53,allow,789,110,679,2,29,1,1
65513,53,57723,53,allow,195,102,93,2,29,1,1
53895,53,0,0,allow,86,86,0,1,29,1,0
56215,53,45300,53,allow,168,78,90,2,29,1,1
64355,53,49915,53,allow,402,118,284,2,29,1,1
47739,53,26929,53,allow,168,78,90,2,29,1,1
56418,53,6346,53,allow,183,94,89,2,29,1,1
64645,53,50507,53,allow,391,96,295,4,49,2,2
56239,53,9531,53,allow,179,86,93,2,29,1,1
56288,53,34669,53,allow,183,94,89,2,30,1,1
65463,53,23022,53,allow,177,94,83,2,30,1,1
56845,53,40181,53,allow,730,102,628,2,30,1,1
56924,53,7241,53,allow,216,110,106,2,30,1,1
64527,53,58780,53,allow,228,102,126,2,30,1,1
64871,53,62774,53,allow,263,94,169,2,31,1,1
51988,53,22023,53,allow,78,78,0,1,30,1,0
41907,53,41907,53,allow,233,90,143,2,33,1,1
36682,80,24588,80,allow,130,70,60,2,15,1,1
56114,53,2423,53,allow,216,110,106,2,30,1,1
44211,53,44211,53,allow,850,114,736,2,30,1,1
65312,53,52827,53,allow,182,94,88,2,30,1,1
65312,53,55577,53,allow,182,94,88,2,30,1,1
57132,53,36267,53,allow,177,94,83,2,30,1,1
56458,53,47423,53,allow,196,102,94,2,30,1,1
57321,53,18718,53,allow,199,102,97,2,30,1,1
51550,53,60452,53,allow,168,78,90,2,30,1,1
64145,53,5953,53,allow,504,105,399,4,35,2,2
65372,53,40284,53,allow,198,102,96,2,30,1,1
49301,53,20768,53,allow,214,102,112,2,30,1,1
44116,123,64380,123,allow,184,94,90,2,30,1,1
64840,53,3676,53,allow,193,102,91,2,30,1,1
56924,53,61139,53,allow,216,110,106,2,30,1,1
64281,53,41166,53,allow,492,90,402,4,45,2,2
57321,53,57606,53,allow,199,102,97,2,30,1,1
65312,53,9346,53,allow,182,94,88,2,30,1,1
57367,53,52070,53,allow,177,94,83,2,30,1,1
41210,443,11454,443,allow,234,234,0,4,11,4,0
51105,80,8408,80,allow,366,240,126,7,20,5,2
53556,1024,47936,1024,allow,70,70,0,1,4,1,0
49418,53,51153,53,allow,379,93,286,4,37,2,2
55730,53,1752,53,allow,819,102,717,2,29,1,1
50334,53,27323,53,allow,216,110,106,2,29,1,1
64811,53,25235,53,allow,193,102,91,2,29,1,1
56114,53,59313,53,allow,216,110,106,2,30,1,1
64517,53,41974,53,allow,194,102,92,2,29,1,1
64877,53,24531,53,allow,309,110,199,2,30,1,1
50164,53,36057,53,allow,260,86,174,2,29,1,1
64580,53,58796,53,allow,200,94,106,2,30,1,1
56924,53,48740,53,allow,216,110,106,2,30,1,1
56431,53,52567,53,allow,323,110,213,2,30,1,1
64320,53,48665,53,allow,199,102,97,2,30,1,1
65011,53,28977,53,allow,183,94,89,2,31,1,1
55577,53,12118,53,allow,199,102,97,2,30,1,1
64275,53,2712,53,allow,644,198,446,6,48,3,3
57132,53,31918,53,allow,177,94,83,2,30,1,1
55577,53,47306,53,allow,199,102,97,2,30,1,1
65443,53,31902,53,allow,730,102,628,2,30,1,1
55788,53,26476,53,allow,231,110,121,2,30,1,1
65372,53,29268,53,allow,198,102,96,2,30,1,1
49996,53,62453,53,allow,183,94,89,2,30,1,1
49580,53,4352,53,allow,196,102,94,2,30,1,1
49580,53,60391,53,allow,196,102,94,2,30,1,1
49759,53,30943,53,allow,216,110,106,2,31,1,1
64613,53,60043,53,allow,179,94,85,2,30,1,1
57661,53,46284,53,allow,70,70,0,1,30,1,0
51104,80,56002,80,allow,1524,1028,496,10,21,7,3
64613,53,44378,53,allow,179,94,85,2,30,1,1
65449,53,65266,53,allow,507,193,314,6,57,3,3
55577,53,3000,53,allow,699,204,495,6,57,3,3
55519,53,47075,53,allow,193,102,91,2,30,1,1
57271,53,58158,53,allow,288,94,194,2,30,1,1
51886,445,0,0,drop,70,70,0,1,0,1,0
56900,445,0,0,drop,70,70,0,1,0,1,0
56896,445,0,0,drop,70,70,0,1,0,1,0
51881,445,0,0,drop,70,70,0,1,0,1,0
52303,445,0,0,drop,66,66,0,1,0,1,0
56895,445,0,0,drop,70,70,0,1,0,1,0
56894,445,0,0,drop,70,70,0,1,0,1,0
51872,445,0,0,drop,70,70,0,1,0,1,0
51864,445,0,0,drop,70,70,0,1,0,1,0
52298,445,0,0,drop,66,66,0,1,0,1,0
52296,445,0,0,drop,66,66,0,1,0,1,0
56881,445,0,0,drop,70,70,0,1,0,1,0
56878,445,0,0,drop,70,70,0,1,0,1,0
56874,445,0,0,drop,70,70,0,1,0,1,0
52294,445,0,0,drop,66,66,0,1,0,1,0
51856,445,0,0,drop,70,70,0,1,0,1,0
56869,445,0,0,drop,70,70,0,1,0,1,0
56865,445,0,0,drop,70,70,0,1,0,1,0
56864,445,0,0,drop,70,70,0,1,0,1,0
56861,445,0,0,drop,70,70,0,1,0,1,0
52287,445,0,0,drop,66,66,0,1,0,1,0
51851,445,0,0,drop,70,70,0,1,0,1,0
52282,445,0,0,drop,66,66,0,1,0,1,0
52283,445,0,0,drop,66,66,0,1,0,1,0
52280,445,0,0,drop,66,66,0,1,0,1,0
52276,445,0,0,drop,66,66,0,1,0,1,0
52277,445,0,0,drop,66,66,0,1,0,1,0
52275,445,0,0,drop,66,66,0,1,0,1,0
51846,445,0,0,drop,70,70,0,1,0,1,0
56860,445,0,0,drop,70,70,0,1,0,1,0
56858,445,0,0,drop,70,70,0,1,0,1,0
52273,445,0,0,drop,66,66,0,1,0,1,0
56852,445,0,0,drop,70,70,0,1,0,1,0
52269,445,0,0,drop,66,66,0,1,0,1,0
52267,445,0,0,drop,66,66,0,1,0,1,0
52265,445,0,0,drop,66,66,0,1,0,1,0
52263,445,0,0,drop,66,66,0,1,0,1,0
56844,445,0,0,drop,70,70,0,1,0,1,0
51833,445,0,0,drop,70,70,0,1,0,1,0
56837,445,0,0,drop,70,70,0,1,0,1,0
52255,445,0,0,drop,66,66,0,1,0,1,0
52245,445,0,0,drop,66,66,0,1,0,1,0
51826,445,0,0,drop,70,70,0,1,0,1,0
51824,445,0,0,drop,70,70,0,1,0,1,0
52243,445,0,0,drop,66,66,0,1,0,1,0
52236,445,0,0,drop,66,66,0,1,0,1,0
52231,445,0,0,drop,66,66,0,1,0,1,0
51813,445,0,0,drop,70,70,0,1,0,1,0
65339,53,50441,53,allow,186,95,91,2,31,1,1
64992,53,63333,53,allow,170,87,83,2,30,1,1
55519,53,8879,53,allow,186,95,91,2,30,1,1
51101,80,9411,80,allow,366,240,126,7,20,5,2
53974,53,45539,53,allow,578,286,292,9,15,5,4
49759,53,28731,53,allow,216,110,106,2,30,1,1
57367,53,62826,53,allow,170,87,83,2,30,1,1
45713,53,45713,53,allow,217,87,130,2,30,1,1
51425,53,0,0,allow,194,87,107,2,30,1,1
64320,53,33961,53,allow,198,101,97,2,30,1,1
53670,53,0,0,allow,82,82,0,1,30,1,0
62524,123,21935,123,allow,184,94,90,2,31,1,1
60962,53,0,0,allow,180,80,100,2,31,1,1
59455,53,0,0,allow,221,81,140,2,31,1,1
51812,445,0,0,drop,70,70,0,1,0,1,0
51810,445,0,0,drop,70,70,0,1,0,1,0
51807,445,0,0,drop,70,70,0,1,0,1,0
56815,445,0,0,drop,70,70,0,1,0,1,0
56813,445,0,0,drop,70,70,0,1,0,1,0
56812,445,0,0,drop,70,70,0,1,0,1,0
52214,445,0,0,drop,66,66,0,1,0,1,0
52220,445,0,0,drop,66,66,0,1,0,1,0
52219,445,0,0,drop,66,66,0,1,0,1,0
52217,445,0,0,drop,66,66,0,1,0,1,0
52215,445,0,0,deny,66,66,0,1,0,1,0
52216,445,0,0,drop,66,66,0,1,0,1,0
52213,445,0,0,drop,66,66,0,1,0,1,0
52212,445,0,0,drop,66,66,0,1,0,1,0
51792,445,0,0,drop,70,70,0,1,0,1,0
51791,445,0,0,drop,70,70,0,1,0,1,0
51788,445,0,0,drop,70,70,0,1,0,1,0
49996,53,6579,53,allow,183,94,89,2,30,1,1
58052,25,34376,25,allow,540,256,284,9,30,5,4
41502,443,22197,443,allow,1053,566,487,10,48,6,4
65011,53,20412,53,allow,183,94,89,2,29,1,1
56955,53,20294,53,allow,184,86,98,2,29,1,1
64520,53,44752,53,allow,184,86,98,2,29,1,1
38211,123,28193,123,allow,184,94,90,2,29,1,1
57367,53,51549,53,allow,177,94,83,2,29,1,1
49815,53,18819,53,allow,212,102,110,2,29,1,1
49527,53,19400,53,allow,200,94,106,2,30,1,1
55088,53,55518,53,allow,193,102,91,2,30,1,1
64828,53,62244,53,allow,260,102,158,2,30,1,1
56018,443,53493,443,allow,162,102,60,2,5,1,1
44861,443,26247,443,allow,1053,566,487,10,47,6,4
60139,53,31222,53,allow,218,78,140,2,30,1,1
46342,53,46342,53,allow,233,90,143,2,32,1,1
56335,53,31703,53,allow,260,102,158,2,30,1,1
55971,53,55971,53,allow,233,90,143,2,33,1,1
54889,53,54889,53,allow,832,106,726,2,30,1,1
64320,53,61236,53,allow,199,102,97,2,30,1,1
55377,53,9978,53,allow,228,110,118,2,30,1,1
62877,53,36980,53,allow,248,78,170,2,30,1,1
64891,53,17816,53,allow,211,102,109,2,30,1,1
49482,53,59102,53,allow,196,94,102,2,30,1,1
55088,53,58589,53,allow,193,102,91,2,30,1,1
65147,53,52735,53,allow,323,102,221,2,30,1,1
64314,53,49422,53,allow,319,126,193,2,30,1,1
40500,53,40500,53,allow,203,82,121,2,30,1,1
49807,53,0,0,allow,218,77,141,2,30,1,1
56650,53,58049,53,allow,253,102,151,2,30,1,1
59112,53,0,0,allow,296,76,220,2,30,1,1
65381,53,45140,53,allow,241,110,131,2,30,1,1
50444,80,3294,80,allow,378,192,186,7,19,4,3
65399,53,0,0,allow,191,75,116,2,30,1,1
61320,53,0,0,allow,194,80,114,2,30,1,1
65339,53,24574,53,allow,193,102,91,2,30,1,1
57040,53,51890,53,allow,236,94,142,2,30,1,1
65256,53,29045,53,allow,357,105,252,4,57,2,2
64946,53,64946,53,allow,233,90,143,2,33,1,1
50443,80,16210,80,allow,378,192,186,7,19,4,3
47123,443,37885,443,allow,1053,566,487,10,43,6,4
49759,53,16085,53,allow,216,110,106,2,29,1,1
49903,53,18446,53,allow,215,102,113,2,29,1,1
49575,53,59647,53,allow,244,102,142,2,29,1,1
64654,53,63011,53,allow,240,110,130,2,30,1,1
55600,80,11201,80,allow,70,70,0,2,8,2,0
59794,443,46382,443,allow,408,78,330,6,25,1,5
57367,53,32502,53,allow,177,94,83,2,30,1,1
49996,53,8571,53,allow,183,94,89,2,30,1,1
49580,53,62367,53,allow,196,102,94,2,30,1,1
49810,53,13654,53,allow,244,94,150,2,30,1,1
55088,53,3753,53,allow,193,102,91,2,29,1,1
49640,53,5967,53,allow,402,118,284,2,30,1,1
54987,53,61181,53,allow,215,102,113,2,30,1,1
40465,443,49132,443,allow,1053,566,487,10,47,6,4
51607,53,31669,53,allow,284,86,198,2,30,1,1
49759,53,4425,53,allow,381,110,271,4,32,2,2
47651,443,48756,443,allow,1053,566,487,10,43,6,4
50442,80,8641,80,allow,378,192,186,7,19,4,3
55627,53,18188,53,allow,240,110,130,2,30,1,1
64992,53,56297,53,allow,177,94,83,2,30,1,1
47894,443,64449,443,allow,70,70,0,2,5,2,0
64320,53,46178,53,allow,199,102,97,2,30,1,1
57333,53,41487,53,allow,258,110,148,2,31,1,1
49246,53,63715,53,allow,286,102,184,2,31,1,1
49561,53,53882,53,allow,211,102,109,2,30,1,1
65339,53,13346,53,allow,949,285,664,8,39,4,4
64090,53,12119,53,allow,227,102,125,2,30,1,1
50690,443,43818,443,allow,354,294,60,2,5,1,1
51782,445,0,0,drop,70,70,0,1,0,1,0
51781,445,0,0,deny,70,70,0,1,0,1,0
56805,445,0,0,drop,70,70,0,1,0,1,0
56804,445,0,0,drop,70,70,0,1,0,1,0
56797,445,0,0,drop,70,70,0,1,0,1,0
52200,445,0,0,drop,66,66,0,1,0,1,0
52199,445,0,0,drop,66,66,0,1,0,1,0
52197,445,0,0,drop,66,66,0,1,0,1,0
56794,445,0,0,drop,70,70,0,1,0,1,0
51770,445,0,0,drop,70,70,0,1,0,1,0
56792,445,0,0,drop,70,70,0,1,0,1,0
56791,445,0,0,drop,70,70,0,1,0,1,0
56784,445,0,0,drop,70,70,0,1,0,1,0
56783,445,0,0,drop,70,70,0,1,0,1,0
51766,445,0,0,drop,70,70,0,1,0,1,0
51756,445,0,0,drop,70,70,0,1,0,1,0
51749,445,0,0,drop,70,70,0,1,0,1,0
56771,445,0,0,drop,70,70,0,1,0,1,0
51744,445,0,0,drop,70,70,0,1,0,1,0
52174,445,0,0,drop,66,66,0,1,0,1,0
56767,445,0,0,drop,70,70,0,1,0,1,0
56766,445,0,0,drop,70,70,0,1,0,1,0
51733,445,0,0,drop,70,70,0,1,0,1,0
52172,445,0,0,drop,66,66,0,1,0,1,0
52168,445,0,0,drop,66,66,0,1,0,1,0
51723,445,0,0,drop,70,70,0,1,0,1,0
51722,445,0,0,drop,70,70,0,1,0,1,0
56751,445,0,0,drop,70,70,0,1,0,1,0
56746,445,0,0,drop,70,70,0,1,0,1,0
52167,445,0,0,drop,66,66,0,1,0,1,0
51718,445,0,0,drop,70,70,0,1,0,1,0
56739,445,0,0,drop,70,70,0,1,0,1,0
56247,23,0,0,deny,60,60,0,1,0,1,0
56735,445,0,0,drop,70,70,0,1,0,1,0
56733,445,0,0,drop,70,70,0,1,0,1,0
52159,445,0,0,drop,66,66,0,1,0,1,0
52156,445,0,0,drop,66,66,0,1,0,1,0
52150,445,0,0,drop,66,66,0,1,0,1,0
52154,445,0,0,drop,66,66,0,1,0,1,0
52148,445,0,0,drop,66,66,0,1,0,1,0
52149,445,0,0,drop,66,66,0,1,0,1,0
52146,445,0,0,drop,66,66,0,1,0,1,0
51712,445,0,0,drop,70,70,0,1,0,1,0
56732,445,0,0,drop,70,70,0,1,0,1,0
56728,445,0,0,drop,70,70,0,1,0,1,0
56727,445,0,0,drop,70,70,0,1,0,1,0
52143,445,0,0,drop,66,66,0,1,0,1,0
52141,445,0,0,drop,66,66,0,1,0,1,0
52139,445,0,0,drop,66,66,0,1,0,1,0
52138,445,0,0,drop,66,66,0,1,0,1,0
52135,445,0,0,drop,66,66,0,1,0,1,0
51699,445,0,0,drop,70,70,0,1,0,1,0
56716,445,0,0,drop,70,70,0,1,0,1,0
56707,445,0,0,drop,70,70,0,1,0,1,0
51696,445,0,0,drop,70,70,0,1,0,1,0
52127,445,0,0,drop,66,66,0,1,0,1,0
51690,445,0,0,drop,70,70,0,1,0,1,0
52117,445,0,0,drop,66,66,0,1,0,1,0
56696,445,0,0,drop,70,70,0,1,0,1,0
51688,445,0,0,drop,70,70,0,1,0,1,0
52115,445,0,0,drop,66,66,0,1,0,1,0
52108,445,0,0,drop,66,66,0,1,0,1,0
57086,53,16252,53,allow,711,87,624,2,30,1,1
52096,443,15286,443,allow,283,163,120,4,15,2,2
50458,80,53639,80,allow,1426,865,561,9,15,5,4
58506,53,0,0,allow,192,86,106,2,30,1,1
57477,53,0,0,allow,186,83,103,2,30,1,1
65518,53,19504,53,allow,701,88,613,2,30,1,1
53550,1,57289,1,allow,70,70,0,1,5,1,0
59793,443,27595,443,allow,840,456,384,14,25,8,6
51681,445,0,0,drop,70,70,0,1,0,1,0
52099,445,0,0,drop,66,66,0,1,0,1,0
51679,445,0,0,drop,70,70,0,1,0,1,0
49766,80,16081,80,allow,254,128,126,5,15,3,2
51677,445,0,0,drop,70,70,0,1,0,1,0
51673,445,0,0,drop,70,70,0,1,0,1,0
56687,445,0,0,drop,70,70,0,1,0,1,0
56686,445,0,0,drop,70,70,0,1,0,1,0
52088,445,0,0,drop,66,66,0,1,0,1,0
52090,445,0,0,drop,66,66,0,1,0,1,0
52084,445,0,0,drop,66,66,0,1,0,1,0
49256,53,47190,53,allow,177,94,83,2,30,1,1
63609,53,0,0,allow,182,81,101,2,30,1,1
55216,53,0,0,allow,192,86,106,2,30,1,1
49767,80,10412,80,allow,70,70,0,1,4,1,0
58941,80,60543,80,allow,1114,534,580,12,15,7,5
56602,80,9300,80,allow,234,234,0,4,11,4,0
63675,123,55630,123,allow,184,94,90,2,29,1,1
64992,53,39214,53,allow,177,94,83,2,29,1,1
64992,53,21333,53,allow,177,94,83,2,29,1,1
56928,80,39650,80,allow,526,304,222,8,35,5,3
47832,80,56253,80,allow,1151,711,440,10,15,5,5
51407,443,57078,443,allow,202,70,132,3,11,1,2
65178,53,0,0,allow,190,85,105,2,30,1,1
64532,53,56480,53,allow,258,110,148,2,30,1,1
56927,80,6442,80,allow,214,140,74,4,35,3,1
55146,53,47576,53,allow,277,110,167,2,30,1,1
56709,53,55050,53,allow,211,102,109,2,30,1,1
59937,443,12788,443,allow,70,70,0,1,5,1,0
58530,53,0,0,allow,188,84,104,2,30,1,1
49256,53,12893,53,allow,177,94,83,2,30,1,1
57357,53,10860,53,allow,231,94,137,2,30,1,1
58110,53,0,0,allow,178,79,99,2,30,1,1
55611,53,41439,53,allow,768,200,568,6,53,3,3
47893,443,63291,443,allow,172,172,0,2,4,2,0
56468,80,52689,80,allow,214,140,74,4,26,3,1
59938,443,3054,443,allow,70,70,0,1,5,1,0
47892,443,55293,443,allow,172,172,0,2,5,2,0
57287,53,47799,53,allow,305,102,203,2,29,1,1
55807,53,4924,53,allow,257,102,155,2,29,1,1
55851,53,42151,53,allow,277,110,167,2,30,1,1
65339,53,32222,53,allow,193,102,91,2,29,1,1
40329,80,42227,80,allow,2128,798,1330,14,46,7,7
55267,53,26990,53,allow,214,102,112,2,29,1,1
64201,53,27931,53,allow,200,94,106,2,29,1,1
64785,53,44600,53,allow,281,94,187,2,29,1,1
65057,53,8165,53,allow,211,94,117,2,30,1,1
64236,53,6587,53,allow,211,102,109,2,30,1,1
53821,53,5224,53,allow,199,94,105,2,30,1,1
46758,123,10814,123,allow,184,94,90,2,30,1,1
56374,53,9778,53,allow,212,102,110,2,30,1,1
40243,443,64916,443,allow,284,164,120,4,15,2,2
64027,53,2870,53,allow,360,97,263,4,38,2,2
62757,123,11526,123,allow,184,94,90,2,30,1,1
50089,53,56216,53,allow,718,94,624,2,30,1,1
64194,53,10058,53,allow,262,126,136,2,30,1,1
64114,53,0,0,allow,200,90,110,2,30,1,1
56120,53,44279,53,allow,177,94,83,2,30,1,1
56120,53,38603,53,allow,177,94,83,2,30,1,1
51204,123,19622,123,allow,184,94,90,2,30,1,1
55326,53,27995,53,allow,177,94,83,2,30,1,1
50036,53,50623,53,allow,353,118,235,2,31,1,1
55366,53,65278,53,allow,79,79,0,2,35,2,0
65347,53,20093,53,allow,352,94,258,2,30,1,1
52092,445,0,0,drop,66,66,0,1,0,1,0
52087,445,0,0,drop,66,66,0,1,0,1,0
52091,445,0,0,drop,66,66,0,1,0,1,0
52085,445,0,0,drop,66,66,0,1,0,1,0
52086,445,0,0,drop,66,66,0,1,0,1,0
51658,445,0,0,drop,70,70,0,1,0,1,0
51657,445,0,0,drop,70,70,0,1,0,1,0
51655,445,0,0,drop,70,70,0,1,0,1,0
51648,445,0,0,drop,70,70,0,1,0,1,0
51647,445,0,0,drop,70,70,0,1,0,1,0
56678,445,0,0,drop,70,70,0,1,0,1,0
56675,445,0,0,drop,70,70,0,1,0,1,0
56669,445,0,0,drop,70,70,0,1,0,1,0
52072,445,0,0,drop,66,66,0,1,0,1,0
52071,445,0,0,drop,66,66,0,1,0,1,0
52070,445,0,0,drop,66,66,0,1,0,1,0
51636,445,0,0,drop,70,70,0,1,0,1,0
56666,445,0,0,drop,70,70,0,1,0,1,0
56663,445,0,0,drop,70,70,0,1,0,1,0
56654,445,0,0,drop,70,70,0,1,0,1,0
56655,445,0,0,drop,70,70,0,1,0,1,0
56652,445,0,0,drop,70,70,0,1,0,1,0
40082,22,0,0,deny,60,60,0,1,0,1,0
51632,445,0,0,drop,70,70,0,1,0,1,0
51623,445,0,0,drop,70,70,0,1,0,1,0
51617,445,0,0,drop,70,70,0,1,0,1,0
51620,445,0,0,drop,70,70,0,1,0,1,0
51616,445,0,0,drop,70,70,0,1,0,1,0
56641,445,0,0,drop,70,70,0,1,0,1,0
56639,445,0,0,drop,70,70,0,1,0,1,0
52050,445,0,0,drop,66,66,0,1,0,1,0
56638,445,0,0,drop,70,70,0,1,0,1,0
56637,445,0,0,drop,70,70,0,1,0,1,0
51602,445,0,0,drop,70,70,0,1,0,1,0
51599,445,0,0,drop,70,70,0,1,0,1,0
58458,17,0,0,deny,60,60,0,1,0,1,0
52041,445,0,0,drop,66,66,0,1,0,1,0
51596,445,0,0,drop,70,70,0,1,0,1,0
51594,445,0,0,drop,70,70,0,1,0,1,0
52040,445,0,0,drop,66,66,0,1,0,1,0
56628,445,0,0,drop,70,70,0,1,0,1,0
56620,445,0,0,drop,70,70,0,1,0,1,0
56616,445,0,0,drop,70,70,0,1,0,1,0
52037,445,0,0,drop,66,66,0,1,0,1,0
51590,445,0,0,drop,70,70,0,1,0,1,0
51589,445,0,0,drop,70,70,0,1,0,1,0
56613,445,0,0,deny,70,70,0,1,0,1,0
56606,445,0,0,drop,70,70,0,1,0,1,0
56604,445,0,0,drop,70,70,0,1,0,1,0
52029,445,0,0,drop,66,66,0,1,0,1,0
52027,445,0,0,drop,66,66,0,1,0,1,0
52025,445,0,0,drop,66,66,0,1,0,1,0
52022,445,0,0,drop,66,66,0,1,0,1,0
52020,445,0,0,drop,66,66,0,1,0,1,0
52021,445,0,0,drop,66,66,0,1,0,1,0
55468,23,0,0,deny,60,60,0,1,0,1,0
56601,445,0,0,drop,70,70,0,1,0,1,0
56600,445,0,0,drop,70,70,0,1,0,1,0
56598,445,0,0,drop,70,70,0,1,0,1,0
52017,445,0,0,drop,66,66,0,1,0,1,0
52012,445,0,0,drop,66,66,0,1,0,1,0
52010,445,0,0,drop,66,66,0,1,0,1,0
52009,445,0,0,drop,66,66,0,1,0,1,0
52007,445,0,0,drop,66,66,0,1,0,1,0
51571,445,0,0,drop,70,70,0,1,0,1,0
51568,445,0,0,drop,70,70,0,1,0,1,0
56583,445,0,0,drop,70,70,0,1,0,1,0
56581,445,0,0,drop,70,70,0,1,0,1,0
50502,123,48233,123,allow,184,94,90,2,30,1,1
55326,53,8434,53,allow,170,87,83,2,30,1,1
52625,53,52625,53,allow,231,88,143,2,32,1,1
50622,53,42098,53,allow,202,83,119,2,30,1,1
39207,80,48256,80,allow,234,234,0,4,12,4,0
44206,53,19423,53,allow,202,83,119,2,30,1,1
50172,443,41441,443,allow,161,101,60,2,5,1,1
53760,80,45731,80,allow,1667,619,1048,10,45,6,4
65348,53,36995,53,allow,170,87,83,2,30,1,1
51997,445,0,0,drop,66,66,0,1,0,1,0
51563,445,0,0,drop,70,70,0,1,0,1,0
51562,445,0,0,drop,70,70,0,1,0,1,0
55326,53,39375,53,allow,177,94,83,2,29,1,1
40232,53,19769,53,allow,205,86,119,2,29,1,1
55594,53,28823,53,allow,168,78,90,2,30,1,1
57714,53,57714,53,allow,233,90,143,2,32,1,1
63737,80,37849,80,allow,314,192,122,6,15,4,2
42128,80,52556,80,allow,1139,506,633,10,15,6,4
51399,443,28295,443,allow,642,582,60,2,5,1,1
65198,53,6063,53,allow,448,94,354,4,49,2,2
47808,53,24079,53,allow,168,78,90,2,30,1,1
65426,53,23528,53,allow,706,195,511,6,52,3,3
56541,443,9751,443,allow,130,70,60,2,15,1,1
64805,53,57151,53,allow,215,102,113,2,30,1,1
42686,443,38351,443,allow,190,70,120,4,15,2,2
51774,80,22011,80,allow,240,120,120,5,27,3,2
45619,80,13038,80,allow,1052,612,440,10,15,5,5
46291,443,48252,443,allow,70,70,0,1,5,1,0
53227,53,29917,53,allow,205,86,119,2,29,1,1
49260,53,27595,53,allow,177,86,91,2,29,1,1
49619,53,1376,53,allow,184,86,98,2,30,1,1
65348,53,2839,53,allow,177,94,83,2,30,1,1
58663,53,40233,53,allow,167,78,89,2,30,1,1
54020,53,54020,53,allow,233,90,143,2,32,1,1
51398,443,32490,443,allow,322,262,60,2,5,1,1
64133,53,49082,53,allow,225,110,115,2,30,1,1
53860,53,53860,53,allow,197,90,107,2,30,1,1
55326,53,7571,53,allow,177,94,83,2,30,1,1
50096,53,50096,53,allow,197,90,107,2,30,1,1
55440,53,55440,53,allow,220,90,130,2,30,1,1
48755,53,17288,53,allow,168,78,90,2,30,1,1
58662,53,17171,53,allow,167,78,89,2,31,1,1
63926,53,50565,53,allow,260,102,158,2,31,1,1
65183,53,44616,53,allow,718,94,624,2,31,1,1
49664,443,7925,443,allow,134,60,74,3,6,2,1
49449,80,5830,80,allow,1948,912,1036,13,56,7,6
44187,53,44187,53,allow,233,90,143,2,32,1,1
49624,53,37843,53,allow,216,94,122,2,30,1,1
57082,53,1107,53,allow,211,102,109,2,30,1,1
39054,53,31083,53,allow,168,78,90,2,30,1,1
65348,53,40565,53,allow,177,94,83,2,30,1,1
51989,445,0,0,drop,66,66,0,1,0,1,0
56567,445,0,0,drop,70,70,0,1,0,1,0
51986,445,0,0,drop,66,66,0,1,0,1,0
51553,445,0,0,drop,70,70,0,1,0,1,0
51977,445,0,0,drop,66,66,0,1,0,1,0
51549,445,0,0,drop,70,70,0,1,0,1,0
51975,445,0,0,drop,66,66,0,1,0,1,0
51546,445,0,0,deny,70,70,0,1,0,1,0
56556,445,0,0,drop,70,70,0,1,0,1,0
56555,445,0,0,drop,70,70,0,1,0,1,0
51528,445,0,0,drop,70,70,0,1,0,1,0
51527,445,0,0,drop,70,70,0,1,0,1,0
51961,445,0,0,drop,66,66,0,1,0,1,0
51962,445,0,0,drop,66,66,0,1,0,1,0
51963,445,0,0,deny,66,66,0,1,0,1,0
51960,445,0,0,drop,66,66,0,1,0,1,0
51959,445,0,0,drop,66,66,0,1,0,1,0
51957,445,0,0,drop,66,66,0,1,0,1,0
51956,445,0,0,drop,66,66,0,1,0,1,0
51517,445,0,0,drop,70,70,0,1,0,1,0
51518,445,0,0,drop,70,70,0,1,0,1,0
57098,1,0,0,deny,78,78,0,1,0,1,0
56553,445,0,0,drop,70,70,0,1,0,1,0
56539,445,0,0,drop,70,70,0,1,0,1,0
51506,445,0,0,drop,70,70,0,1,0,1,0
51943,445,0,0,drop,66,66,0,1,0,1,0
51940,445,0,0,drop,66,66,0,1,0,1,0
51941,445,0,0,drop,66,66,0,1,0,1,0
56537,445,0,0,drop,70,70,0,1,0,1,0
56535,445,0,0,drop,70,70,0,1,0,1,0
51502,445,0,0,drop,70,70,0,1,0,1,0
56531,445,0,0,drop,70,70,0,1,0,1,0
56527,445,0,0,drop,70,70,0,1,0,1,0
56524,445,0,0,drop,70,70,0,1,0,1,0
51491,445,0,0,drop,70,70,0,1,0,1,0
51493,445,0,0,drop,70,70,0,1,0,1,0
51489,445,0,0,drop,70,70,0,1,0,1,0
51488,445,0,0,drop,70,70,0,1,0,1,0
51486,445,0,0,drop,70,70,0,1,0,1,0
51472,445,0,0,drop,70,70,0,1,0,1,0
51918,445,0,0,drop,66,66,0,1,0,1,0
56510,445,0,0,drop,70,70,0,1,0,1,0
56508,445,0,0,drop,70,70,0,1,0,1,0
51463,445,0,0,drop,70,70,0,1,0,1,0
51462,445,0,0,drop,70,70,0,1,0,1,0
37571,443,14290,443,allow,499,425,74,4,0,3,1
37574,443,27983,443,allow,499,425,74,4,0,3,1
37573,443,61773,443,allow,499,425,74,4,0,3,1
37572,443,25877,443,allow,499,425,74,4,0,3,1
37570,443,49846,443,allow,499,425,74,4,0,3,1
37569,443,25156,443,allow,499,425,74,4,0,3,1
51914,445,0,0,drop,66,66,0,1,0,1,0
51911,445,0,0,drop,66,66,0,1,0,1,0
56495,445,0,0,drop,70,70,0,1,0,1,0
56489,445,0,0,drop,70,70,0,1,0,1,0
56488,445,0,0,drop,70,70,0,1,0,1,0
51908,445,0,0,drop,66,66,0,1,0,1,0
56482,445,0,0,drop,70,70,0,1,0,1,0
56477,445,0,0,drop,70,70,0,1,0,1,0
56478,445,0,0,drop,70,70,0,1,0,1,0
51902,445,0,0,drop,66,66,0,1,0,1,0
51452,445,0,0,drop,70,70,0,1,0,1,0
51893,445,0,0,drop,66,66,0,1,0,1,0
51896,445,0,0,drop,66,66,0,1,0,1,0
51897,445,0,0,drop,66,66,0,1,0,1,0
51891,445,0,0,drop,66,66,0,1,0,1,0
51892,445,0,0,drop,66,66,0,1,0,1,0
51889,445,0,0,drop,66,66,0,1,0,1,0
56474,445,0,0,drop,70,70,0,1,0,1,0
56471,445,0,0,drop,70,70,0,1,0,1,0
56469,445,0,0,drop,70,70,0,1,0,1,0
51887,445,0,0,drop,66,66,0,1,0,1,0
51884,445,0,0,drop,66,66,0,1,0,1,0
51882,445,0,0,drop,66,66,0,1,0,1,0
51881,445,0,0,drop,66,66,0,1,0,1,0
57512,80,20735,80,allow,1377,881,496,12,48,7,5
49736,443,37577,443,allow,378,192,186,7,15,4,3
62462,53,62462,53,allow,238,99,139,2,30,1,1
58046,53,58046,53,allow,231,88,143,2,32,1,1
52629,53,0,0,allow,232,77,155,2,33,1,1
41322,443,7553,443,allow,153,93,60,2,5,1,1
52540,443,62112,443,allow,153,93,60,2,5,1,1
54105,443,23340,443,allow,2227,1018,1209,17,16,8,9
49285,53,48057,53,allow,168,78,90,2,30,1,1
60419,53,60419,53,allow,217,87,130,2,30,1,1
55890,53,46214,53,allow,711,87,624,2,30,1,1
57568,53,57568,53,allow,235,98,137,2,30,1,1
57371,53,40591,53,allow,728,96,632,2,30,1,1
40631,53,40631,53,allow,262,107,155,2,30,1,1
51439,445,0,0,drop,70,70,0,1,0,1,0
51878,445,0,0,drop,66,66,0,1,0,1,0
51464,23,0,0,deny,60,60,0,1,0,1,0
51436,445,0,0,drop,70,70,0,1,0,1,0
49772,80,25587,80,allow,1155,781,374,10,15,6,4
49526,53,60849,53,allow,402,118,284,2,30,1,1
57009,53,8536,53,allow,177,94,83,2,30,1,1
57224,53,20310,53,allow,532,198,334,6,50,3,3
43837,443,27944,443,allow,70,70,0,1,4,1,0
65273,53,14991,53,allow,338,110,228,2,29,1,1
64338,53,55215,53,allow,292,102,190,2,29,1,1
44883,53,44883,53,allow,216,90,126,2,29,1,1
65348,53,17423,53,allow,177,94,83,2,29,1,1
58659,53,58909,53,allow,167,78,89,2,30,1,1
56176,53,8371,53,allow,194,102,92,2,30,1,1
56601,80,22349,80,allow,234,234,0,4,12,4,0
57396,53,39255,53,allow,358,102,256,2,30,1,1
55114,53,53852,53,allow,392,100,292,4,33,2,2
46442,80,6730,80,allow,1373,669,704,10,16,5,5
49774,53,5014,53,allow,236,94,142,2,30,1,1
55229,53,55587,53,allow,199,94,105,2,30,1,1
59175,53,63239,53,allow,168,78,90,2,30,1,1
57009,53,48433,53,allow,177,94,83,2,30,1,1
63264,53,63264,53,allow,197,90,107,2,30,1,1
49796,53,34008,53,allow,238,102,136,2,30,1,1
57353,443,32586,443,allow,150,150,0,1,5,1,0
56964,53,13707,53,allow,267,87,180,4,57,2,2
61492,80,29860,80,allow,901,398,503,10,15,5,5
65287,53,32403,53,allow,222,86,136,2,30,1,1
56126,53,59441,53,allow,336,110,226,2,29,1,1
55567,53,55567,53,allow,216,90,126,2,30,1,1
49553,53,5635,53,allow,614,239,375,6,53,3,3
58664,53,10827,53,allow,167,78,89,2,29,1,1
49419,53,3552,53,allow,343,100,243,4,52,2,2
43484,443,55073,443,allow,130,70,60,2,15,1,1
49610,53,9285,53,allow,168,78,90,2,30,1,1
50645,53,27805,53,allow,177,94,83,2,30,1,1
52629,53,0,0,allow,418,154,264,4,33,2,2
64657,53,35491,53,allow,370,96,274,4,39,2,2
59179,53,29104,53,allow,260,86,174,2,30,1,1
50209,53,40978,53,allow,86,86,0,1,30,1,0
61712,80,5502,80,allow,1864,1024,840,10,16,6,4
56291,53,51569,53,allow,260,102,158,2,30,1,1
58658,53,27150,53,allow,260,86,174,2,30,1,1
46297,80,56497,80,allow,1155,781,374,10,15,6,4
50645,53,59508,53,allow,177,94,83,2,30,1,1
54807,53,14408,53,allow,206,86,120,2,30,1,1
41296,80,53379,80,allow,1056,682,374,10,15,6,4
52322,53,58058,53,allow,86,86,0,1,30,1,0
63968,53,61368,53,allow,310,142,168,2,30,1,1
56462,445,0,0,drop,70,70,0,1,0,1,0
56454,445,0,0,drop,70,70,0,1,0,1,0
56450,445,0,0,drop,70,70,0,1,0,1,0
37568,443,2020,443,allow,499,425,74,4,0,3,1
37564,443,36169,443,allow,499,425,74,4,0,3,1
37567,443,17651,443,allow,499,425,74,4,0,3,1
37566,443,23464,443,allow,499,425,74,4,0,3,1
37563,443,52126,443,allow,499,425,74,4,0,3,1
37565,443,6723,443,allow,499,425,74,4,0,3,1
51870,445,0,0,drop,66,66,0,1,0,1,0
51430,445,0,0,drop,70,70,0,1,0,1,0
51428,445,0,0,drop,70,70,0,1,0,1,0
51859,445,0,0,drop,66,66,0,1,0,1,0
56439,445,0,0,drop,70,70,0,1,0,1,0
51856,445,0,0,drop,66,66,0,1,0,1,0
51421,445,0,0,drop,70,70,0,1,0,1,0
51848,445,0,0,drop,66,66,0,1,0,1,0
51418,445,0,0,drop,70,70,0,1,0,1,0
51840,445,0,0,drop,66,66,0,1,0,1,0
51411,445,0,0,drop,70,70,0,1,0,1,0
51398,445,0,0,drop,70,70,0,1,0,1,0
51397,445,0,0,drop,70,70,0,1,0,1,0
51391,445,0,0,drop,70,70,0,1,0,1,0
51388,445,0,0,drop,70,70,0,1,0,1,0
51387,445,0,0,drop,70,70,0,1,0,1,0
56430,445,0,0,drop,70,70,0,1,0,1,0
56428,445,0,0,drop,70,70,0,1,0,1,0
56427,445,0,0,drop,70,70,0,1,0,1,0
51832,445,0,0,drop,66,66,0,1,0,1,0
51833,445,0,0,drop,66,66,0,1,0,1,0
51834,445,0,0,drop,66,66,0,1,0,1,0
51831,445,0,0,drop,66,66,0,1,0,1,0
51827,445,0,0,drop,66,66,0,1,0,1,0
51829,445,0,0,drop,66,66,0,1,0,1,0
51828,445,0,0,drop,66,66,0,1,0,1,0
51826,445,0,0,drop,66,66,0,1,0,1,0
51376,445,0,0,drop,70,70,0,1,0,1,0
53745,443,56954,443,allow,499,425,74,4,0,3,1
53744,443,46972,443,allow,499,425,74,4,0,3,1
56422,445,0,0,drop,70,70,0,1,0,1,0
56417,445,0,0,drop,70,70,0,1,0,1,0
56412,445,0,0,drop,70,70,0,1,0,1,0
51814,445,0,0,drop,66,66,0,1,0,1,0
51813,445,0,0,drop,66,66,0,1,0,1,0
51812,445,0,0,drop,66,66,0,1,0,1,0
56410,445,0,0,drop,70,70,0,1,0,1,0
56407,445,0,0,drop,70,70,0,1,0,1,0
56406,445,0,0,drop,70,70,0,1,0,1,0
56403,445,0,0,drop,70,70,0,1,0,1,0
56395,445,0,0,drop,70,70,0,1,0,1,0
51361,445,0,0,drop,70,70,0,1,0,1,0
51363,445,0,0,drop,70,70,0,1,0,1,0
51359,445,0,0,drop,70,70,0,1,0,1,0
51358,445,0,0,drop,70,70,0,1,0,1,0
51355,445,0,0,drop,70,70,0,1,0,1,0
56385,445,0,0,drop,70,70,0,1,0,1,0
51350,445,0,0,drop,70,70,0,1,0,1,0
51342,445,0,0,drop,70,70,0,1,0,1,0
51340,445,0,0,drop,70,70,0,1,0,1,0
51788,445,0,0,drop,66,66,0,1,0,1,0
56380,445,0,0,drop,70,70,0,1,0,1,0
61524,23,0,0,deny,60,60,0,1,0,1,0
51335,445,0,0,drop,70,70,0,1,0,1,0
51334,445,0,0,drop,70,70,0,1,0,1,0
51783,445,0,0,drop,66,66,0,1,0,1,0
51782,445,0,0,drop,66,66,0,1,0,1,0
51330,445,0,0,drop,70,70,0,1,0,1,0
56368,445,0,0,drop,70,70,0,1,0,1,0
56364,445,0,0,drop,70,70,0,1,0,1,0
56361,445,0,0,drop,70,70,0,1,0,1,0
56360,445,0,0,drop,70,70,0,1,0,1,0
51781,445,0,0,drop,66,66,0,1,0,1,0
56354,445,0,0,drop,70,70,0,1,0,1,0
56352,445,0,0,drop,70,70,0,1,0,1,0
56351,445,0,0,drop,70,70,0,1,0,1,0
56348,445,0,0,drop,70,70,0,1,0,1,0
51324,445,0,0,drop,70,70,0,1,0,1,0
59738,443,4655,443,allow,510,164,346,2,31,1,1
38085,443,1147,443,allow,78,78,0,1,5,1,0
56964,53,45347,53,allow,267,87,180,4,54,2,2
64530,53,55254,53,allow,261,87,174,4,45,2,2
49523,53,10736,53,allow,728,96,632,2,30,1,1
59737,53,18837,53,allow,382,164,218,2,31,1,1
56923,53,49262,53,allow,711,87,624,2,30,1,1
39871,53,52816,53,allow,198,93,105,2,31,1,1
51773,445,0,0,drop,66,66,0,1,0,1,0
51769,445,0,0,drop,66,66,0,1,0,1,0
51768,445,0,0,drop,66,66,0,1,0,1,0
51764,445,0,0,drop,66,66,0,1,0,1,0
52514,23,0,0,deny,60,60,0,1,0,1,0
51763,445,0,0,drop,66,66,0,1,0,1,0
51762,445,0,0,drop,66,66,0,1,0,1,0
51761,445,0,0,drop,66,66,0,1,0,1,0
64375,53,1918,53,allow,228,110,118,2,29,1,1
57305,53,63466,53,allow,177,94,83,2,30,1,1
42922,80,60551,80,allow,78,78,0,1,4,1,0
64882,53,49587,53,allow,279,126,153,2,30,1,1
49848,53,60109,53,allow,260,102,158,2,30,1,1
60062,53,61702,53,allow,168,78,90,2,30,1,1
38321,80,40490,80,allow,543,469,74,6,16,5,1
64530,53,18888,53,allow,261,87,174,4,45,2,2
64573,53,58393,53,allow,558,104,454,4,49,2,2
50501,123,36469,123,allow,184,94,90,2,30,1,1
57305,53,33562,53,allow,177,94,83,2,30,1,1
59739,443,20531,443,allow,304,86,218,2,30,1,1
62947,53,18275,53,allow,213,86,127,2,30,1,1
55596,53,49236,53,allow,177,94,83,2,30,1,1
39640,53,64225,53,allow,168,78,90,2,30,1,1
46167,80,23731,80,allow,234,234,0,4,11,4,0
57416,66,12942,66,allow,70,70,0,1,4,1,0
56964,53,17076,53,allow,267,87,180,4,53,2,2
47110,80,30489,80,allow,436,222,214,7,19,4,3
65248,53,8659,53,allow,197,94,103,2,30,1,1
64218,53,41220,53,allow,212,94,118,2,30,1,1
49915,53,47403,53,allow,225,102,123,2,30,1,1
56661,53,1967,53,allow,900,110,790,2,30,1,1
57165,53,9169,53,allow,216,102,114,2,30,1,1
41882,53,0,0,allow,86,86,0,1,29,1,0
59740,53,42403,53,allow,304,86,218,2,30,1,1
59727,443,28777,443,allow,304,86,218,2,31,1,1
59725,443,21996,443,allow,304,86,218,2,31,1,1
59731,443,4869,443,allow,384,166,218,2,31,1,1
52907,80,17763,80,allow,1659,653,1006,10,16,6,4
59742,53,55013,53,allow,448,166,282,2,30,1,1
56207,53,30514,53,allow,260,102,158,2,30,1,1
56964,53,61136,53,allow,267,87,180,4,59,2,2
59741,443,12538,443,allow,384,166,218,2,30,1,1
64720,53,3807,53,allow,216,102,114,2,30,1,1
57264,53,9791,53,allow,214,102,112,2,30,1,1
50112,123,33230,123,allow,184,94,90,2,30,1,1
64530,53,39688,53,allow,261,87,174,4,46,2,2
56378,53,11573,53,allow,214,102,112,2,30,1,1
55704,53,11582,53,allow,260,102,158,2,30,1,1
59733,53,57614,53,allow,384,166,218,2,30,1,1
53556,1024,53867,1024,allow,70,70,0,2,8,2,0
50978,80,46474,80,allow,1442,700,742,12,35,6,6
56345,445,0,0,drop,70,70,0,1,0,1,0
56343,445,0,0,drop,70,70,0,1,0,1,0
56342,445,0,0,drop,70,70,0,1,0,1,0
51759,445,0,0,drop,66,66,0,1,0,1,0
52401,623,0,0,deny,60,60,0,1,0,1,0
51755,445,0,0,drop,66,66,0,1,0,1,0
51311,445,0,0,drop,70,70,0,1,0,1,0
51753,445,0,0,drop,66,66,0,1,0,1,0
51752,445,0,0,drop,66,66,0,1,0,1,0
51749,445,0,0,drop,66,66,0,1,0,1,0
56335,445,0,0,drop,70,70,0,1,0,1,0
56324,445,0,0,drop,70,70,0,1,0,1,0
51304,445,0,0,drop,70,70,0,1,0,1,0
51302,445,0,0,drop,70,70,0,1,0,1,0
51737,445,0,0,drop,66,66,0,1,0,1,0
51300,445,0,0,drop,70,70,0,1,0,1,0
51730,445,0,0,drop,66,66,0,1,0,1,0
56311,445,0,0,drop,70,70,0,1,0,1,0
51293,445,0,0,drop,70,70,0,1,0,1,0
51727,445,0,0,drop,66,66,0,1,0,1,0
51290,445,0,0,drop,70,70,0,1,0,1,0
51720,445,0,0,drop,66,66,0,1,0,1,0
51288,445,0,0,drop,70,70,0,1,0,1,0
51283,445,0,0,drop,70,70,0,1,0,1,0
51713,445,0,0,drop,66,66,0,1,0,1,0
53743,443,64755,443,allow,495,421,74,4,1,3,1
51270,445,0,0,drop,70,70,0,1,0,1,0
51268,445,0,0,drop,70,70,0,1,0,1,0
51264,445,0,0,drop,70,70,0,1,0,1,0
51260,445,0,0,drop,70,70,0,1,0,1,0
51259,445,0,0,drop,70,70,0,1,0,1,0
56303,445,0,0,drop,70,70,0,1,0,1,0
56301,445,0,0,drop,70,70,0,1,0,1,0
56299,445,0,0,drop,70,70,0,1,0,1,0
51702,445,0,0,drop,66,66,0,1,0,1,0
51704,445,0,0,drop,66,66,0,1,0,1,0
51701,445,0,0,drop,66,66,0,1,0,1,0
51699,445,0,0,drop,66,66,0,1,0,1,0
51697,445,0,0,drop,66,66,0,1,0,1,0
51705,445,0,0,drop,66,66,0,1,0,1,0
51700,445,0,0,drop,66,66,0,1,0,1,0
51698,445,0,0,drop,66,66,0,1,0,1,0
51248,445,0,0,drop,70,70,0,1,0,1,0
56292,445,0,0,drop,70,70,0,1,0,1,0
56285,445,0,0,drop,70,70,0,1,0,1,0
51685,445,0,0,drop,66,66,0,1,0,1,0
51684,445,0,0,drop,66,66,0,1,0,1,0
51682,445,0,0,drop,66,66,0,1,0,1,0
51244,445,0,0,drop,70,70,0,1,0,1,0
56282,445,0,0,drop,70,70,0,1,0,1,0
56279,445,0,0,drop,70,70,0,1,0,1,0
51235,445,0,0,drop,70,70,0,1,0,1,0
56278,445,0,0,drop,70,70,0,1,0,1,0
56269,445,0,0,drop,70,70,0,1,0,1,0
56267,445,0,0,drop,70,70,0,1,0,1,0
51229,445,0,0,drop,70,70,0,1,0,1,0
51231,445,0,0,drop,70,70,0,1,0,1,0
51227,445,0,0,drop,70,70,0,1,0,1,0
56262,445,0,0,drop,70,70,0,1,0,1,0
56255,445,0,0,drop,70,70,0,1,0,1,0
51214,445,0,0,drop,70,70,0,1,0,1,0
51212,445,0,0,drop,70,70,0,1,0,1,0
51661,445,0,0,drop,66,66,0,1,0,1,0
56279,23,0,0,deny,60,60,0,1,0,1,0
56251,445,0,0,drop,70,70,0,1,0,1,0
56246,445,0,0,drop,70,70,0,1,0,1,0
51207,445,0,0,drop,70,70,0,1,0,1,0
51206,445,0,0,drop,70,70,0,1,0,1,0
51202,445,0,0,drop,70,70,0,1,0,1,0
64663,53,18610,53,allow,578,286,292,9,15,5,4
51139,80,1947,80,allow,124,64,60,2,15,1,1
55596,53,61686,53,allow,170,87,83,2,30,1,1
43014,53,60826,53,allow,198,93,105,2,30,1,1
59729,53,2967,53,allow,303,85,218,2,30,1,1
51357,80,45603,80,allow,124,64,60,2,16,1,1
59730,443,46246,443,allow,303,85,218,2,30,1,1
56704,53,33003,53,allow,711,87,624,2,30,1,1
51655,445,0,0,drop,66,66,0,1,0,1,0
51653,445,0,0,drop,66,66,0,1,0,1,0
56239,445,0,0,drop,70,70,0,1,0,1,0
51200,445,0,0,drop,70,70,0,1,0,1,0
56237,445,0,0,drop,70,70,0,1,0,1,0
56232,445,0,0,drop,70,70,0,1,0,1,0
51651,445,0,0,drop,66,66,0,1,0,1,0
51196,445,0,0,drop,70,70,0,1,0,1,0
56225,445,0,0,drop,70,70,0,1,0,1,0
56224,445,0,0,drop,70,70,0,1,0,1,0
56220,445,0,0,drop,70,70,0,1,0,1,0
51643,445,0,0,drop,66,66,0,1,0,1,0
51641,445,0,0,drop,66,66,0,1,0,1,0
51640,445,0,0,drop,66,66,0,1,0,1,0
51639,445,0,0,drop,66,66,0,1,0,1,0
51634,445,0,0,drop,66,66,0,1,0,1,0
51632,445,0,0,drop,66,66,0,1,0,1,0
51633,445,0,0,drop,66,66,0,1,0,1,0
56218,445,0,0,drop,70,70,0,1,0,1,0
51643,80,38570,80,allow,499,192,307,6,38,4,2
49836,53,62893,53,allow,168,78,90,2,30,1,1
51657,80,10496,80,allow,318,192,126,6,37,4,2
49565,443,37074,443,allow,378,192,186,7,14,4,3
51658,80,29469,80,allow,318,192,126,6,37,4,2
51645,80,57006,80,allow,318,192,126,6,38,4,2
51632,80,60453,80,allow,502,256,246,9,39,5,4
55878,53,24199,53,allow,260,102,158,2,29,1,1
59736,53,9602,53,allow,571,166,405,2,29,1,1
59735,443,11235,443,allow,512,166,346,2,29,1,1
55596,53,19558,53,allow,177,94,83,2,30,1,1
56046,53,22169,53,allow,289,160,129,3,29,2,1
51650,80,16811,80,allow,312,192,120,6,37,4,2
51635,80,49291,80,allow,318,192,126,6,39,4,2
56665,53,16180,53,allow,216,102,114,2,30,1,1
56546,53,5266,53,allow,177,94,83,2,30,1,1
56060,53,26992,53,allow,224,102,122,2,30,1,1
64945,53,32076,53,allow,733,94,639,2,30,1,1
51654,80,46130,80,allow,318,192,126,6,37,4,2
53715,443,59918,443,allow,70,70,0,1,5,1,0
56600,80,32176,80,allow,234,234,0,4,12,4,0
51634,80,59507,80,allow,378,192,186,7,39,4,3
59166,123,2980,123,allow,184,94,90,2,30,1,1
56912,53,43272,53,allow,216,94,122,2,30,1,1
47302,53,19968,53,allow,168,78,90,2,30,1,1
53864,53,19118,53,allow,168,78,90,2,30,1,1
56546,53,1301,53,allow,177,94,83,2,30,1,1
39458,443,56911,443,allow,1053,566,487,10,31,6,4
51647,80,60876,80,allow,378,192,186,7,38,4,3
39310,53,33057,53,allow,199,94,105,2,30,1,1
63628,53,35423,53,allow,289,86,203,2,30,1,1
53772,53,7783,53,allow,70,70,0,1,30,1,0
56920,53,48525,53,allow,184,78,106,2,30,1,1
51646,80,56559,80,allow,378,192,186,7,38,4,3
51653,80,24193,80,allow,454,262,192,8,37,5,3
51637,80,27014,80,allow,378,192,186,7,39,4,3
51659,80,25484,80,allow,318,192,126,6,37,4,2
50014,80,33183,80,allow,810,670,140,6,34,4,2
51652,80,59640,80,allow,454,262,192,8,37,5,3
51644,80,3834,80,allow,499,192,307,6,38,4,2
51655,80,54219,80,allow,318,192,126,6,37,4,2
64530,53,20478,53,allow,261,87,174,4,44,2,2
51636,80,6805,80,allow,318,192,126,6,39,4,2
51638,80,60451,80,allow,318,192,126,6,39,4,2
55596,53,2008,53,allow,177,94,83,2,29,1,1
58711,53,20725,53,allow,277,78,199,2,30,1,1
65235,53,39902,53,allow,216,94,122,2,30,1,1
59734,443,60915,443,allow,512,166,346,2,29,1,1
59178,53,27947,53,allow,260,86,174,2,30,1,1
59732,53,64408,53,allow,384,166,218,2,30,1,1
59728,53,43809,53,allow,304,86,218,2,30,1,1
59726,53,53950,53,allow,304,86,218,2,30,1,1
41039,443,10141,443,allow,1053,566,487,10,31,6,4
58046,443,22923,443,allow,1536,1089,447,11,56,7,4
56421,53,8309,53,allow,177,94,83,2,30,1,1
51633,80,4651,80,allow,502,256,246,9,39,5,4
46236,53,38054,53,allow,199,94,105,2,30,1,1
56261,53,65402,53,allow,199,94,105,2,30,1,1
49872,53,15358,53,allow,216,94,122,2,30,1,1
51656,80,3808,80,allow,318,192,126,6,37,4,2
59724,53,63001,53,allow,304,86,218,2,30,1,1
59723,443,40207,443,allow,304,86,218,2,30,1,1
57173,53,39121,53,allow,168,78,90,2,30,1,1
55008,53,19602,53,allow,215,102,113,2,30,1,1
60740,80,7735,80,allow,254,128,126,5,16,3,2
65109,53,42813,53,allow,229,102,127,2,30,1,1
56759,53,36247,53,allow,733,94,639,2,31,1,1
65388,80,37790,80,allow,1498,392,1106,10,16,5,5
51466,443,4846,443,allow,1878,1050,828,9,16,5,4
49923,53,8519,53,allow,702,194,508,6,67,3,3
53785,53,12230,53,allow,167,78,89,2,31,1,1
56215,445,0,0,drop,70,70,0,1,0,1,0
56212,445,0,0,drop,70,70,0,1,0,1,0
51183,445,0,0,drop,70,70,0,1,0,1,0
51628,445,0,0,drop,66,66,0,1,0,1,0
56211,445,0,0,drop,70,70,0,1,0,1,0
51625,445,0,0,drop,66,66,0,1,0,1,0
51623,445,0,0,drop,66,66,0,1,0,1,0
51622,445,0,0,drop,66,66,0,1,0,1,0
51180,445,0,0,drop,70,70,0,1,0,1,0
51619,445,0,0,drop,66,66,0,1,0,1,0
51174,445,0,0,drop,70,70,0,1,0,1,0
56192,445,0,0,drop,70,70,0,1,0,1,0
51172,445,0,0,drop,70,70,0,1,0,1,0
51608,445,0,0,drop,66,66,0,1,0,1,0
51601,445,0,0,drop,66,66,0,1,0,1,0
51165,445,0,0,drop,70,70,0,1,0,1,0
51599,445,0,0,drop,66,66,0,1,0,1,0
51162,445,0,0,drop,70,70,0,1,0,1,0
51161,445,0,0,drop,70,70,0,1,0,1,0
51157,445,0,0,drop,70,70,0,1,0,1,0
51156,445,0,0,drop,70,70,0,1,0,1,0
51590,445,0,0,drop,66,66,0,1,0,1,0
51586,445,0,0,drop,66,66,0,1,0,1,0
53737,443,15661,443,allow,499,425,74,4,0,3,1
53738,443,58635,443,allow,499,425,74,4,0,3,1
53739,443,35645,443,allow,499,425,74,4,0,3,1
53735,443,34476,443,allow,499,425,74,4,0,3,1
53736,443,20137,443,allow,499,425,74,4,0,3,1
53733,443,35168,443,allow,499,425,74,4,0,3,1
53734,443,22403,443,allow,499,425,74,4,0,3,1
53732,443,58255,443,allow,499,425,74,4,0,3,1
53730,443,15340,443,allow,499,425,74,4,0,3,1
53729,443,15910,443,allow,499,425,74,4,0,3,1
53731,443,61889,443,allow,499,425,74,4,0,3,1
53727,443,53687,443,allow,499,425,74,4,0,3,1
51142,445,0,0,drop,70,70,0,1,0,1,0
51140,445,0,0,drop,70,70,0,1,0,1,0
51136,445,0,0,drop,70,70,0,1,0,1,0
51132,445,0,0,drop,70,70,0,1,0,1,0
51131,445,0,0,drop,70,70,0,1,0,1,0
53728,443,11260,443,allow,499,425,74,4,0,3,1
53725,443,12003,443,allow,499,425,74,4,0,3,1
53726,443,39961,443,allow,499,425,74,4,0,3,1
53721,443,9349,443,allow,499,425,74,4,0,3,1
53724,443,54768,443,allow,499,425,74,4,0,3,1
53723,443,16354,443,allow,499,425,74,4,0,3,1
53722,443,25032,443,allow,499,425,74,4,0,3,1
53720,443,24279,443,allow,499,425,74,4,0,3,1
53716,443,47571,443,allow,499,425,74,4,0,3,1
53717,443,51020,443,allow,499,425,74,4,0,3,1
53718,443,3459,443,allow,499,425,74,4,0,3,1
53719,443,17807,443,allow,499,425,74,4,0,3,1
56174,445,0,0,drop,70,70,0,1,0,1,0
56173,445,0,0,drop,70,70,0,1,0,1,0
56171,445,0,0,drop,70,70,0,1,0,1,0
51576,445,0,0,drop,66,66,0,1,0,1,0
51568,445,0,0,drop,66,66,0,1,0,1,0
51575,445,0,0,drop,66,66,0,1,0,1,0
51574,445,0,0,drop,66,66,0,1,0,1,0
51573,445,0,0,drop,66,66,0,1,0,1,0
51570,445,0,0,drop,66,66,0,1,0,1,0
51571,445,0,0,drop,66,66,0,1,0,1,0
51569,445,0,0,drop,66,66,0,1,0,1,0
51120,445,0,0,drop,70,70,0,1,0,1,0
56165,445,0,0,drop,70,70,0,1,0,1,0
56156,445,0,0,drop,70,70,0,1,0,1,0
56703,22,0,0,deny,60,60,0,1,0,1,0
51115,445,0,0,drop,70,70,0,1,0,1,0
51553,445,0,0,drop,66,66,0,1,0,1,0
51555,445,0,0,drop,66,66,0,1,0,1,0
51554,445,0,0,drop,66,66,0,1,0,1,0
56153,445,0,0,drop,70,70,0,1,0,1,0
51103,445,0,0,drop,70,70,0,1,0,1,0
51104,445,0,0,drop,70,70,0,1,0,1,0
51101,445,0,0,drop,70,70,0,1,0,1,0
51100,445,0,0,drop,70,70,0,1,0,1,0
56151,445,0,0,drop,70,70,0,1,0,1,0
56148,445,0,0,drop,70,70,0,1,0,1,0
56145,445,0,0,drop,70,70,0,1,0,1,0
56144,445,0,0,drop,70,70,0,1,0,1,0
51090,445,0,0,drop,70,70,0,1,0,1,0
56128,445,0,0,drop,70,70,0,1,0,1,0
51083,445,0,0,drop,70,70,0,1,0,1,0
51080,445,0,0,drop,70,70,0,1,0,1,0
51076,445,0,0,drop,70,70,0,1,0,1,0
58429,53,0,0,allow,1254,160,1094,4,49,2,2
57356,53,56372,53,allow,815,95,720,2,30,1,1
49308,53,0,0,allow,180,80,100,2,30,1,1
43735,53,43735,53,allow,216,88,128,2,30,1,1
49650,53,63255,53,allow,322,110,212,4,30,2,2
56421,53,23965,53,allow,170,87,83,2,30,1,1
51870,53,51870,53,allow,825,99,726,2,30,1,1
57061,53,26951,53,allow,711,87,624,2,30,1,1
51727,1024,54726,1024,allow,66,66,0,1,5,1,0
50068,53,50068,53,allow,240,96,144,2,30,1,1
49650,53,21786,53,allow,216,110,106,2,30,1,1
56980,53,43925,53,allow,701,88,613,2,30,1,1
54032,53,0,0,allow,195,79,116,2,31,1,1
64933,53,1484,53,allow,738,86,652,2,31,1,1
57281,53,58597,53,allow,711,87,624,2,31,1,1
56760,53,60380,53,allow,760,96,664,2,31,1,1
51530,445,0,0,drop,66,66,0,1,0,1,0
56124,445,0,0,drop,70,70,0,1,0,1,0
56118,445,0,0,drop,70,70,0,1,0,1,0
41156,53,41156,53,allow,216,82,134,2,31,1,1
49162,53,61794,53,allow,371,94,277,2,29,1,1
49650,53,24810,53,allow,216,110,106,2,29,1,1
58429,53,0,0,allow,360,160,200,4,49,2,2
64114,443,8780,443,allow,1411,852,559,13,24,7,6
60078,80,2527,80,allow,1114,534,580,12,15,7,5
64574,53,64558,53,allow,388,95,293,4,32,2,2
55787,53,59622,53,allow,229,102,127,2,29,1,1
55488,53,31385,53,allow,210,94,116,2,29,1,1
49650,53,11402,53,allow,216,110,106,2,30,1,1
64742,53,25271,53,allow,165,86,79,2,29,1,1
56143,53,42893,53,allow,195,94,101,2,30,1,1
52944,53,19420,53,allow,168,78,90,2,30,1,1
56939,53,33751,53,allow,351,94,257,2,30,1,1
56998,53,2449,53,allow,199,94,105,2,30,1,1
64746,53,10441,53,allow,260,86,174,2,30,1,1
65313,53,33070,53,allow,193,102,91,2,30,1,1
64676,53,19072,53,allow,276,94,182,2,30,1,1
40890,53,0,0,allow,86,86,0,1,30,1,0
64123,53,16597,53,allow,325,102,223,2,30,1,1
51401,443,9077,443,allow,130,70,60,2,4,1,1
64742,53,28467,53,allow,173,94,79,2,29,1,1
60517,53,55123,53,allow,215,94,121,2,29,1,1
56421,53,33128,53,allow,177,94,83,2,29,1,1
64021,53,10744,53,allow,339,118,221,2,29,1,1
49308,53,0,0,allow,627,80,547,2,29,1,1
65313,53,6135,53,allow,193,102,91,2,30,1,1
64747,53,25665,53,allow,167,78,89,2,30,1,1
49397,53,28669,53,allow,365,94,271,2,30,1,1
57238,53,58179,53,allow,165,86,79,2,30,1,1
49603,53,2204,53,allow,238,110,128,2,30,1,1
49965,53,21038,53,allow,285,110,175,2,30,1,1
51465,80,10875,80,allow,913,410,503,10,15,5,5
40648,443,10699,443,allow,130,70,60,3,5,2,1
65527,53,57886,53,allow,194,94,100,2,30,1,1
41858,53,0,0,allow,86,86,0,1,30,1,0
55800,53,32257,53,allow,177,94,83,2,30,1,1
55800,53,5218,53,allow,177,94,83,2,30,1,1
55450,53,40253,53,allow,213,102,111,2,30,1,1
57238,53,29243,53,allow,165,86,79,2,30,1,1
56421,53,57015,53,allow,177,94,83,2,30,1,1
57240,53,54621,53,allow,180,94,86,2,30,1,1
65382,53,20411,53,allow,274,94,180,2,30,1,1
64655,53,25772,53,allow,225,102,123,2,30,1,1
55545,53,22001,53,allow,177,94,83,2,30,1,1
58932,53,21682,53,allow,168,78,90,2,31,1,1
64966,53,51667,53,allow,458,188,270,6,31,3,3
48975,443,52782,443,allow,130,70,60,3,5,2,1
49767,80,33888,80,allow,70,70,0,2,8,2,0
64631,53,54731,53,allow,351,93,258,4,50,2,2
64399,53,19303,53,allow,373,90,283,4,53,2,2
55545,53,60601,53,allow,177,94,83,2,30,1,1
65276,53,46929,53,allow,212,102,110,2,30,1,1
49853,53,48467,53,allow,811,94,717,2,30,1,1
51071,445,0,0,drop,70,70,0,1,0,1,0
51070,445,0,0,drop,70,70,0,1,0,1,0
51528,445,0,0,drop,66,66,0,1,0,1,0
51524,445,0,0,drop,66,66,0,1,0,1,0
56115,445,0,0,drop,70,70,0,1,0,1,0
56109,445,0,0,drop,70,70,0,1,0,1,0
56105,445,0,0,drop,70,70,0,1,0,1,0
51522,445,0,0,drop,66,66,0,1,0,1,0
51065,445,0,0,drop,70,70,0,1,0,1,0
56098,445,0,0,drop,70,70,0,1,0,1,0
56096,445,0,0,drop,70,70,0,1,0,1,0
56095,445,0,0,drop,70,70,0,1,0,1,0
56092,445,0,0,drop,70,70,0,1,0,1,0
51514,445,0,0,drop,66,66,0,1,0,1,0
51511,445,0,0,drop,66,66,0,1,0,1,0
51510,445,0,0,drop,66,66,0,1,0,1,0
51505,445,0,0,drop,66,66,0,1,0,1,0
51503,445,0,0,drop,66,66,0,1,0,1,0
51504,445,0,0,drop,66,66,0,1,0,1,0
51502,445,0,0,drop,66,66,0,1,0,1,0
51052,445,0,0,drop,70,70,0,1,0,1,0
56090,445,0,0,drop,70,70,0,1,0,1,0
56089,445,0,0,drop,70,70,0,1,0,1,0
56086,445,0,0,drop,70,70,0,1,0,1,0
51499,445,0,0,drop,66,66,0,1,0,1,0
56083,445,0,0,drop,70,70,0,1,0,1,0
51049,445,0,0,drop,70,70,0,1,0,1,0
51495,445,0,0,drop,66,66,0,1,0,1,0
51494,445,0,0,drop,66,66,0,1,0,1,0
51491,445,0,0,drop,66,66,0,1,0,1,0
51490,445,0,0,drop,66,66,0,1,0,1,0
51043,445,0,0,drop,70,70,0,1,0,1,0
56077,445,0,0,drop,70,70,0,1,0,1,0
56074,445,0,0,drop,70,70,0,1,0,1,0
56069,445,0,0,drop,70,70,0,1,0,1,0
50972,443,8971,443,allow,469,403,66,4,0,3,1
51480,445,0,0,drop,66,66,0,1,0,1,0
51471,445,0,0,drop,66,66,0,1,0,1,0
51029,445,0,0,drop,70,70,0,1,0,1,0
56056,445,0,0,drop,70,70,0,1,0,1,0
51027,445,0,0,drop,70,70,0,1,0,1,0
51468,445,0,0,drop,66,66,0,1,0,1,0
51023,445,0,0,drop,70,70,0,1,0,1,0
51020,445,0,0,drop,70,70,0,1,0,1,0
51461,445,0,0,drop,66,66,0,1,0,1,0
51008,445,0,0,drop,70,70,0,1,0,1,0
51007,445,0,0,drop,70,70,0,1,0,1,0
51453,445,0,0,drop,66,66,0,1,0,1,0
50997,445,0,0,drop,70,70,0,1,0,1,0
56047,445,0,0,drop,70,70,0,1,0,1,0
56045,445,0,0,drop,70,70,0,1,0,1,0
56043,445,0,0,drop,70,70,0,1,0,1,0
51443,445,0,0,drop,66,66,0,1,0,1,0
51446,445,0,0,drop,66,66,0,1,0,1,0
51444,445,0,0,drop,66,66,0,1,0,1,0
51438,445,0,0,drop,66,66,0,1,0,1,0
51445,445,0,0,drop,66,66,0,1,0,1,0
51439,445,0,0,drop,66,66,0,1,0,1,0
51441,445,0,0,drop,66,66,0,1,0,1,0
51440,445,0,0,drop,66,66,0,1,0,1,0
56041,445,0,0,drop,70,70,0,1,0,1,0
56028,445,0,0,drop,70,70,0,1,0,1,0
50982,445,0,0,drop,70,70,0,1,0,1,0
51426,445,0,0,drop,66,66,0,1,0,1,0
51425,445,0,0,drop,66,66,0,1,0,1,0
51423,445,0,0,drop,66,66,0,1,0,1,0
50971,445,0,0,drop,70,70,0,1,0,1,0
56025,445,0,0,drop,70,70,0,1,0,1,0
56023,445,0,0,drop,70,70,0,1,0,1,0
56013,445,0,0,drop,70,70,0,1,0,1,0
56012,445,0,0,drop,70,70,0,1,0,1,0
40885,23,0,0,deny,60,60,0,1,0,1,0
57240,53,16899,53,allow,176,90,86,2,30,1,1
53799,80,41607,80,allow,1056,682,374,10,15,6,4
51464,443,29786,443,allow,575,326,249,10,15,6,4
47388,443,27845,443,allow,350,210,140,6,15,4,2
41793,53,3227,53,allow,168,78,90,2,30,1,1
55545,53,10302,53,allow,170,87,83,2,30,1,1
53550,1,56985,1,allow,70,70,0,2,8,2,0
50116,22,50116,22,allow,184,120,64,4,11,3,1
65261,53,13380,53,allow,168,86,82,2,30,1,1
55926,53,35022,53,allow,184,94,90,2,30,1,1
55401,53,40210,53,allow,168,86,82,2,31,1,1
46663,53,46663,53,allow,209,83,126,2,30,1,1
40603,53,40603,53,allow,240,96,144,2,31,1,1
39166,53,0,0,allow,82,82,0,1,31,1,0
64180,53,16774,53,allow,176,90,86,2,31,1,1
50958,445,0,0,drop,70,70,0,1,0,1,0
56006,445,0,0,drop,70,70,0,1,0,1,0
50943,445,0,0,drop,70,70,0,1,0,1,0
39161,17,0,0,deny,60,60,0,1,0,1,0
51403,445,0,0,drop,66,66,0,1,0,1,0
55990,445,0,0,drop,70,70,0,1,0,1,0
45987,123,19536,123,allow,184,94,90,2,30,1,1
64169,53,57112,53,allow,212,102,110,2,30,1,1
57344,53,65328,53,allow,177,94,83,2,30,1,1
57240,53,32655,53,allow,180,94,86,2,29,1,1
50238,53,16273,53,allow,164,78,86,2,29,1,1
49563,53,57038,53,allow,199,94,105,2,29,1,1
55926,53,47769,53,allow,184,94,90,2,29,1,1
65074,53,7213,53,allow,227,94,133,2,29,1,1
57046,53,24095,53,allow,234,94,140,2,29,1,1
65330,53,59699,53,allow,766,102,664,2,29,1,1
58478,53,13215,53,allow,332,102,230,2,29,1,1
49722,53,29083,53,allow,215,94,121,2,30,1,1
49477,53,25866,53,allow,183,86,97,2,30,1,1
56950,53,15623,53,allow,363,109,254,4,46,2,2
37202,53,37202,53,allow,216,90,126,2,30,1,1
49930,53,51940,53,allow,258,110,148,2,30,1,1
38009,443,41561,443,allow,130,70,60,3,5,2,1
57344,53,21861,53,allow,177,94,83,2,30,1,1
65405,53,15243,53,allow,210,102,108,2,30,1,1
53108,80,57072,80,allow,1797,1070,727,10,15,5,5
46342,53,46342,53,allow,220,90,130,2,30,1,1
45396,53,7036,53,allow,168,78,90,2,30,1,1
49496,53,24067,53,allow,194,102,92,2,30,1,1
64806,53,2007,53,allow,273,94,179,2,30,1,1
57339,53,58719,53,allow,248,94,154,2,30,1,1
55314,53,61384,53,allow,279,110,169,2,30,1,1
56755,53,8890,53,allow,663,212,451,6,63,3,3
64137,53,55466,53,allow,228,94,134,2,30,1,1
49787,53,45265,53,allow,196,94,102,2,30,1,1
60097,53,60097,53,allow,193,90,103,2,30,1,1
64874,53,41940,53,allow,324,94,230,2,30,1,1
62119,53,18352,53,allow,239,102,137,2,30,1,1
52706,53,0,0,allow,82,82,0,2,40,2,0
61417,80,18297,80,allow,214,140,74,4,55,3,1
50320,53,20919,53,allow,168,78,90,2,30,1,1
56785,53,13080,53,allow,213,102,111,2,30,1,1
65466,53,26406,53,allow,248,94,154,2,30,1,1
63016,53,49407,53,allow,243,94,149,2,30,1,1
58753,443,28125,443,allow,70,70,0,1,5,1,0
51405,80,23596,80,allow,1510,481,1029,11,20,6,5
57183,53,5484,53,allow,199,94,105,2,29,1,1
49496,53,27238,53,allow,194,102,92,2,30,1,1
65016,53,63384,53,allow,215,94,121,2,29,1,1
57340,53,50973,53,allow,258,110,148,2,30,1,1
56782,53,60829,53,allow,227,94,133,2,29,1,1
64277,53,1694,53,allow,337,110,227,2,30,1,1
50000,53,40875,53,allow,263,110,153,2,30,1,1
49602,53,44779,53,allow,247,102,145,2,30,1,1
55926,53,60455,53,allow,184,94,90,2,30,1,1
55545,53,31002,53,allow,177,94,83,2,30,1,1
49430,53,18362,53,allow,279,94,185,2,30,1,1
55401,53,24581,53,allow,168,86,82,2,30,1,1
49973,53,45350,53,allow,309,110,199,2,30,1,1
55635,53,55876,53,allow,177,94,83,2,30,1,1
64180,53,29611,53,allow,180,94,86,2,31,1,1
56599,80,32983,80,allow,234,234,0,4,12,4,0
55665,53,45679,53,allow,229,94,135,2,30,1,1
50433,53,61618,53,allow,770,102,668,2,30,1,1
65261,53,34538,53,allow,168,86,82,2,30,1,1
63725,80,55530,80,allow,374,192,182,7,15,4,3
44414,123,11306,123,allow,184,94,90,2,30,1,1
56103,53,56052,53,allow,279,94,185,2,30,1,1
57240,53,1415,53,allow,180,94,86,2,30,1,1
57123,53,38680,53,allow,811,94,717,2,30,1,1
55447,53,41152,53,allow,194,102,92,2,30,1,1
49722,53,50235,53,allow,168,78,90,2,30,1,1
49444,53,27495,53,allow,199,94,105,2,30,1,1
55317,53,59583,53,allow,244,94,150,2,31,1,1
57071,53,47529,53,allow,274,110,164,2,31,1,1
57366,53,60542,53,allow,458,188,270,6,31,3,3
55184,53,55740,53,allow,443,92,351,4,31,2,2
64611,53,46299,53,allow,189,102,87,2,30,1,1
43542,53,13639,53,allow,168,78,90,2,30,1,1
56631,53,31631,53,allow,199,94,105,2,30,1,1
50691,443,45100,443,allow,152,86,66,2,6,1,1
56970,53,18773,53,allow,230,110,120,2,30,1,1
55151,53,16947,53,allow,285,102,183,2,30,1,1
55956,53,7528,53,allow,200,94,106,2,30,1,1
65170,53,60576,53,allow,771,102,669,2,30,1,1
65414,53,10727,53,allow,197,102,95,2,31,1,1
64825,53,28794,53,allow,184,94,90,2,31,1,1
50936,445,0,0,drop,70,70,0,1,0,1,0
51397,445,0,0,drop,66,66,0,1,0,1,0
51393,445,0,0,drop,66,66,0,1,0,1,0
55979,445,0,0,drop,70,70,0,1,0,1,0
50931,445,0,0,drop,70,70,0,1,0,1,0
51389,445,0,0,drop,66,66,0,1,0,1,0
55968,445,0,0,drop,70,70,0,1,0,1,0
55967,445,0,0,drop,70,70,0,1,0,1,0
55964,445,0,0,drop,70,70,0,1,0,1,0
51383,445,0,0,drop,66,66,0,1,0,1,0
51380,445,0,0,drop,66,66,0,1,0,1,0
51378,445,0,0,drop,66,66,0,1,0,1,0
51375,445,0,0,drop,66,66,0,1,0,1,0
51372,445,0,0,drop,66,66,0,1,0,1,0
51373,445,0,0,drop,66,66,0,1,0,1,0
51371,445,0,0,drop,66,66,0,1,0,1,0
50914,445,0,0,drop,70,70,0,1,0,1,0
55962,445,0,0,drop,70,70,0,1,0,1,0
55960,445,0,0,drop,70,70,0,1,0,1,0
55956,445,0,0,drop,70,70,0,1,0,1,0
51369,445,0,0,drop,66,66,0,1,0,1,0
54204,443,58891,443,allow,499,425,74,4,0,3,1
54196,443,33780,443,allow,499,425,74,4,0,3,1
54195,443,37622,443,allow,499,425,74,4,0,3,1
54199,443,31908,443,allow,499,425,74,4,0,3,1
54198,443,37713,443,allow,499,425,74,4,0,3,1
55955,445,0,0,drop,70,70,0,1,0,1,0
51365,445,0,0,drop,66,66,0,1,0,1,0
51363,445,0,0,drop,66,66,0,1,0,1,0
51362,445,0,0,drop,66,66,0,1,0,1,0
50906,445,0,0,drop,70,70,0,1,0,1,0
55940,445,0,0,drop,70,70,0,1,0,1,0
55938,445,0,0,drop,70,70,0,1,0,1,0
54202,443,43752,443,allow,499,425,74,4,0,3,1
54203,443,21798,443,allow,499,425,74,4,0,3,1
54201,443,55731,443,allow,499,425,74,4,0,3,1
54200,443,47040,443,allow,499,425,74,4,0,3,1
54197,443,1352,443,allow,499,425,74,4,0,3,1
54194,443,16208,443,allow,499,425,74,4,0,3,1
51351,445,0,0,drop,66,66,0,1,0,1,0
50899,445,0,0,drop,70,70,0,1,0,1,0
50897,445,0,0,drop,70,70,0,1,0,1,0
51341,445,0,0,drop,66,66,0,1,0,1,0
55929,445,0,0,drop,70,70,0,1,0,1,0
50896,445,0,0,drop,70,70,0,1,0,1,0
50895,445,0,0,drop,70,70,0,1,0,1,0
50894,445,0,0,drop,70,70,0,1,0,1,0
51338,445,0,0,drop,66,66,0,1,0,1,0
50876,445,0,0,drop,70,70,0,1,0,1,0
50875,445,0,0,drop,70,70,0,1,0,1,0
50872,445,0,0,drop,70,70,0,1,0,1,0
51330,445,0,0,drop,66,66,0,1,0,1,0
50865,445,0,0,drop,70,70,0,1,0,1,0
51325,445,0,0,drop,66,66,0,1,0,1,0
56006,23,0,0,deny,60,60,0,1,0,1,0
55918,445,0,0,drop,70,70,0,1,0,1,0
55915,445,0,0,drop,70,70,0,1,0,1,0
55916,445,0,0,drop,70,70,0,1,0,1,0
50854,445,0,0,drop,70,70,0,1,0,1,0
51310,445,0,0,drop,66,66,0,1,0,1,0
51311,445,0,0,drop,66,66,0,1,0,1,0
51313,445,0,0,drop,66,66,0,1,0,1,0
51312,445,0,0,drop,66,66,0,1,0,1,0
51315,445,0,0,drop,66,66,0,1,0,1,0
51314,445,0,0,drop,66,66,0,1,0,1,0
51308,445,0,0,drop,66,66,0,1,0,1,0
51309,445,0,0,drop,66,66,0,1,0,1,0
50849,445,0,0,drop,70,70,0,1,0,1,0
49963,53,30474,53,allow,279,96,183,4,58,2,2
59774,443,17301,443,allow,846,420,426,15,29,8,7
42821,53,25927,53,allow,168,78,90,2,30,1,1
49475,80,53528,80,allow,1548,847,701,10,16,5,5
59798,443,49371,443,allow,1887,1152,735,18,28,9,9
55920,53,58162,53,allow,770,102,668,2,30,1,1
52309,80,52309,80,allow,450,246,204,8,29,5,3
56689,53,22159,53,allow,738,86,652,2,30,1,1
42566,53,42566,53,allow,216,98,118,2,30,1,1
52311,80,52311,80,allow,450,246,204,8,29,5,3
56520,53,14015,53,allow,757,98,659,2,30,1,1
56223,53,26065,53,allow,768,99,669,2,30,1,1
64825,53,38972,53,allow,184,94,90,2,30,1,1
59787,443,40007,443,allow,1457,816,641,15,28,7,8
59805,443,46522,443,allow,2334,1113,1221,19,27,9,10
59777,443,29457,443,allow,966,480,486,17,29,9,8
55635,53,27124,53,allow,170,87,83,2,30,1,1
55048,53,59185,53,allow,780,104,676,2,30,1,1
56176,53,4646,53,allow,188,96,92,2,30,1,1
64706,443,64706,443,allow,274,132,142,5,76,3,2
56727,53,56099,53,allow,168,86,82,3,50,2,1
60745,123,31928,123,allow,184,94,90,2,30,1,1
55732,53,62249,53,allow,188,96,92,2,31,1,1
63965,53,30693,53,allow,192,90,102,2,31,1,1
58770,53,51678,53,allow,168,78,90,2,31,1,1
57334,53,29836,53,allow,204,104,100,2,31,1,1
64989,53,14791,53,allow,756,95,661,2,31,1,1
57372,53,34702,53,allow,756,95,661,2,31,1,1
65349,53,30593,53,allow,772,103,669,2,31,1,1
56050,53,45848,53,allow,172,88,84,2,30,1,1
64359,53,39260,53,allow,192,98,94,2,31,1,1
57173,53,42104,53,allow,216,110,106,2,31,1,1
55896,53,50702,53,allow,184,94,90,2,31,1,1
49824,53,9699,53,allow,172,88,84,2,31,1,1
65049,53,32515,53,allow,204,104,100,2,31,1,1
57173,53,12903,53,allow,216,110,106,2,31,1,1
55605,53,47383,53,allow,772,103,669,2,31,1,1
56478,53,58747,53,allow,200,102,98,2,31,1,1
55921,53,12219,53,allow,747,92,655,2,31,1,1
55906,445,0,0,drop,70,70,0,1,0,1,0
55900,445,0,0,drop,70,70,0,1,0,1,0
50840,445,0,0,drop,70,70,0,1,0,1,0
51296,445,0,0,drop,66,66,0,1,0,1,0
51295,445,0,0,drop,66,66,0,1,0,1,0
51293,445,0,0,drop,66,66,0,1,0,1,0
50833,445,0,0,drop,70,70,0,1,0,1,0
55897,445,0,0,drop,70,70,0,1,0,1,0
55895,445,0,0,drop,70,70,0,1,0,1,0
56176,53,62297,53,allow,102,102,0,1,30,1,0
55926,53,56818,53,allow,184,94,90,2,29,1,1
49567,53,58916,53,allow,244,94,150,2,29,1,1
64858,53,57701,53,allow,196,102,94,2,30,1,1
55892,445,0,0,drop,70,70,0,1,0,1,0
55888,445,0,0,drop,70,70,0,1,0,1,0
55883,445,0,0,drop,70,70,0,1,0,1,0
50827,445,0,0,drop,70,70,0,1,0,1,0
50820,445,0,0,drop,70,70,0,1,0,1,0
50818,445,0,0,drop,70,70,0,1,0,1,0
55875,445,0,0,drop,70,70,0,1,0,1,0
55873,445,0,0,drop,70,70,0,1,0,1,0
51273,445,0,0,drop,66,66,0,1,0,1,0
50808,445,0,0,drop,70,70,0,1,0,1,0
55868,445,0,0,drop,70,70,0,1,0,1,0
55862,445,0,0,drop,70,70,0,1,0,1,0
49275,53,23304,53,allow,212,102,110,2,30,1,1
53209,80,42720,80,allow,1452,484,968,8,15,5,3
55635,53,55478,53,allow,177,94,83,2,29,1,1
55776,53,11095,53,allow,272,110,162,2,29,1,1
64611,53,9832,53,allow,181,94,87,2,29,1,1
64762,53,23924,53,allow,200,94,106,2,30,1,1
57486,80,57486,80,allow,1248,535,713,10,20,5,5
55732,53,1656,53,allow,194,102,92,2,30,1,1
52313,80,52313,80,allow,450,246,204,8,29,5,3
56624,53,50985,53,allow,196,102,94,2,30,1,1
56730,53,45534,53,allow,210,110,100,2,30,1,1
59781,443,23445,443,allow,546,180,366,10,28,4,6
43055,80,43055,80,allow,1246,533,713,10,20,5,5
49939,53,36312,53,allow,384,103,281,4,50,2,2
55635,53,13643,53,allow,177,94,83,2,30,1,1
49963,53,54838,53,allow,279,96,183,4,59,2,2
64946,53,45329,53,allow,210,102,108,2,30,1,1
49614,53,48437,53,allow,258,110,148,2,30,1,1
55217,53,21902,53,allow,189,102,87,2,30,1,1
39036,443,62520,443,allow,1768,541,1227,11,20,7,4
64858,53,5118,53,allow,819,102,717,2,30,1,1
65298,53,31126,53,allow,277,110,167,2,30,1,1
56602,53,21237,53,allow,197,102,95,2,30,1,1
55879,53,32478,53,allow,200,94,106,2,30,1,1
46734,53,46734,53,allow,314,98,216,2,29,1,1
55447,53,22356,53,allow,194,102,92,2,29,1,1
55769,53,28226,53,allow,373,103,270,4,43,2,2
56925,53,26704,53,allow,275,110,165,2,29,1,1
52310,80,52310,80,allow,450,246,204,8,29,5,3
64489,53,3033,53,allow,320,97,223,4,50,2,2
36452,53,36452,53,allow,226,106,120,2,29,1,1
51675,53,24941,53,allow,168,78,90,2,29,1,1
64742,53,25545,53,allow,761,102,659,2,29,1,1
60306,53,57588,53,allow,168,78,90,2,29,1,1
64890,53,55634,53,allow,210,110,100,2,29,1,1
52312,80,52312,80,allow,450,246,204,8,29,5,3
49557,53,50413,53,allow,272,110,162,2,29,1,1
65025,53,29192,53,allow,786,110,676,2,29,1,1
64890,53,13860,53,allow,210,110,100,2,30,1,1
55896,53,65305,53,allow,184,94,90,2,30,1,1
56154,53,34116,53,allow,291,94,197,2,29,1,1
56730,53,53565,53,allow,210,110,100,2,30,1,1
55217,53,28752,53,allow,189,102,87,2,30,1,1
41923,53,17859,53,allow,168,78,90,2,30,1,1
55498,53,3379,53,allow,340,134,206,2,30,1,1
56793,53,24911,53,allow,196,102,94,2,30,1,1
49864,53,65077,53,allow,212,102,110,2,30,1,1
64359,53,44275,53,allow,196,102,94,2,30,1,1
56050,53,45376,53,allow,178,94,84,2,30,1,1
59494,443,29596,443,allow,338,278,60,2,5,1,1
40375,443,13030,443,allow,130,70,60,3,5,2,1
64188,53,11006,53,allow,299,98,201,4,57,2,2
56624,53,20436,53,allow,819,102,717,2,30,1,1
64487,53,6176,53,allow,225,110,115,2,30,1,1
49213,53,21489,53,allow,272,94,178,2,30,1,1
57235,53,3428,53,allow,212,102,110,2,30,1,1
57879,80,31290,80,allow,318,192,126,6,27,4,2
51294,443,42258,443,allow,162,102,60,2,5,1,1
59776,443,24367,443,allow,966,480,486,17,29,9,8
57334,53,43556,53,allow,210,110,100,2,30,1,1
55403,53,28747,53,allow,211,102,109,2,30,1,1
56176,53,42328,53,allow,194,102,92,2,30,1,1
49522,53,16817,53,allow,688,185,503,6,45,3,3
43634,80,30485,80,allow,1151,711,440,10,15,5,5
65414,53,34166,53,allow,197,102,95,2,30,1,1
56268,53,23212,53,allow,210,102,108,2,30,1,1
57334,53,14690,53,allow,210,110,100,2,30,1,1
56793,53,12485,53,allow,196,102,94,2,30,1,1
64153,53,64829,53,allow,340,134,206,2,30,1,1
56478,53,62940,53,allow,200,102,98,2,30,1,1
56050,53,26569,53,allow,178,94,84,2,30,1,1
56522,53,58867,53,allow,322,134,188,2,30,1,1
55384,53,33566,53,allow,212,102,110,2,30,1,1
65246,53,1802,53,allow,209,102,107,2,30,1,1
65049,53,22516,53,allow,210,110,100,2,30,1,1
64513,53,7726,53,allow,396,102,294,2,31,1,1
57173,53,30572,53,allow,322,110,212,4,31,2,2
49473,53,57880,53,allow,290,118,172,2,30,1,1
64865,53,41424,53,allow,423,102,321,2,30,1,1
65496,123,10878,123,allow,184,94,90,2,30,1,1
55896,53,44537,53,allow,184,94,90,2,30,1,1
56997,123,16433,123,allow,184,94,90,2,30,1,1
49679,53,54923,53,allow,166,86,80,2,30,1,1
65418,53,64332,53,allow,211,102,109,2,30,1,1
56050,53,44342,53,allow,178,94,84,2,30,1,1
59278,53,0,0,allow,86,86,0,1,30,1,0
54369,53,50744,53,allow,168,78,90,2,31,1,1
55732,53,61011,53,allow,194,102,92,2,30,1,1
56602,53,29182,53,allow,197,102,95,2,30,1,1
57334,53,19722,53,allow,210,110,100,2,30,1,1
64825,53,52627,53,allow,184,94,90,2,30,1,1
64056,53,57608,53,allow,383,94,289,2,30,1,1
45614,123,42191,123,allow,184,94,90,2,30,1,1
49540,53,39432,53,allow,198,110,88,2,31,1,1
63965,53,54423,53,allow,180,94,86,2,31,1,1
49540,53,53210,53,allow,198,110,88,2,30,1,1
55951,53,13243,53,allow,197,102,95,2,31,1,1
57173,53,19613,53,allow,216,110,106,2,31,1,1
49177,53,40047,53,allow,184,94,90,2,31,1,1
55292,53,33154,53,allow,211,102,109,2,31,1,1
56727,53,55377,53,allow,250,86,164,4,52,2,2
49963,53,15871,53,allow,279,96,183,4,58,2,2
49963,53,58470,53,allow,564,191,373,6,62,3,3
55922,53,46699,53,allow,423,102,321,2,30,1,1
56983,53,28765,53,allow,424,108,316,4,55,2,2
64180,53,4267,53,allow,180,94,86,2,30,1,1
64825,53,49543,53,allow,184,94,90,2,31,1,1
50031,53,36003,53,allow,386,134,252,2,30,1,1
49679,53,7089,53,allow,166,86,80,2,31,1,1
64297,53,33648,53,allow,199,94,105,2,30,1,1
56478,53,14582,53,allow,200,102,98,2,30,1,1
55732,53,40584,53,allow,194,102,92,2,31,1,1
65049,53,4020,53,allow,210,110,100,2,31,1,1
55033,53,37383,53,allow,182,94,88,2,31,1,1
50692,443,11802,443,allow,152,86,66,2,5,1,1
61705,80,47319,80,allow,134,60,74,3,11,2,1
56736,53,58809,53,allow,283,94,189,4,41,2,2
56793,53,43867,53,allow,196,102,94,2,30,1,1
49824,53,46232,53,allow,178,94,84,2,30,1,1
64256,53,5483,53,allow,334,94,240,2,31,1,1
55896,53,45886,53,allow,184,94,90,2,31,1,1
49824,53,29358,53,allow,178,94,84,2,31,1,1
56524,53,60434,53,allow,182,102,80,2,31,1,1
51266,445,0,0,drop,66,66,0,1,0,1,0
51263,445,0,0,drop,66,66,0,1,0,1,0
50802,445,0,0,drop,70,70,0,1,0,1,0
55851,445,0,0,drop,70,70,0,1,0,1,0
55847,445,0,0,drop,70,70,0,1,0,1,0
51262,445,0,0,drop,66,66,0,1,0,1,0
55842,445,0,0,drop,70,70,0,1,0,1,0
55840,445,0,0,drop,70,70,0,1,0,1,0
55836,445,0,0,drop,70,70,0,1,0,1,0
51254,445,0,0,drop,66,66,0,1,0,1,0
51247,445,0,0,drop,66,66,0,1,0,1,0
51248,445,0,0,drop,66,66,0,1,0,1,0
51245,445,0,0,drop,66,66,0,1,0,1,0
51243,445,0,0,drop,66,66,0,1,0,1,0
51244,445,0,0,drop,66,66,0,1,0,1,0
51241,445,0,0,drop,66,66,0,1,0,1,0
55835,445,0,0,drop,70,70,0,1,0,1,0
55833,445,0,0,drop,70,70,0,1,0,1,0
55828,445,0,0,drop,70,70,0,1,0,1,0
51240,445,0,0,drop,66,66,0,1,0,1,0
55827,445,0,0,drop,70,70,0,1,0,1,0
51236,445,0,0,drop,66,66,0,1,0,1,0
51234,445,0,0,drop,66,66,0,1,0,1,0
51233,445,0,0,drop,66,66,0,1,0,1,0
50781,445,0,0,drop,70,70,0,1,0,1,0
51230,445,0,0,drop,66,66,0,1,0,1,0
50778,445,0,0,drop,70,70,0,1,0,1,0
55821,445,0,0,drop,70,70,0,1,0,1,0
55818,445,0,0,drop,70,70,0,1,0,1,0
55815,445,0,0,drop,70,70,0,1,0,1,0
50771,445,0,0,drop,70,70,0,1,0,1,0
51221,445,0,0,drop,66,66,0,1,0,1,0
50769,445,0,0,drop,70,70,0,1,0,1,0
50768,445,0,0,drop,70,70,0,1,0,1,0
50767,445,0,0,drop,70,70,0,1,0,1,0
51212,445,0,0,drop,66,66,0,1,0,1,0
50766,445,0,0,drop,70,70,0,1,0,1,0
55800,445,0,0,drop,70,70,0,1,0,1,0
50760,445,0,0,drop,70,70,0,1,0,1,0
51209,445,0,0,drop,66,66,0,1,0,1,0
50748,445,0,0,drop,70,70,0,1,0,1,0
50747,445,0,0,drop,70,70,0,1,0,1,0
50745,445,0,0,drop,70,70,0,1,0,1,0
50737,445,0,0,drop,70,70,0,1,0,1,0
51201,445,0,0,drop,66,66,0,1,0,1,0
51194,445,0,0,drop,66,66,0,1,0,1,0
50726,445,0,0,drop,70,70,0,1,0,1,0
60309,443,17740,443,allow,130,70,60,3,5,2,1
61714,443,30943,443,allow,134,60,74,3,10,2,1
53194,443,63620,443,allow,1462,965,497,13,18,7,6
53195,443,48069,443,allow,1462,965,497,13,18,7,6
53179,80,43162,80,allow,1628,828,800,10,25,6,4
45426,80,3986,80,allow,416,210,206,7,28,4,3
45428,80,14591,80,allow,350,210,140,6,28,4,2
55951,53,16889,53,allow,194,99,95,2,31,1,1
45427,80,37690,80,allow,350,210,140,6,28,4,2
50571,80,64124,80,allow,300,174,126,5,15,3,2
57595,443,62180,443,allow,291,171,120,4,16,2,2
49177,53,33754,53,allow,184,94,90,2,31,1,1
59950,53,51206,53,allow,395,115,280,2,30,1,1
50214,53,34671,53,allow,789,110,679,2,31,1,1
49364,53,62830,53,allow,180,92,88,2,31,1,1
56215,53,26623,53,allow,216,110,106,2,31,1,1
39381,53,0,0,allow,82,82,0,1,31,1,0
47504,53,47504,53,allow,174,77,97,2,30,1,1
63945,53,52680,53,allow,216,110,106,2,31,1,1
65127,53,26912,53,allow,188,96,92,2,31,1,1
56322,53,7412,53,allow,202,103,99,2,31,1,1
55791,445,0,0,drop,70,70,0,1,0,1,0
55788,445,0,0,drop,70,70,0,1,0,1,0
55787,445,0,0,drop,70,70,0,1,0,1,0
51187,445,0,0,drop,66,66,0,1,0,1,0
51185,445,0,0,drop,66,66,0,1,0,1,0
51186,445,0,0,drop,66,66,0,1,0,1,0
51184,445,0,0,drop,66,66,0,1,0,1,0
51182,445,0,0,drop,66,66,0,1,0,1,0
51183,445,0,0,drop,66,66,0,1,0,1,0
51181,445,0,0,drop,66,66,0,1,0,1,0
51179,445,0,0,drop,66,66,0,1,0,1,0
50722,445,0,0,drop,70,70,0,1,0,1,0
55779,445,0,0,drop,70,70,0,1,0,1,0
55776,445,0,0,drop,70,70,0,1,0,1,0
55772,445,0,0,drop,70,70,0,1,0,1,0
50708,445,0,0,drop,70,70,0,1,0,1,0
50705,445,0,0,drop,70,70,0,1,0,1,0
51167,445,0,0,drop,66,66,0,1,0,1,0
51164,445,0,0,drop,66,66,0,1,0,1,0
51166,445,0,0,drop,66,66,0,1,0,1,0
55770,445,0,0,drop,70,70,0,1,0,1,0
55767,445,0,0,drop,70,70,0,1,0,1,0
55761,445,0,0,drop,70,70,0,1,0,1,0
50875,53,15135,53,allow,234,234,0,4,47,4,0
56847,53,25632,53,allow,225,86,139,2,30,1,1
55190,53,57289,53,allow,311,94,217,2,30,1,1
55951,53,4112,53,allow,197,102,95,2,30,1,1
55947,53,33524,53,allow,311,108,203,4,42,2,2
48017,443,12876,443,allow,198,78,120,4,6,2,2
50689,443,50217,443,allow,152,86,66,2,4,1,1
56727,53,4531,53,allow,250,86,164,4,46,2,2
56135,53,22804,53,allow,542,112,430,4,34,2,2
49775,53,55039,53,allow,399,93,306,4,41,2,2
49689,443,55526,443,allow,1179,655,524,13,56,7,6
63927,53,30501,53,allow,196,94,102,2,30,1,1
65412,53,14297,53,allow,305,118,187,2,30,1,1
55281,53,43570,53,allow,210,102,108,2,30,1,1
43444,53,43444,53,allow,314,98,216,2,30,1,1
64694,53,57973,53,allow,209,102,107,2,30,1,1
64018,53,10598,53,allow,229,94,135,2,30,1,1
61060,53,61060,53,allow,257,106,151,2,30,1,1
53199,443,19271,443,allow,1582,965,617,15,18,7,8
53193,443,17954,443,allow,1462,965,497,13,18,7,6
49826,443,4711,443,allow,1738,1159,579,16,74,10,6
49650,53,42506,53,allow,248,110,138,2,30,1,1
54309,80,4585,80,allow,552,280,272,9,30,5,4
64371,53,21841,53,allow,181,86,95,2,30,1,1
64701,53,54317,53,allow,195,94,101,2,30,1,1
55033,53,44325,53,allow,182,94,88,2,30,1,1
49828,443,7626,443,allow,1737,1158,579,16,74,10,6
57424,53,8409,53,allow,210,102,108,2,30,1,1
56215,53,24448,53,allow,216,110,106,2,30,1,1
64749,53,21766,53,allow,227,110,117,2,30,1,1
63965,53,11899,53,allow,180,94,86,2,30,1,1
53197,443,58160,443,allow,1462,965,497,13,18,7,6
49824,53,4911,53,allow,392,88,304,4,53,2,2
54310,80,7871,80,allow,552,280,272,9,30,5,4
50690,443,9122,443,allow,152,86,66,2,4,1,1
52640,443,13563,443,allow,70,70,0,1,5,1,0
53198,443,2334,443,allow,1462,965,497,13,18,7,6
64359,53,14911,53,allow,196,102,94,2,30,1,1
56524,53,26224,53,allow,182,102,80,2,30,1,1
55853,53,62979,53,allow,228,110,118,2,30,1,1
65361,53,62352,53,allow,211,102,109,2,30,1,1
64614,53,60972,53,allow,168,86,82,2,31,1,1
65432,53,33110,53,allow,448,184,264,6,30,3,3
56215,53,5017,53,allow,216,110,106,2,30,1,1
49961,53,9720,53,allow,327,126,201,2,30,1,1
52473,443,5513,443,allow,1625,1038,587,14,28,8,6
49671,443,7194,443,allow,1485,940,545,13,57,7,6
51685,80,11134,80,allow,1516,481,1035,11,15,6,5
56598,80,2431,80,allow,234,234,0,4,12,4,0
38171,443,40043,443,allow,1649,980,669,14,28,7,7
53200,443,25558,443,allow,1462,965,497,13,18,7,6
55081,53,46160,53,allow,209,102,107,2,30,1,1
49691,443,33512,443,allow,1183,659,524,13,56,7,6
65079,53,34794,53,allow,272,94,178,2,30,1,1
65049,53,16377,53,allow,210,110,100,2,30,1,1
50403,53,9932,53,allow,749,94,655,2,30,1,1
56478,53,64286,53,allow,200,102,98,2,30,1,1
65218,53,47163,53,allow,276,126,150,2,30,1,1
49756,53,22675,53,allow,243,118,125,2,30,1,1
56881,53,21712,53,allow,181,86,95,2,30,1,1
49413,53,52444,53,allow,231,110,121,2,30,1,1
56215,53,1097,53,allow,216,110,106,2,30,1,1
65127,53,45861,53,allow,194,102,92,2,30,1,1
56322,53,2088,53,allow,209,110,99,2,30,1,1
57074,53,27906,53,allow,259,78,181,2,30,1,1
49177,53,24852,53,allow,184,94,90,2,30,1,1
49627,53,57352,53,allow,288,110,178,2,31,1,1
64835,53,56147,53,allow,200,102,98,2,31,1,1
64077,53,54964,53,allow,199,94,105,2,30,1,1
56727,53,51350,53,allow,250,86,164,4,54,2,2
65056,53,43061,53,allow,211,102,109,2,30,1,1
52329,53,12571,53,allow,294,86,208,2,30,1,1
64814,53,5615,53,allow,243,94,149,2,30,1,1
64359,53,62943,53,allow,196,102,94,2,30,1,1
56617,53,16257,53,allow,286,94,192,2,30,1,1
55972,53,36064,53,allow,193,102,91,2,30,1,1
55559,53,59475,53,allow,182,94,88,2,30,1,1
65020,53,52884,53,allow,289,102,187,2,30,1,1
55951,53,63735,53,allow,197,102,95,2,31,1,1
65277,53,17756,53,allow,819,102,717,2,31,1,1
55972,53,18787,53,allow,193,102,91,2,31,1,1
63945,53,11861,53,allow,216,110,106,2,31,1,1
64742,53,40488,53,allow,194,94,100,2,31,1,1
58612,443,21355,443,allow,154,94,60,2,5,1,1
55759,445,0,0,drop,70,70,0,1,0,1,0
50699,445,0,0,drop,70,70,0,1,0,1,0
50689,445,0,0,drop,70,70,0,1,0,1,0
55746,445,0,0,drop,70,70,0,1,0,1,0
55743,445,0,0,drop,70,70,0,1,0,1,0
50685,445,0,0,drop,70,70,0,1,0,1,0
50680,445,0,0,drop,70,70,0,1,0,1,0
51144,445,0,0,drop,66,66,0,1,0,1,0
55741,445,0,0,drop,70,70,0,1,0,1,0
55734,445,0,0,drop,70,70,0,1,0,1,0
50678,445,0,0,drop,70,70,0,1,0,1,0
36945,23,0,0,deny,60,60,0,1,0,1,0
51137,445,0,0,drop,66,66,0,1,0,1,0
51134,445,0,0,drop,66,66,0,1,0,1,0
55731,445,0,0,drop,70,70,0,1,0,1,0
55726,445,0,0,drop,70,70,0,1,0,1,0
55721,445,0,0,drop,70,70,0,1,0,1,0
51132,445,0,0,drop,66,66,0,1,0,1,0
55712,445,0,0,drop,70,70,0,1,0,1,0
51117,445,0,0,drop,66,66,0,1,0,1,0
51114,445,0,0,drop,66,66,0,1,0,1,0
51113,445,0,0,drop,66,66,0,1,0,1,0
51112,445,0,0,drop,66,66,0,1,0,1,0
50658,445,0,0,drop,70,70,0,1,0,1,0
55707,445,0,0,drop,70,70,0,1,0,1,0
55705,445,0,0,drop,70,70,0,1,0,1,0
51110,445,0,0,drop,66,66,0,1,0,1,0
55699,445,0,0,drop,70,70,0,1,0,1,0
50653,445,0,0,drop,70,70,0,1,0,1,0
51106,445,0,0,drop,66,66,0,1,0,1,0
51101,445,0,0,drop,66,66,0,1,0,1,0
55685,445,0,0,drop,70,70,0,1,0,1,0
55684,445,0,0,drop,70,70,0,1,0,1,0
50643,445,0,0,drop,70,70,0,1,0,1,0
50641,445,0,0,drop,70,70,0,1,0,1,0
51092,445,0,0,drop,66,66,0,1,0,1,0
50640,445,0,0,drop,70,70,0,1,0,1,0
50639,445,0,0,drop,70,70,0,1,0,1,0
50638,445,0,0,drop,70,70,0,1,0,1,0
50635,445,0,0,drop,70,70,0,1,0,1,0
50632,445,0,0,drop,70,70,0,1,0,1,0
51083,445,0,0,drop,66,66,0,1,0,1,0
50620,445,0,0,drop,70,70,0,1,0,1,0
50619,445,0,0,drop,70,70,0,1,0,1,0
63864,23,0,0,deny,60,60,0,1,0,1,0
50609,445,0,0,drop,70,70,0,1,0,1,0
51073,445,0,0,drop,66,66,0,1,0,1,0
64614,53,55255,53,allow,168,86,82,2,30,1,1
56117,53,10364,53,allow,757,98,659,2,30,1,1
55479,53,3977,53,allow,789,110,679,2,30,1,1
64756,53,24462,53,allow,757,98,659,2,30,1,1
57108,53,22880,53,allow,186,95,91,2,30,1,1
55972,53,10428,53,allow,186,95,91,2,30,1,1
57594,443,61887,443,allow,291,171,120,4,15,2,2
63808,53,2452,53,allow,578,286,292,9,15,5,4
37570,443,53443,443,allow,986,499,487,9,17,5,4
64835,53,1399,53,allow,200,102,98,2,30,1,1
56243,53,64458,53,allow,762,101,661,2,30,1,1
55559,53,26431,53,allow,180,92,88,2,30,1,1
65460,53,42143,53,allow,194,99,95,2,31,1,1
56296,53,43298,53,allow,216,110,106,2,30,1,1
50582,53,45109,53,allow,216,110,106,2,30,1,1
65277,53,20067,53,allow,196,102,94,2,30,1,1
65127,53,38412,53,allow,194,102,92,2,30,1,1
57122,53,32018,53,allow,216,110,106,2,30,1,1
49364,53,61563,53,allow,182,94,88,2,30,1,1
64950,53,11191,53,allow,326,88,238,4,52,2,2
65460,53,26483,53,allow,197,102,95,2,30,1,1
49364,53,40148,53,allow,182,94,88,2,30,1,1
57108,53,35898,53,allow,193,102,91,2,30,1,1
55824,53,60939,53,allow,819,102,717,2,30,1,1
64614,53,52648,53,allow,168,86,82,2,31,1,1
36448,80,28179,80,allow,1325,336,989,10,15,5,5
56435,53,21877,53,allow,193,102,91,2,30,1,1
64580,53,23762,53,allow,199,102,97,2,30,1,1
55824,53,12441,53,allow,196,102,94,2,30,1,1
57108,53,37838,53,allow,193,102,91,2,30,1,1
65134,53,31124,53,allow,229,110,119,2,30,1,1
36924,53,36924,53,allow,257,106,151,2,30,1,1
57122,53,3566,53,allow,216,110,106,2,30,1,1
65403,53,24512,53,allow,249,102,147,2,30,1,1
50561,53,34475,53,allow,763,102,661,2,30,1,1
48016,443,47269,443,allow,138,78,60,2,5,1,1
37523,443,28556,443,allow,154,94,60,2,4,1,1
57416,66,17429,66,allow,70,70,0,2,7,2,0
56712,53,4721,53,allow,448,184,264,6,29,3,3
50572,80,46272,80,allow,62,62,0,1,5,1,0
64968,53,11604,53,allow,448,98,350,4,41,2,2
65123,53,24943,53,allow,307,110,197,2,29,1,1
55559,53,16251,53,allow,182,94,88,2,30,1,1
49177,53,27104,53,allow,184,94,90,2,30,1,1
55559,53,6941,53,allow,182,94,88,2,29,1,1
55017,53,20456,53,allow,288,110,178,2,29,1,1
64580,53,13673,53,allow,199,102,97,2,30,1,1
57108,53,1595,53,allow,193,102,91,2,30,1,1
56322,53,24189,53,allow,209,110,99,2,30,1,1
64835,53,60535,53,allow,200,102,98,2,31,1,1
52155,80,42520,80,allow,1056,682,374,10,15,6,4
56862,53,7245,53,allow,198,94,104,2,30,1,1
49364,53,15202,53,allow,182,94,88,2,30,1,1
56829,53,48980,53,allow,199,102,97,2,30,1,1
50582,53,14787,53,allow,216,110,106,2,30,1,1
57330,53,31519,53,allow,228,94,134,2,30,1,1
56435,53,33982,53,allow,193,102,91,2,30,1,1
64615,53,40640,53,allow,198,94,104,2,30,1,1
56829,53,59229,53,allow,199,102,97,2,30,1,1
55535,53,57254,53,allow,199,102,97,2,30,1,1
55535,53,2360,53,allow,199,102,97,2,31,1,1
50008,53,47667,53,allow,193,102,91,2,31,1,1
64357,53,38839,53,allow,469,103,366,4,43,2,2
43078,80,13694,80,allow,1052,612,440,10,15,5,5
63945,53,38413,53,allow,216,110,106,2,30,1,1
60900,443,23820,443,allow,134,60,74,3,6,2,1
64659,53,14647,53,allow,464,99,365,4,39,2,2
45227,80,43141,80,allow,1114,534,580,12,16,7,5
43175,53,11498,53,allow,194,86,108,2,30,1,1
50598,445,0,0,drop,70,70,0,1,0,1,0
55664,445,0,0,drop,70,70,0,1,0,1,0
55659,445,0,0,drop,70,70,0,1,0,1,0
51052,445,0,0,drop,66,66,0,1,0,1,0
51054,445,0,0,drop,66,66,0,1,0,1,0
51051,445,0,0,drop,66,66,0,1,0,1,0
51058,445,0,0,drop,66,66,0,1,0,1,0
51055,445,0,0,drop,66,66,0,1,0,1,0
51056,445,0,0,drop,66,66,0,1,0,1,0
57896,1,0,0,deny,100,100,0,1,0,1,0
50594,445,0,0,drop,70,70,0,1,0,1,0
41836,23,0,0,deny,60,60,0,1,0,1,0
50583,445,0,0,drop,70,70,0,1,0,1,0
50585,445,0,0,drop,70,70,0,1,0,1,0
50579,445,0,0,drop,70,70,0,1,0,1,0
50578,445,0,0,drop,70,70,0,1,0,1,0
55654,445,0,0,drop,70,70,0,1,0,1,0
55649,445,0,0,drop,70,70,0,1,0,1,0
51038,445,0,0,drop,66,66,0,1,0,1,0
51037,445,0,0,drop,66,66,0,1,0,1,0
51035,445,0,0,drop,66,66,0,1,0,1,0
55639,445,0,0,drop,70,70,0,1,0,1,0
55634,445,0,0,drop,70,70,0,1,0,1,0
50564,445,0,0,drop,70,70,0,1,0,1,0
50558,445,0,0,drop,70,70,0,1,0,1,0
55621,445,0,0,drop,70,70,0,1,0,1,0
55615,445,0,0,deny,70,70,0,1,0,1,0
50551,445,0,0,drop,70,70,0,1,0,1,0
55613,445,0,0,drop,70,70,0,1,0,1,0
55606,445,0,0,drop,70,70,0,1,0,1,0
50546,445,0,0,drop,70,70,0,1,0,1,0
51009,445,0,0,drop,66,66,0,1,0,1,0
51006,445,0,0,drop,66,66,0,1,0,1,0
55601,445,0,0,drop,70,70,0,1,0,1,0
51004,445,0,0,drop,66,66,0,1,0,1,0
56793,53,56695,53,allow,192,98,94,2,0,1,1
50533,445,0,0,drop,70,70,0,1,0,1,0
55584,445,0,0,drop,70,70,0,1,0,1,0
50995,445,0,0,deny,66,66,0,1,0,1,0
50989,445,0,0,drop,66,66,0,1,0,1,0
50987,445,0,0,drop,66,66,0,1,0,1,0
50985,445,0,0,drop,66,66,0,1,0,1,0
50984,445,0,0,drop,66,66,0,1,0,1,0
55578,445,0,0,drop,70,70,0,1,0,1,0
55572,445,0,0,drop,70,70,0,1,0,1,0
55573,445,0,0,drop,70,70,0,1,0,1,0
50982,445,0,0,drop,66,66,0,1,0,1,0
55571,445,0,0,drop,70,70,0,1,0,1,0
50979,445,0,0,drop,66,66,0,1,0,1,0
50522,445,0,0,drop,70,70,0,1,0,1,0
50977,445,0,0,drop,66,66,0,1,0,1,0
50973,445,0,0,drop,66,66,0,1,0,1,0
55566,445,0,0,drop,70,70,0,1,0,1,0
50515,445,0,0,drop,70,70,0,1,0,1,0
55559,445,0,0,drop,70,70,0,1,0,1,0
55554,445,0,0,drop,70,70,0,1,0,1,0
50513,445,0,0,drop,70,70,0,1,0,1,0
65114,53,35237,53,allow,192,98,94,2,30,1,1
64289,53,24247,53,allow,198,101,97,2,30,1,1
49660,53,64845,53,allow,186,95,91,2,30,1,1
65176,53,13076,53,allow,299,103,196,4,51,2,2
50008,53,29808,53,allow,186,95,91,2,30,1,1
64926,53,43197,53,allow,192,98,94,2,40,1,1
55535,53,31917,53,allow,198,101,97,2,30,1,1
65201,53,7188,53,allow,216,110,106,2,30,1,1
55090,53,47013,53,allow,192,98,94,2,30,1,1
56296,53,27962,53,allow,216,110,106,2,30,1,1
50965,445,0,0,drop,66,66,0,1,0,1,0
50512,445,0,0,drop,70,70,0,1,0,1,0
50510,445,0,0,drop,70,70,0,1,0,1,0
50507,445,0,0,drop,70,70,0,1,0,1,0
50506,445,0,0,drop,70,70,0,1,0,1,0
50955,445,0,0,drop,66,66,0,1,0,1,0
65201,53,5294,53,allow,216,110,106,2,30,1,1
55543,445,0,0,drop,70,70,0,1,0,1,0
50492,445,0,0,drop,70,70,0,1,0,1,0
50490,445,0,0,drop,70,70,0,1,0,1,0
50481,445,0,0,drop,70,70,0,1,0,1,0
50953,445,0,0,drop,66,66,0,1,0,1,0
41995,80,63213,80,allow,1105,634,471,11,15,6,5
55535,53,24278,53,allow,199,102,97,2,29,1,1
56322,53,19228,53,allow,209,110,99,2,29,1,1
50008,53,33522,53,allow,193,102,91,2,29,1,1
39953,80,18059,80,allow,1035,564,471,10,15,5,5
48015,443,20608,443,allow,138,78,60,2,4,1,1
55972,53,35969,53,allow,193,102,91,2,29,1,1
55090,53,34414,53,allow,196,102,94,2,29,1,1
55090,53,59676,53,allow,196,102,94,2,29,1,1
56296,53,37666,53,allow,216,110,106,2,30,1,1
64835,53,33008,53,allow,200,102,98,2,29,1,1
56296,53,12716,53,allow,216,110,106,2,29,1,1
57455,123,24910,123,allow,184,94,90,2,29,1,1
55090,53,17815,53,allow,196,102,94,2,30,1,1
56597,80,61984,80,allow,234,234,0,4,12,4,0
65114,53,28927,53,allow,196,102,94,2,30,1,1
65208,53,46888,53,allow,637,178,459,6,70,3,3
37234,53,61804,53,allow,168,78,90,2,30,1,1
50008,53,59037,53,allow,359,95,264,4,46,2,2
63964,53,52901,53,allow,196,94,102,2,30,1,1
57780,53,53500,53,allow,70,70,0,1,30,1,0
65460,53,30831,53,allow,197,102,95,2,30,1,1
57582,80,30299,80,allow,370,222,148,6,48,4,2
60156,443,49389,443,allow,178,118,60,2,15,1,1
56925,80,48459,80,allow,214,140,74,4,25,3,1
53715,443,45128,443,allow,70,70,0,2,8,2,0
65176,53,64803,53,allow,299,103,196,4,51,2,2
49660,53,23772,53,allow,193,102,91,2,30,1,1
63945,53,51432,53,allow,216,110,106,2,29,1,1
49450,53,27588,53,allow,227,94,133,2,29,1,1
65127,53,53558,53,allow,194,102,92,2,29,1,1
64416,53,53808,53,allow,211,94,117,2,30,1,1
64414,53,58315,53,allow,406,142,264,2,30,1,1
60715,80,28604,80,allow,198,78,120,4,11,2,2
56315,123,48493,123,allow,184,94,90,2,30,1,1
64614,53,61495,53,allow,538,179,359,6,63,3,3
64289,53,50043,53,allow,199,102,97,2,30,1,1
64289,53,28932,53,allow,199,102,97,2,30,1,1
65201,53,42204,53,allow,216,110,106,2,30,1,1
64289,53,64357,53,allow,199,102,97,2,30,1,1
51711,1027,5156,1027,allow,70,70,0,1,5,1,0
56926,80,46037,80,allow,214,140,74,4,25,3,1
49820,123,49820,123,allow,184,94,90,2,30,1,1
65460,53,40464,53,allow,197,102,95,2,30,1,1
65201,53,38349,53,allow,216,110,106,2,30,1,1
61178,53,58018,53,allow,290,86,204,2,30,1,1
49222,53,61468,53,allow,418,150,268,2,30,1,1
48555,53,5829,53,allow,215,86,129,2,30,1,1
65114,53,27541,53,allow,196,102,94,2,31,1,1
49660,53,56463,53,allow,193,102,91,2,31,1,1
65515,53,22832,53,allow,338,107,231,4,39,2,2
42922,80,41285,80,allow,234,234,0,4,12,4,0
50939,445,0,0,drop,66,66,0,1,0,1,0
50470,445,0,0,drop,70,70,0,1,0,1,0
55536,445,0,0,drop,70,70,0,1,0,1,0
55531,445,0,0,drop,70,70,0,1,0,1,0
50926,445,0,0,drop,66,66,0,1,0,1,0
50925,445,0,0,drop,66,66,0,1,0,1,0
50930,445,0,0,drop,66,66,0,1,0,1,0
50924,445,0,0,drop,66,66,0,1,0,1,0
50923,445,0,0,drop,66,66,0,1,0,1,0
50466,445,0,0,drop,70,70,0,1,0,1,0
50457,445,0,0,drop,70,70,0,1,0,1,0
50449,445,0,0,drop,70,70,0,1,0,1,0
49717,666,0,0,deny,60,60,0,1,0,1,0
50910,445,0,0,drop,66,66,0,1,0,1,0
50908,445,0,0,drop,66,66,0,1,0,1,0
50907,445,0,0,drop,66,66,0,1,0,1,0
55511,445,0,0,drop,70,70,0,1,0,1,0
55502,445,0,0,drop,70,70,0,1,0,1,0
50436,445,0,0,drop,70,70,0,1,0,1,0
50971,443,37029,443,allow,469,403,66,4,0,3,1
50970,443,47824,443,allow,469,403,66,4,0,3,1
50433,445,0,0,drop,70,70,0,1,0,1,0
55489,445,0,0,drop,70,70,0,1,0,1,0
50424,445,0,0,drop,70,70,0,1,0,1,0
50886,445,0,0,drop,66,66,0,1,0,1,0
55485,445,0,0,drop,70,70,0,1,0,1,0
50418,445,0,0,drop,70,70,0,1,0,1,0
50881,445,0,0,drop,66,66,0,1,0,1,0
50878,445,0,0,drop,66,66,0,1,0,1,0
55471,445,0,0,drop,70,70,0,1,0,1,0
55466,445,0,0,drop,70,70,0,1,0,1,0
50875,445,0,0,drop,66,66,0,1,0,1,0
50405,445,0,0,drop,70,70,0,1,0,1,0
55456,445,0,0,drop,70,70,0,1,0,1,0
55454,445,0,0,drop,70,70,0,1,0,1,0
55453,445,0,0,drop,70,70,0,1,0,1,0
50861,445,0,0,drop,66,66,0,1,0,1,0
50856,445,0,0,drop,66,66,0,1,0,1,0
50859,445,0,0,drop,66,66,0,1,0,1,0
50858,445,0,0,drop,66,66,0,1,0,1,0
50397,445,0,0,drop,70,70,0,1,0,1,0
55450,445,0,0,drop,70,70,0,1,0,1,0
55446,445,0,0,drop,70,70,0,1,0,1,0
50854,445,0,0,drop,66,66,0,1,0,1,0
54540,22,0,0,deny,60,60,0,1,0,1,0
50849,445,0,0,drop,66,66,0,1,0,1,0
56526,80,57143,80,allow,1056,682,374,10,15,6,4
60323,443,19514,443,allow,1743,1164,579,16,25,10,6
60324,443,7520,443,allow,1743,1164,579,16,25,10,6
63383,53,63383,53,allow,235,90,145,2,33,1,1
38085,443,21750,443,allow,234,234,0,4,12,4,0
60321,443,49674,443,allow,1743,1164,579,16,25,10,6
60320,443,16711,443,allow,1743,1164,579,16,25,10,6
61692,443,18049,443,allow,126,60,66,3,10,2,1
51727,1024,33037,1024,allow,70,70,0,2,8,2,0
63976,53,34685,53,allow,200,102,98,2,30,1,1
60322,443,12700,443,allow,1743,1164,579,16,25,10,6
56597,53,9477,53,allow,197,197,0,3,60,3,0
50845,445,0,0,drop,66,66,0,1,0,1,0
50387,445,0,0,drop,70,70,0,1,0,1,0
50385,445,0,0,drop,70,70,0,1,0,1,0
55432,445,0,0,drop,70,70,0,1,0,1,0
50384,445,0,0,drop,70,70,0,1,0,1,0
50383,445,0,0,drop,70,70,0,1,0,1,0
50382,445,0,0,drop,70,70,0,1,0,1,0
50378,445,0,0,drop,70,70,0,1,0,1,0
50362,445,0,0,drop,70,70,0,1,0,1,0
50361,445,0,0,drop,70,70,0,1,0,1,0
50359,445,0,0,drop,70,70,0,1,0,1,0
50827,445,0,0,drop,66,66,0,1,0,1,0
55415,445,0,0,drop,70,70,0,1,0,1,0
50351,445,0,0,drop,70,70,0,1,0,1,0
50824,445,0,0,drop,66,66,0,1,0,1,0
39839,67,0,0,deny,60,60,0,1,0,1,0
50340,445,0,0,drop,70,70,0,1,0,1,0
50336,445,0,0,drop,70,70,0,1,0,1,0
55407,445,0,0,drop,70,70,0,1,0,1,0
55403,445,0,0,drop,70,70,0,1,0,1,0
53472,17,0,0,deny,60,60,0,1,0,1,0
45001,443,55898,443,allow,570,318,252,10,20,6,4
58248,53,0,0,allow,633,83,550,2,30,1,1
65476,53,44080,53,allow,226,110,116,2,29,1,1
65304,53,52702,53,allow,194,86,108,2,29,1,1
62678,53,62678,53,allow,216,90,126,2,30,1,1
65176,53,35354,53,allow,511,195,316,6,56,3,3
49577,53,54563,53,allow,384,94,290,2,30,1,1
60239,53,53135,53,allow,219,102,117,2,30,1,1
55610,53,9648,53,allow,265,91,174,4,36,2,2
57170,53,13134,53,allow,298,102,196,4,36,2,2
49634,443,7107,443,allow,1575,988,587,13,35,7,6
49359,53,57768,53,allow,102,102,0,1,60,1,0
58248,53,0,0,allow,186,83,103,2,30,1,1
65005,53,2818,53,allow,239,94,145,2,30,1,1
49711,80,42345,80,allow,2269,821,1448,15,51,8,7
65008,53,8162,53,allow,312,94,218,2,30,1,1
57266,53,22077,53,allow,209,102,107,2,30,1,1
49891,443,20308,443,allow,1820,1101,719,18,73,10,8
56009,53,4440,53,allow,232,94,138,2,30,1,1
60319,80,61391,80,allow,194,128,66,4,25,3,1
63976,53,54161,53,allow,200,102,98,2,33,1,1
49892,443,65121,443,allow,1820,1101,719,18,73,10,8
65176,53,60246,53,allow,299,103,196,4,53,2,2
49660,53,59057,53,allow,193,102,91,2,29,1,1
53392,53,53392,53,allow,832,106,726,2,30,1,1
65073,53,55415,53,allow,325,102,223,2,29,1,1
65114,53,15041,53,allow,196,102,94,2,29,1,1
58409,53,57147,53,allow,307,86,221,2,30,1,1
56459,53,55165,53,allow,392,86,306,2,30,1,1
55330,53,4334,53,allow,216,102,114,2,30,1,1
63976,53,50670,53,allow,200,102,98,2,30,1,1
49538,53,56684,53,allow,258,102,156,2,30,1,1
65278,53,45335,53,allow,264,110,154,2,30,1,1
58828,53,32002,53,allow,215,102,113,2,30,1,1
43817,53,0,0,allow,82,82,0,2,40,2,0
49688,443,44354,443,allow,318,192,126,6,53,4,2
63718,80,18056,80,allow,314,192,122,6,15,4,2
64038,53,4227,53,allow,321,102,219,2,30,1,1
58562,53,31864,53,allow,215,102,113,2,30,1,1
64745,53,11106,53,allow,196,94,102,2,31,1,1
36716,53,54815,53,allow,224,78,146,2,31,1,1
50796,445,0,0,drop,66,66,0,1,0,1,0
50802,445,0,0,drop,66,66,0,1,0,1,0
50795,445,0,0,drop,66,66,0,1,0,1,0
50798,445,0,0,drop,66,66,0,1,0,1,0
50797,445,0,0,drop,66,66,0,1,0,1,0
50794,445,0,0,drop,66,66,0,1,0,1,0
50325,445,0,0,drop,70,70,0,1,0,1,0
50321,445,0,0,drop,70,70,0,1,0,1,0
50319,445,0,0,drop,70,70,0,1,0,1,0
55394,445,0,0,drop,70,70,0,1,0,1,0
50780,445,0,0,drop,66,66,0,1,0,1,0
50782,445,0,0,drop,66,66,0,1,0,1,0
50779,445,0,0,drop,66,66,0,1,0,1,0
50313,445,0,0,drop,70,70,0,1,0,1,0
55383,445,0,0,drop,70,70,0,1,0,1,0
55377,445,0,0,drop,70,70,0,1,0,1,0
55375,445,0,0,drop,70,70,0,1,0,1,0
55373,445,0,0,drop,70,70,0,1,0,1,0
50306,445,0,0,drop,70,70,0,1,0,1,0
55364,445,0,0,drop,70,70,0,1,0,1,0
55359,445,0,0,drop,70,70,0,1,0,1,0
50294,445,0,0,drop,70,70,0,1,0,1,0
58036,443,0,0,deny,1097,1097,0,1,0,1,0
50759,445,0,0,drop,66,66,0,1,0,1,0
55357,445,0,0,drop,70,70,0,1,0,1,0
50288,445,0,0,drop,70,70,0,1,0,1,0
50753,445,0,0,drop,66,66,0,1,0,1,0
50750,445,0,0,drop,66,66,0,1,0,1,0
55344,445,0,0,drop,70,70,0,1,0,1,0
50748,445,0,0,drop,66,66,0,1,0,1,0
64616,53,29802,53,allow,184,80,104,2,30,1,1
40709,53,32661,53,allow,221,75,146,2,30,1,1
52765,443,14674,443,allow,283,163,120,4,16,2,2
50967,80,65454,80,allow,1439,697,742,12,35,6,6
57595,80,57595,80,allow,254,120,134,5,26,3,2
48381,53,16694,53,allow,221,75,146,2,30,1,1
55328,445,0,0,drop,70,70,0,1,0,1,0
55326,445,0,0,drop,70,70,0,1,0,1,0
50739,445,0,0,drop,66,66,0,1,0,1,0
50733,445,0,0,drop,66,66,0,1,0,1,0
50732,445,0,0,drop,66,66,0,1,0,1,0
50731,445,0,0,drop,66,66,0,1,0,1,0
50730,445,0,0,drop,66,66,0,1,0,1,0
50728,445,0,0,drop,66,66,0,1,0,1,0
50266,445,0,0,drop,70,70,0,1,0,1,0
57493,443,0,0,deny,60,60,0,1,0,1,0
55323,445,0,0,drop,70,70,0,1,0,1,0
55318,445,0,0,drop,70,70,0,1,0,1,0
55320,445,0,0,drop,70,70,0,1,0,1,0
50725,445,0,0,drop,66,66,0,1,0,1,0
55315,445,0,0,drop,70,70,0,1,0,1,0
50723,445,0,0,drop,66,66,0,1,0,1,0
50717,445,0,0,drop,66,66,0,1,0,1,0
50256,445,0,0,drop,70,70,0,1,0,1,0
50254,445,0,0,drop,70,70,0,1,0,1,0
55310,445,0,0,drop,70,70,0,1,0,1,0
50253,445,0,0,drop,70,70,0,1,0,1,0
50252,445,0,0,drop,70,70,0,1,0,1,0
50251,445,0,0,drop,70,70,0,1,0,1,0
50249,445,0,0,drop,70,70,0,1,0,1,0
50233,445,0,0,drop,70,70,0,1,0,1,0
50231,445,0,0,drop,70,70,0,1,0,1,0
50230,445,0,0,drop,70,70,0,1,0,1,0
50699,445,0,0,drop,66,66,0,1,0,1,0
58438,53,46803,53,allow,246,102,144,2,29,1,1
50316,80,27928,80,allow,1677,862,815,10,15,5,5
50028,53,56615,53,allow,323,110,213,2,29,1,1
50013,53,8122,53,allow,662,195,467,6,39,3,3
38413,53,37201,53,allow,199,94,105,2,29,1,1
37752,53,54109,53,allow,220,78,142,2,30,1,1
59437,53,35841,53,allow,215,86,129,2,29,1,1
58602,53,5583,53,allow,197,86,111,2,29,1,1
42805,443,52110,443,allow,130,70,60,2,15,1,1
49445,80,19716,80,allow,1586,808,778,13,45,7,6
49166,53,8191,53,allow,468,93,375,4,34,2,2
64593,53,5715,53,allow,602,93,509,4,42,2,2
43532,80,43879,80,allow,1449,364,1085,13,15,6,7
65318,53,16200,53,allow,395,102,293,2,30,1,1
43402,53,65461,53,allow,241,78,163,2,30,1,1
49812,53,37839,53,allow,195,86,109,2,30,1,1
39417,53,53271,53,allow,224,78,146,2,30,1,1
59420,53,63231,53,allow,224,78,146,2,30,1,1
49505,53,46670,53,allow,232,110,122,2,30,1,1
52203,80,56885,80,allow,432,246,186,7,40,4,3
49154,53,7041,53,allow,763,204,559,6,40,3,3
49792,53,58447,53,allow,339,110,229,2,30,1,1
52402,53,52402,53,allow,212,98,114,2,30,1,1
49230,53,32099,53,allow,195,94,101,2,30,1,1
56595,80,43530,80,allow,234,234,0,4,12,4,0
51069,80,24367,80,allow,254,128,126,5,15,3,2
53868,53,29458,53,allow,86,86,0,1,30,1,0
50377,80,8000,80,allow,1451,796,655,11,31,6,5
58866,53,56575,53,allow,355,118,237,2,29,1,1
60425,443,26007,443,allow,1541,1004,537,14,26,8,6
64947,53,12228,53,allow,402,118,284,2,29,1,1
61412,53,24202,53,allow,225,78,147,2,30,1,1
50313,80,63654,80,allow,736,670,66,6,15,5,1
46619,123,26763,123,allow,184,94,90,2,30,1,1
36928,53,43446,53,allow,241,78,163,2,30,1,1
57318,53,50520,53,allow,418,88,330,4,41,2,2
44674,80,41945,80,allow,1298,624,674,12,16,5,7
64772,53,2611,53,allow,633,231,402,6,47,3,3
64000,53,61132,53,allow,214,102,112,2,30,1,1
51108,53,64155,53,allow,168,78,90,2,30,1,1
57099,53,12968,53,allow,278,102,176,2,31,1,1
52208,80,51352,80,allow,372,246,126,6,28,4,2
50308,80,8289,80,allow,1083,653,430,8,16,5,3
58959,53,45652,53,allow,307,86,221,2,30,1,1
53479,23,0,0,deny,60,60,0,1,0,1,0
50696,445,0,0,drop,66,66,0,1,0,1,0
43704,465,0,0,deny,60,60,0,1,0,1,0
50681,445,0,0,drop,66,66,0,1,0,1,0
50207,445,0,0,drop,70,70,0,1,0,1,0
50968,443,1243,443,allow,469,403,66,4,0,3,1
50969,443,54163,443,allow,469,403,66,4,0,3,1
56942,443,61847,443,allow,494,420,74,4,0,3,1
55278,445,0,0,drop,70,70,0,1,0,1,0
55276,445,0,0,drop,70,70,0,1,0,1,0
50670,445,0,0,drop,66,66,0,1,0,1,0
50668,445,0,0,drop,66,66,0,1,0,1,0
50673,445,0,0,drop,66,66,0,1,0,1,0
50672,445,0,0,drop,66,66,0,1,0,1,0
50666,445,0,0,drop,66,66,0,1,0,1,0
50667,445,0,0,drop,66,66,0,1,0,1,0
50196,445,0,0,drop,70,70,0,1,0,1,0
55273,445,0,0,drop,70,70,0,1,0,1,0
55265,445,0,0,drop,70,70,0,1,0,1,0
59059,80,0,0,deny,62,62,0,1,0,1,0
50184,445,0,0,drop,70,70,0,1,0,1,0
50654,445,0,0,drop,66,66,0,1,0,1,0
50652,445,0,0,drop,66,66,0,1,0,1,0
50653,445,0,0,drop,66,66,0,1,0,1,0
55258,445,0,0,drop,70,70,0,1,0,1,0
50177,445,0,0,drop,70,70,0,1,0,1,0
55255,445,0,0,drop,70,70,0,1,0,1,0
50174,445,0,0,drop,70,70,0,1,0,1,0
55252,445,0,0,drop,70,70,0,1,0,1,0
50165,445,0,0,drop,70,70,0,1,0,1,0
55236,445,0,0,drop,70,70,0,1,0,1,0
55231,445,0,0,drop,70,70,0,1,0,1,0
50163,445,0,0,drop,70,70,0,1,0,1,0
50632,445,0,0,drop,66,66,0,1,0,1,0
50626,445,0,0,drop,66,66,0,1,0,1,0
49631,53,0,0,allow,82,82,0,1,30,1,0
60152,80,38610,80,allow,1056,682,374,10,15,6,4
38725,80,37134,80,allow,130,70,60,2,15,1,1
49816,80,56471,80,allow,130,70,60,2,15,1,1
39540,80,37629,80,allow,130,70,60,2,15,1,1
65045,53,53307,53,allow,194,99,95,2,30,1,1
53852,80,48149,80,allow,130,70,60,2,15,1,1
56524,53,52908,53,allow,711,87,624,2,31,1,1
42298,443,10335,443,allow,64,64,0,1,31,1,0
50620,445,0,0,drop,66,66,0,1,0,1,0
58972,80,64079,80,allow,943,513,430,9,14,6,3
52207,80,29595,80,allow,372,246,126,6,27,4,2
65045,53,16728,53,allow,197,102,95,2,29,1,1
56051,53,2559,53,allow,249,102,147,2,29,1,1
49952,53,43225,53,allow,196,94,102,2,30,1,1
52206,80,42642,80,allow,372,246,126,6,27,4,2
61713,80,49521,80,allow,134,60,74,3,5,2,1
61707,80,47062,80,allow,134,60,74,3,4,2,1
47655,53,46246,53,allow,168,78,90,2,29,1,1
64045,53,1404,53,allow,1011,232,779,6,55,3,3
64735,53,29173,53,allow,350,118,232,2,29,1,1
49811,53,32866,53,allow,308,110,198,2,29,1,1
64382,53,40543,53,allow,278,102,176,2,30,1,1
65450,53,49502,53,allow,336,110,226,2,30,1,1
52182,53,52182,53,allow,832,106,726,2,30,1,1
49232,53,52451,53,allow,242,78,164,2,29,1,1
59601,443,24962,443,allow,162,102,60,2,5,1,1
56377,80,8742,80,allow,1633,943,690,15,72,8,7
55887,53,55333,53,allow,212,94,118,2,30,1,1
57092,53,3743,53,allow,228,102,126,2,30,1,1
64351,53,15747,53,allow,228,102,126,2,30,1,1
37707,53,28750,53,allow,168,78,90,2,30,1,1
49976,53,5693,53,allow,393,110,283,2,30,1,1
59877,80,9809,80,allow,1306,557,749,10,25,6,4
55179,53,7582,53,allow,194,102,92,2,33,1,1
49287,53,21721,53,allow,405,90,315,4,59,2,2
65306,53,12072,53,allow,244,94,150,2,30,1,1
52209,80,41464,80,allow,372,246,126,6,27,4,2
43412,80,13841,80,allow,78,78,0,1,4,1,0
36927,80,32507,80,allow,130,70,60,2,14,1,1
52210,80,30096,80,allow,372,246,126,6,30,4,2
65045,53,56055,53,allow,197,102,95,2,32,1,1
65233,53,6826,53,allow,448,130,318,4,44,2,2
65169,80,56657,80,allow,1516,481,1035,11,15,6,5
64454,53,61289,53,allow,293,110,183,2,29,1,1
65309,53,47712,53,allow,258,110,148,2,30,1,1
57604,53,48752,53,allow,290,86,204,2,29,1,1
54385,53,14777,53,allow,168,78,90,2,30,1,1
55320,53,12991,53,allow,239,102,137,2,30,1,1
58151,53,58151,53,allow,241,98,143,2,30,1,1
60520,53,60520,53,allow,198,90,108,2,30,1,1
55087,53,44618,53,allow,344,110,234,2,30,1,1
50388,53,36843,53,allow,177,94,83,2,30,1,1
57589,53,7858,53,allow,165,78,87,2,30,1,1
64575,53,36717,53,allow,268,110,158,2,31,1,1
56376,80,29400,80,allow,1635,945,690,15,72,8,7
54942,53,0,0,allow,168,74,94,2,30,1,1
64006,53,16897,53,allow,394,96,298,4,47,2,2
65519,53,27344,53,allow,321,102,219,2,30,1,1
56375,80,51111,80,allow,1609,919,690,15,72,8,7
55350,53,18566,53,allow,315,95,220,4,50,2,2
49899,53,23402,53,allow,718,94,624,2,30,1,1
39508,53,12625,53,allow,78,78,0,1,30,1,0
65454,53,35372,53,allow,218,86,132,2,31,1,1
64744,53,33076,53,allow,376,118,258,2,30,1,1
57588,53,31636,53,allow,165,78,87,2,30,1,1
49428,53,34747,53,allow,267,94,173,2,31,1,1
50291,80,56837,80,allow,442,250,192,8,45,5,3
59494,443,39878,443,allow,448,78,370,6,25,1,5
51510,443,23309,443,allow,1047,560,487,10,16,6,4
44924,53,44924,53,allow,235,90,145,2,32,1,1
55640,53,37187,53,allow,797,208,589,6,67,3,3
55198,445,0,0,drop,70,70,0,1,0,1,0
50611,445,0,0,drop,66,66,0,1,0,1,0
50604,445,0,0,drop,66,66,0,1,0,1,0
50603,445,0,0,drop,66,66,0,1,0,1,0
50602,445,0,0,drop,66,66,0,1,0,1,0
50601,445,0,0,drop,66,66,0,1,0,1,0
50135,445,0,0,drop,70,70,0,1,0,1,0
55193,445,0,0,drop,70,70,0,1,0,1,0
50596,445,0,0,drop,66,66,0,1,0,1,0
55187,445,0,0,drop,70,70,0,1,0,1,0
50595,445,0,0,drop,66,66,0,1,0,1,0
50592,445,0,0,drop,66,66,0,1,0,1,0
50128,445,0,0,drop,70,70,0,1,0,1,0
50589,445,0,0,drop,66,66,0,1,0,1,0
50126,445,0,0,drop,70,70,0,1,0,1,0
50125,445,0,0,drop,70,70,0,1,0,1,0
50124,445,0,0,drop,70,70,0,1,0,1,0
55182,445,0,0,drop,70,70,0,1,0,1,0
50119,445,0,0,drop,70,70,0,1,0,1,0
55173,445,0,0,drop,70,70,0,1,0,1,0
50578,445,0,0,drop,66,66,0,1,0,1,0
50105,445,0,0,drop,70,70,0,1,0,1,0
50104,445,0,0,drop,70,70,0,1,0,1,0
50094,445,0,0,drop,70,70,0,1,0,1,0
50571,445,0,0,drop,66,66,0,1,0,1,0
50568,445,0,0,drop,66,66,0,1,0,1,0
50078,445,0,0,drop,70,70,0,1,0,1,0
50067,445,0,0,drop,70,70,0,1,0,1,0
55152,445,0,0,drop,70,70,0,1,0,1,0
55148,445,0,0,drop,70,70,0,1,0,1,0
55147,445,0,0,drop,70,70,0,1,0,1,0
50061,445,0,0,drop,70,70,0,1,0,1,0
50544,445,0,0,drop,66,66,0,1,0,1,0
50542,445,0,0,drop,66,66,0,1,0,1,0
50539,445,0,0,drop,66,66,0,1,0,1,0
50540,445,0,0,drop,66,66,0,1,0,1,0
50538,445,0,0,drop,66,66,0,1,0,1,0
50055,445,0,0,drop,70,70,0,1,0,1,0
55145,445,0,0,drop,70,70,0,1,0,1,0
50526,445,0,0,drop,66,66,0,1,0,1,0
50524,445,0,0,drop,66,66,0,1,0,1,0
50525,445,0,0,drop,66,66,0,1,0,1,0
55129,445,0,0,drop,70,70,0,1,0,1,0
50048,445,0,0,drop,70,70,0,1,0,1,0
50046,445,0,0,drop,70,70,0,1,0,1,0
55127,445,0,0,drop,70,70,0,1,0,1,0
55117,445,0,0,drop,70,70,0,1,0,1,0
55109,445,0,0,drop,70,70,0,1,0,1,0
55108,445,0,0,drop,70,70,0,1,0,1,0
55103,445,0,0,drop,70,70,0,1,0,1,0
50030,445,0,0,drop,70,70,0,1,0,1,0
53189,80,57818,80,allow,1873,713,1160,10,15,5,5
50348,443,42997,443,allow,1385,868,517,12,30,6,6
58196,53,55117,53,allow,578,286,292,9,16,5,4
57170,53,64269,53,allow,200,102,98,2,31,1,1
53191,80,63359,80,allow,1871,712,1159,10,15,5,5
59513,53,30834,53,allow,212,92,120,2,30,1,1
57200,53,48391,53,allow,711,87,624,2,30,1,1
49473,80,51676,80,allow,388,262,126,7,29,5,2
50347,443,6764,443,allow,1385,868,517,12,30,6,6
53190,80,50867,80,allow,1873,713,1160,10,15,5,5
54942,53,0,0,allow,631,74,557,2,30,1,1
57866,53,0,0,allow,216,80,136,2,30,1,1
50349,443,62395,443,allow,1385,868,517,12,30,6,6
60424,443,16988,443,allow,1477,940,537,13,26,7,6
50345,443,44342,443,allow,1385,868,517,12,30,6,6
50346,443,6974,443,allow,1385,868,517,12,30,6,6
59390,53,43106,53,allow,184,86,98,2,31,1,1
49608,53,10158,53,allow,170,87,83,2,31,1,1
55179,53,36377,53,allow,188,96,92,2,31,1,1
50503,445,0,0,drop,66,66,0,1,0,1,0
55100,445,0,0,drop,70,70,0,1,0,1,0
65196,53,4463,53,allow,177,94,83,2,30,1,1
64369,53,59649,53,allow,240,110,130,2,30,1,1
51861,53,51861,53,allow,305,160,145,3,33,2,1
63976,53,54023,53,allow,200,102,98,2,33,1,1
62332,53,0,0,allow,633,75,558,2,29,1,1
65196,53,58386,53,allow,177,94,83,2,30,1,1
49935,53,55130,53,allow,458,111,347,4,59,2,2
49838,53,62523,53,allow,866,221,645,6,56,3,3
64250,53,22733,53,allow,314,102,212,2,29,1,1
62486,53,33326,53,allow,303,303,0,4,47,4,0
64284,53,35627,53,allow,306,94,212,2,29,1,1
52107,53,0,0,allow,621,77,544,2,29,1,1
65482,53,17558,53,allow,278,126,152,2,30,1,1
55577,80,44269,80,allow,70,70,0,1,5,1,0
42298,443,6175,443,allow,70,70,0,1,30,1,0
54991,53,33819,53,allow,177,94,83,2,30,1,1
52394,53,35816,53,allow,168,78,90,2,30,1,1
57353,443,37638,443,allow,150,150,0,1,5,1,0
50390,443,34358,443,allow,1328,876,452,11,29,6,5
50401,443,36442,443,allow,1124,594,530,12,26,6,6
50398,80,47950,80,allow,318,192,126,6,26,4,2
50400,443,29231,443,allow,1124,594,530,12,26,6,6
49472,80,16724,80,allow,318,192,126,6,28,4,2
39609,53,46701,53,allow,168,78,90,2,30,1,1
39158,53,23110,53,allow,168,78,90,2,30,1,1
64803,53,24000,53,allow,303,303,0,4,47,4,0
42222,53,45931,53,allow,209,86,123,2,30,1,1
56825,53,3164,53,allow,177,94,83,2,30,1,1
57839,53,57631,53,allow,231,231,0,4,47,4,0
55776,53,24282,53,allow,168,78,90,2,30,1,1
49855,53,54307,53,allow,212,102,110,2,30,1,1
65445,53,5000,53,allow,718,94,624,2,30,1,1
50392,443,55310,443,allow,1125,595,530,12,29,6,6
61229,53,16392,53,allow,261,261,0,4,47,4,0
59615,53,32493,53,allow,320,94,226,2,30,1,1
56825,53,56167,53,allow,177,94,83,2,30,1,1
57170,53,47776,53,allow,200,102,98,2,30,1,1
50393,443,64712,443,allow,1125,595,530,12,29,6,6
56891,53,55899,53,allow,226,110,116,2,30,1,1
64737,53,9334,53,allow,269,110,159,2,30,1,1
56568,53,11893,53,allow,306,306,0,4,47,4,0
47264,80,26226,80,allow,1737,796,941,12,16,7,5
64842,53,15693,53,allow,340,95,245,4,47,2,2
50399,80,19756,80,allow,318,192,126,6,26,4,2
50292,80,5743,80,allow,442,250,192,8,44,5,3
65447,53,29961,53,allow,330,105,225,4,37,2,2
62597,53,49610,53,allow,306,306,0,4,47,4,0
43057,80,9462,80,allow,1195,401,794,9,16,5,4
62332,53,0,0,allow,170,75,95,2,29,1,1
52107,53,0,0,allow,210,77,133,2,29,1,1
57866,53,0,0,allow,627,80,547,2,29,1,1
50388,53,14304,53,allow,177,94,83,2,29,1,1
55875,53,42726,53,allow,228,110,118,2,30,1,1
44816,80,47339,80,allow,130,70,60,2,15,1,1
51496,443,41580,443,allow,1177,624,553,12,16,7,5
50958,53,30226,53,allow,264,264,0,4,47,4,0
53986,53,63410,53,allow,306,306,0,4,47,4,0
53789,53,48550,53,allow,168,78,90,2,30,1,1
52074,53,21333,53,allow,199,94,105,2,30,1,1
55866,53,14599,53,allow,168,78,90,2,30,1,1
50407,80,54250,80,allow,1388,917,471,11,26,6,5
55593,53,39878,53,allow,288,288,0,4,47,4,0
55610,53,57817,53,allow,181,94,87,2,30,1,1
57171,53,25491,53,allow,214,102,112,2,30,1,1
49197,53,54717,53,allow,214,102,112,2,30,1,1
52838,53,22296,53,allow,168,78,90,2,30,1,1
58472,53,35113,53,allow,246,246,0,4,47,4,0
64237,53,49326,53,allow,227,110,117,2,31,1,1
49608,53,36244,53,allow,177,94,83,2,31,1,1
55664,53,23659,53,allow,177,94,83,2,30,1,1
51401,443,22599,443,allow,202,70,132,3,11,1,2
50497,445,0,0,drop,66,66,0,1,0,1,0
50494,445,0,0,drop,66,66,0,1,0,1,0
50490,445,0,0,drop,66,66,0,1,0,1,0
55070,445,0,0,drop,70,70,0,1,0,1,0
50483,445,0,0,drop,66,66,0,1,0,1,0
50477,445,0,0,drop,66,66,0,1,0,1,0
50475,445,0,0,drop,66,66,0,1,0,1,0
50474,445,0,0,drop,66,66,0,1,0,1,0
50472,445,0,0,drop,66,66,0,1,0,1,0
55066,445,0,0,drop,70,70,0,1,0,1,0
55064,445,0,0,drop,70,70,0,1,0,1,0
55060,445,0,0,drop,70,70,0,1,0,1,0
50469,445,0,0,drop,66,66,0,1,0,1,0
50467,445,0,0,drop,66,66,0,1,0,1,0
49999,445,0,0,drop,70,70,0,1,0,1,0
50464,445,0,0,drop,66,66,0,1,0,1,0
49997,445,0,0,drop,70,70,0,1,0,1,0
50461,445,0,0,drop,66,66,0,1,0,1,0
49996,445,0,0,drop,70,70,0,1,0,1,0
49995,445,0,0,drop,70,70,0,1,0,1,0
49994,445,0,0,drop,70,70,0,1,0,1,0
49992,445,0,0,drop,70,70,0,1,0,1,0
55049,445,0,0,drop,70,70,0,1,0,1,0
49976,445,0,0,drop,70,70,0,1,0,1,0
49975,445,0,0,drop,70,70,0,1,0,1,0
53710,443,55386,443,allow,499,425,74,4,0,3,1
53711,443,24841,443,allow,499,425,74,4,0,3,1
53706,443,53579,443,allow,499,425,74,4,0,3,1
53705,443,11151,443,allow,499,425,74,4,0,3,1
49973,445,0,0,drop,70,70,0,1,0,1,0
49965,445,0,0,drop,70,70,0,1,0,1,0
50443,445,0,0,drop,66,66,0,1,0,1,0
49954,445,0,0,drop,70,70,0,1,0,1,0
50441,445,0,0,drop,66,66,0,1,0,1,0
50424,445,0,0,drop,66,66,0,1,0,1,0
49950,445,0,0,drop,70,70,0,1,0,1,0
49939,445,0,0,drop,70,70,0,1,0,1,0
49935,445,0,0,drop,70,70,0,1,0,1,0
49936,445,0,0,drop,70,70,0,1,0,1,0
55021,445,0,0,drop,70,70,0,1,0,1,0
55019,445,0,0,drop,70,70,0,1,0,1,0
50413,445,0,0,drop,66,66,0,1,0,1,0
50416,445,0,0,drop,66,66,0,1,0,1,0
50417,445,0,0,drop,66,66,0,1,0,1,0
50414,445,0,0,drop,66,66,0,1,0,1,0
50412,445,0,0,drop,66,66,0,1,0,1,0
50411,445,0,0,drop,66,66,0,1,0,1,0
49927,445,0,0,drop,70,70,0,1,0,1,0
49920,445,0,0,drop,70,70,0,1,0,1,0
50397,445,0,0,drop,66,66,0,1,0,1,0
50398,445,0,0,drop,66,66,0,1,0,1,0
50395,445,0,0,drop,66,66,0,1,0,1,0
49917,445,0,0,drop,70,70,0,1,0,1,0
54999,445,0,0,drop,70,70,0,1,0,1,0
54993,445,0,0,drop,70,70,0,1,0,1,0
54991,445,0,0,drop,70,70,0,1,0,1,0
49912,445,0,0,drop,70,70,0,1,0,1,0
56980,53,42285,53,allow,267,87,180,4,38,2,2
56689,53,4538,53,allow,177,91,86,3,38,2,1
58301,53,36478,53,allow,233,102,131,2,30,1,1
37230,554,0,0,deny,60,60,0,1,0,1,0
49908,445,0,0,drop,70,70,0,1,0,1,0
60223,67,0,0,deny,60,60,0,1,0,1,0
54979,445,0,0,drop,70,70,0,1,0,1,0
37571,53,19977,53,allow,164,78,86,2,30,1,1
61030,53,15331,53,allow,167,78,89,2,30,1,1
56689,53,17079,53,allow,264,91,173,4,38,2,2
56594,80,5980,80,allow,234,234,0,4,11,4,0
58621,53,5007,53,allow,256,94,162,2,29,1,1
65164,53,40444,53,allow,265,102,163,2,29,1,1
60561,53,50880,53,allow,343,86,257,2,30,1,1
36586,80,45063,80,allow,1114,534,580,12,15,7,5
56980,53,33367,53,allow,267,87,180,4,38,2,2
60394,53,18080,53,allow,330,94,236,2,30,1,1
55470,53,6327,53,allow,197,102,95,2,30,1,1
65461,53,1880,53,allow,268,110,158,2,30,1,1
49164,53,4974,53,allow,212,94,118,2,30,1,1
49997,53,42386,53,allow,264,102,162,2,30,1,1
64354,53,25529,53,allow,240,78,162,2,30,1,1
57664,53,41830,53,allow,168,78,90,2,30,1,1
63691,53,63691,53,allow,198,90,108,2,30,1,1
38901,53,60941,53,allow,168,78,90,2,30,1,1
56980,53,28670,53,allow,267,87,180,4,38,2,2
50572,80,21152,80,allow,132,132,0,2,8,2,0
52481,443,2836,443,allow,70,70,0,1,5,1,0
49520,53,55540,53,allow,229,102,127,2,30,1,1
36289,53,0,0,allow,86,86,0,1,30,1,0
48857,53,48857,53,allow,213,82,131,2,30,1,1
64626,53,31838,53,allow,326,102,224,2,30,1,1
49608,53,46552,53,allow,177,94,83,2,30,1,1
55470,53,12953,53,allow,197,102,95,2,33,1,1
52717,53,4391,53,allow,277,94,183,2,30,1,1
49700,53,14464,53,allow,165,78,87,2,30,1,1
47831,53,0,0,allow,86,86,0,1,30,1,0
61973,53,11068,53,allow,222,94,128,2,30,1,1
54961,53,55140,53,allow,375,99,276,4,54,2,2
59486,53,24146,53,allow,316,86,230,2,29,1,1
54991,53,13574,53,allow,177,94,83,2,29,1,1
55317,53,22104,53,allow,94,94,0,1,30,1,0
64401,53,5392,53,allow,293,94,199,2,30,1,1
55664,53,60480,53,allow,177,94,83,2,29,1,1
54991,53,42971,53,allow,253,87,166,4,29,2,2
64254,53,25297,53,allow,211,78,133,2,30,1,1
64905,53,16169,53,allow,245,94,151,2,30,1,1
59165,53,3283,53,allow,186,78,108,2,30,1,1
55179,53,63963,53,allow,194,102,92,2,30,1,1
64209,53,25156,53,allow,277,94,183,2,30,1,1
59610,53,54271,53,allow,191,78,113,2,30,1,1
55801,53,42672,53,allow,222,102,120,2,30,1,1
49529,53,23720,53,allow,211,94,117,2,30,1,1
65383,53,42198,53,allow,267,94,173,2,30,1,1
62139,53,5155,53,allow,291,78,213,2,30,1,1
57067,53,11101,53,allow,252,102,150,2,30,1,1
55179,53,20932,53,allow,194,102,92,2,35,1,1
56980,53,33611,53,allow,526,188,338,6,48,3,3
53521,443,39860,443,allow,710,350,360,12,33,6,6
64650,53,46185,53,allow,257,126,131,2,30,1,1
65186,53,5333,53,allow,285,94,191,2,30,1,1
49942,53,42485,53,allow,177,94,83,2,31,1,1
49585,53,59933,53,allow,718,94,624,2,30,1,1
49312,53,2239,53,allow,184,86,98,2,30,1,1
49878,53,64175,53,allow,327,102,225,2,30,1,1
65018,53,40867,53,allow,198,94,104,2,30,1,1
49902,445,0,0,deny,70,70,0,1,0,1,0
50374,445,0,0,drop,66,66,0,1,0,1,0
54973,445,0,0,drop,70,70,0,1,0,1,0
54972,445,0,0,drop,70,70,0,1,0,1,0
49889,445,0,0,drop,70,70,0,1,0,1,0
50368,445,0,0,drop,66,66,0,1,0,1,0
50366,445,0,0,drop,66,66,0,1,0,1,0
49886,445,0,0,drop,70,70,0,1,0,1,0
54958,445,0,0,drop,70,70,0,1,0,1,0
50365,445,0,0,drop,66,66,0,1,0,1,0
49882,445,0,0,drop,70,70,0,1,0,1,0
54945,445,0,0,drop,70,70,0,1,0,1,0
54941,445,0,0,drop,70,70,0,1,0,1,0
49878,445,0,0,drop,70,70,0,1,0,1,0
50355,445,0,0,drop,66,66,0,1,0,1,0
50347,445,0,0,drop,66,66,0,1,0,1,0
50346,445,0,0,drop,66,66,0,1,0,1,0
50345,445,0,0,drop,66,66,0,1,0,1,0
54935,445,0,0,drop,70,70,0,1,0,1,0
54932,445,0,0,drop,70,70,0,1,0,1,0
49871,445,0,0,drop,70,70,0,1,0,1,0
50343,445,0,0,drop,66,66,0,1,0,1,0
54931,445,0,0,drop,70,70,0,1,0,1,0
49869,445,0,0,drop,70,70,0,1,0,1,0
50339,445,0,0,drop,66,66,0,1,0,1,0
49868,445,0,0,drop,70,70,0,1,0,1,0
50333,445,0,0,drop,66,66,0,1,0,1,0
49866,445,0,0,drop,70,70,0,1,0,1,0
49864,445,0,0,drop,70,70,0,1,0,1,0
49848,445,0,0,drop,70,70,0,1,0,1,0
49846,445,0,0,drop,70,70,0,1,0,1,0
49845,445,0,0,drop,70,70,0,1,0,1,0
49837,445,0,0,drop,70,70,0,1,0,1,0
50315,445,0,0,drop,66,66,0,1,0,1,0
49826,445,0,0,drop,70,70,0,1,0,1,0
50313,445,0,0,drop,66,66,0,1,0,1,0
53358,23,0,0,deny,60,60,0,1,0,1,0
50306,445,0,0,drop,66,66,0,1,0,1,0
49821,445,0,0,drop,70,70,0,1,0,1,0
52600,22,0,0,deny,60,60,0,1,0,1,0
49810,445,0,0,drop,70,70,0,1,0,1,0
49804,445,0,0,drop,70,70,0,1,0,1,0
54894,445,0,0,drop,70,70,0,1,0,1,0
54891,445,0,0,drop,70,70,0,1,0,1,0
50285,445,0,0,drop,66,66,0,1,0,1,0
50289,445,0,0,drop,66,66,0,1,0,1,0
50290,445,0,0,drop,66,66,0,1,0,1,0
50286,445,0,0,drop,66,66,0,1,0,1,0
50284,445,0,0,drop,66,66,0,1,0,1,0
50282,445,0,0,drop,66,66,0,1,0,1,0
49798,445,0,0,drop,70,70,0,1,0,1,0
54889,445,0,0,drop,70,70,0,1,0,1,0
54875,445,0,0,drop,70,70,0,1,0,1,0
49791,445,0,0,drop,70,70,0,1,0,1,0
49788,445,0,0,drop,70,70,0,1,0,1,0
64677,53,12416,53,allow,172,88,84,2,31,1,1
50366,80,53987,80,allow,318,192,126,6,28,4,2
50358,80,31825,80,allow,318,192,126,6,28,4,2
50369,80,41191,80,allow,318,192,126,6,28,4,2
55216,53,59483,53,allow,711,87,624,2,30,1,1
58956,53,19380,53,allow,213,89,124,2,30,1,1
50370,80,12726,80,allow,318,192,126,6,28,4,2
50359,80,41698,80,allow,318,192,126,6,28,4,2
50367,80,15574,80,allow,318,192,126,6,28,4,2
57031,53,9800,53,allow,170,87,83,2,31,1,1
50360,80,16489,80,allow,318,192,126,6,28,4,2
50361,80,40866,80,allow,318,192,126,6,28,4,2
50368,80,46672,80,allow,318,192,126,6,28,4,2
49681,53,1706,53,allow,170,87,83,2,30,1,1
57137,53,7336,53,allow,711,87,624,2,30,1,1
49559,53,6355,53,allow,164,84,80,2,31,1,1
57292,53,56725,53,allow,170,87,83,2,31,1,1
56985,53,45052,53,allow,711,87,624,2,31,1,1
50269,445,0,0,drop,66,66,0,1,0,1,0
50270,445,0,0,drop,66,66,0,1,0,1,0
50268,445,0,0,drop,66,66,0,1,0,1,0
49783,445,0,0,drop,70,70,0,1,0,1,0
65323,53,33275,53,allow,356,118,238,2,30,1,1
63691,80,13237,80,allow,314,192,122,6,15,4,2
54871,445,0,0,drop,70,70,0,1,0,1,0
54870,445,0,0,drop,70,70,0,1,0,1,0
